Player,Nation,Position,Squad,Age,Year of birth,90s Played,Tackles,Tackles Won,Tackles (Def 3rd),Tackles (Mid 3rd),Tackles (Att 3rd),Dribblers Tackled,Dribbles Challenged,% of Dribblers Tackled,Challenges Lost,Blocks,Shots Blocked,Passes Blocked,Interceptions,Tkl+Int,Clearances,Errors,Matches


Yunis Abdelhamid,ma MAR,DF,Reims,33,1987,33.1,48,27,34,14,0,16,32,50.0,16,50,25,25,68,116,104,0,Matches
Salis Abdul Samed,gh GHA,MF,Clermont Foot,21,2000,27.4,43,23,25,16,2,20,57,35.1,37,18,1,17,42,85,15,0,Matches
Laurent Abergel,fr FRA,MF,Lorient,28,1993,32.8,110,60,44,53,13,71,166,42.8,95,58,1,57,55,165,13,0,Matches
Charles Abi,fr FRA,FW,Saint-Étienne,21,2000,0.5,0,0,0,0,0,0,1,0.0,1,2,0,2,0,0,0,0,Matches
Matthis Abline,fr FRA,FW,Rennes,18,2003,1.1,0,0,0,0,0,0,0,,0,2,0,2,0,0,1,0,Matches
Mohamed Achi,fr FRA,MF,Nantes,19,2002,0.1,0,0,0,0,0,0,0,,0,0,0,0,0,0,0,0,Matches
Martin Adeline,fr FRA,"MF,FW",Reims,17,2003,3.9,15,11,5,8,2,8,16,50.0,8,0,0,0,11,26,6,0,Matches
Yacine Adli,fr FRA,"MF,FW",Bordeaux,21,2000,25.1,43,27,22,14,7,19,68,27.9,49,33,3,30,37,80,11,2,Matches
Lucien Agoume,fr FRA,MF,Brest,19,2002,20.8,51,31,24,20,7,23,45,51.1,22,30,9,21,52,103,27,1,Matches
Nayef Aguerd,ma MAR,DF,Rennes,25,1996,30.4,27,18,16,11,0,14,24,58.3,10,24,14,10,24,51,127,1,Matches
Ruben Aguilar,fr FRA,DF,Monaco,28,1993,23.8,78,53,39,32,7,43,68,63.2,25,19,4,15,44,122,57,0,Matches
Anel Ahmedhodžić,ba BIH,DF,Bordeaux,22,1999,15.0,38,26,27,9,2,20,31,64.5,11,16,8,8,22,60,44,0,Matches
Jean-Eudes Aholou,ci CIV,MF,Strasbourg,27,1994,11.2,16,9,4,9,3,5,19,26.3,14,8,1,7,19,35,7,0,Matches
Ludovic Ajorque,fr FRA,FW,Strasbourg,27,1994,30.4,36,25,5,19,12,7,40,17.5,33,28,3,25,8,44,31,1,Matches
Maghnes Akliouche,fr FRA,"MF,FW",Monaco,19,2002,0.6,2,0,0,2,0,0,1,0.0,1,2,0,2,0,2,0,0,Matches
Sofiane Alakouch,ma MAR,"DF,MF",Metz,23,1998,1.8,7,4,3,4,0,2,5,40.0,3,4,0,4,1,8,4,0,Matches
Josué Albert,gf GUF,DF,Clermont Foot,29,1992,0.2,0,0,0,0,0,0,0,,0,0,0,0,1,1,2,0,Matches
Doğan Alemdar,tr TUR,GK,Rennes,18,2002,12.0,0,0,0,0,0,0,0,,0,0,0,0,0,0,9,1,Matches
Mohamed Ali Cho,fr FRA,FW,Angers,17,2004,20.4,10,5,1,4,5,5,17,29.4,12,17,1,16,8,18,0,1,Matches
Jim Allevinah,ga GAB,FW,Clermont Foot,26,1995,16.5,18,13,8,8,2,5,18,27.8,13,11,0,11,6,24,4,0,Matches
Ibrahim Amadou,fr FRA,"DF,MF",Metz,28,1993,9.0,16,8,10,6,0,8,15,53.3,7,4,2,2,14,30,26,0,Matches
Jordan Amavi,fr FRA,DF,Nice,27,1994,4.6,16,10,8,7,1,10,17,58.8,7,3,1,2,15,31,7,0,Matches
Jordan Amavi,fr FRA,"DF,FW",Marseille,27,1994,1.4,6,5,3,1,2,5,10,50.0,5,1,0,1,1,7,3,0,Matches
Benjamin André,fr FRA,MF,Lille,30,1990,30.6,123,69,49,65,9,51,113,45.1,62,49,11,38,50,173,56,0,Matches
Houssem Aouar,dz ALG,"MF,FW",Lyon,23,1998,27.8,46,30,9,25,12,27,54,50.0,27,26,1,25,20,66,5,0,Matches

Adil Aouchiche,fr FRA,"MF,FW",Saint-Étienne,19,2002,12.0,13,6,5,5,3,5,33,15.2,28,18,1,17,17,30,4,0,Matches
Dennis Appiah,fr FRA,DF,Nantes,29,1992,23.3,55,34,35,18,2,28,48,58.3,20,30,13,17,27,82,74,0,Matches
Lorenz Assignon,tg TOG,DF,Rennes,21,2000,6.8,15,10,11,3,1,5,9,55.6,4,3,1,2,11,26,19,0,Matches
Youcef Atal,dz ALG,DF,Nice,25,1996,12.7,29,19,17,10,2,14,25,56.0,11,13,2,11,32,61,21,0,Matches
Jean-Kévin Augustin,fr FRA,"FW,MF",Nantes,24,1997,0.9,1,0,0,0,1,0,3,0.0,3,1,0,1,0,1,0,0,Matches
Karim Azamoum,fr FRA,DF,Troyes,31,1990,4.3,6,5,4,2,0,3,5,60.0,2,4,2,2,1,7,10,0,Matches
Loïc Bade,fr FRA,DF,Rennes,21,2000,10.9,6,5,4,2,0,3,5,60.0,2,12,10,2,12,18,48,0,Matches
Benoît Badiashile,fr FRA,DF,Monaco,20,2001,20.4,36,19,21,15,0,14,23,60.9,9,18,12,6,28,64,68,1,Matches
Youssouph Badji,sn SEN,"FW,MF",Brest,19,2001,1.5,1,0,0,1,0,0,1,0.0,1,0,0,0,0,1,0,0,Matches
Stéphane Bahoken,cm CMR,FW,Angers,29,1992,12.2,13,8,2,7,4,1,9,11.1,8,15,0,15,3,16,3,0,Matches
Dénys Bain,fr FRA,DF,Brest,28,1993,2.0,3,3,1,2,0,1,1,100.0,0,3,1,2,3,6,5,0,Matches
Stefan Bajic,fr FRA,GK,Saint-Étienne,19,2001,5.7,0,0,0,0,0,0,0,,0,0,0,0,0,0,4,0,Matches
Cédric Bakambu,cd COD,FW,Marseille,30,1991,4.0,2,0,1,0,1,0,3,0.0,3,2,0,2,0,2,1,0,Matches
Abdoulaye Bakayoko,fr FRA,DF,Saint-Étienne,18,2002,3.4,15,9,13,2,0,8,12,66.7,4,5,4,1,12,27,15,0,Matches
Dilane Bakwa,fr FRA,"FW,MF",Bordeaux,18,2002,0.5,1,1,0,1,0,1,2,50.0,1,0,0,0,0,1,1,0,Matches
Ibrahima Baldé,fr FRA,"FW,MF",Lens,18,2003,0.6,0,0,0,0,0,0,0,,0,0,0,0,0,0,0,0,Matches
Leonardo Balerdi,ar ARG,DF,Marseille,22,1999,10.6,9,6,9,0,0,5,14,35.7,9,11,4,7,19,28,30,0,Matches
Abdoulaye Bamba,ci CIV,"DF,FW",Angers,31,1990,5.1,6,5,6,0,0,4,11,36.4,7,5,1,4,9,15,13,0,Matches
Jonathan Bamba,ci CIV,"MF,FW",Lille,25,1996,27.0,30,12,13,9,8,13,36,36.1,23,24,1,23,21,51,10,0,Matches
Simon Banza,cd COD,FW,Lens,24,1996,1.4,2,1,0,0,2,0,2,0.0,2,1,0,1,1,3,2,0,Matches
Danilo Barbosa,br BRA,DF,Nice,25,1996,1.0,0,0,0,0,0,0,0,,0,1,1,0,2,2,10,0,Matches
Bradley Barcola,fr FRA,"FW,MF",Lyon,18,2002,2.9,7,4,2,3,2,1,8,12.5,7,7,1,6,2,9,1,0,Matches
Melvin Bard,fr FRA,DF,Nice,20,2000,28.8,59,37,38,17,4,41,63,65.1,22,33,10,23,51,110,56,0,Matches
Toma Bašić,hr CRO,MF,Bordeaux,24,1996,2.3,2,2,1,0,1,0,4,0.0,4,4,1,3,2,4,0,0,Matches
Amine Bassi,fr FRA,"MF,FW",Metz,23,1997,2.0,6,3,2,3,1,1,3,33.3,2,5,0,5,0,6,0,0,Matches

Paul Baysse,fr FRA,"MF,DF",Bordeaux,33,1988,0.1,1,1,0,1,0,0,0,,0,0,0,0,0,1,1,0,Matches
Youcef Belaïli,dz ALG,"MF,FW",Brest,29,1992,9.2,2,1,0,0,2,2,9,22.2,7,5,1,4,7,9,4,0,Matches
Haris Belkebla,dz ALG,MF,Brest,27,1994,25.7,46,23,21,21,4,18,39,46.2,21,26,6,20,48,94,30,1,Matches
Jean-Ricner Bellegarde,fr FRA,MF,Strasbourg,23,1998,25.9,51,32,21,21,9,17,41,41.5,24,29,4,25,27,78,19,0,Matches
Jeanuël Belocian,fr FRA,DF,Rennes,16,2005,0.1,0,0,0,0,0,0,0,,0,0,0,0,0,0,0,0,Matches
Hatem Ben Arfa,fr FRA,"FW,MF",Lille,34,1987,3.5,4,2,2,1,1,2,4,50.0,2,3,0,3,0,4,1,0,Matches
Salim Ben Seghir,fr FRA,MF,Marseille,18,2003,0.0,0,0,0,0,0,0,0,,0,0,0,0,0,0,0,0,Matches
Wissam Ben Yedder,fr FRA,FW,Monaco,30,1990,28.1,18,8,1,11,6,6,15,40.0,9,12,1,11,0,18,1,0,Matches
Darío Benedetto,ar ARG,"FW,MF",Marseille,31,1990,0.6,0,0,0,0,0,0,0,,0,2,0,2,0,0,0,0,Matches
Walter Benítez,ar ARG,GK,Nice,28,1993,37.0,0,0,0,0,0,0,2,0.0,2,1,0,1,0,0,12,2,Matches
Loris Benito,ch SUI,DF,Bordeaux,29,1992,0.7,0,0,0,0,0,0,0,,0,0,0,0,1,1,3,1,Matches
Nabil Bentaleb,dz ALG,MF,Angers,26,1994,16.8,42,24,15,20,7,16,29,55.2,13,24,9,15,28,70,13,0,Matches
Patrick Berg,no NOR,MF,Lens,23,1997,3.4,14,6,6,8,0,0,4,0.0,4,2,1,1,4,18,3,0,Matches
Mitchell van Bergen,nl NED,"FW,MF",Reims,21,1999,10.9,8,5,7,0,1,6,15,40.0,9,9,0,9,4,12,7,0,Matches
Valon Berisha,xk KVX,"MF,FW",Reims,28,1993,5.1,10,7,2,5,3,2,10,20.0,8,9,0,9,4,14,3,0,Matches
Paul Bernardoni,fr FRA,GK,Angers,24,1997,13.0,3,2,3,0,0,3,4,75.0,1,0,0,0,0,3,8,1,Matches
Paul Bernardoni,fr FRA,GK,Saint-Étienne,24,1997,19.0,0,0,0,0,0,0,0,,0,0,0,0,0,0,14,2,Matches
Juan Bernat,es ESP,"DF,MF",Paris S-G,28,1993,10.6,24,14,10,10,4,13,18,72.2,5,8,0,8,8,32,16,0,Matches
Dimitry Bertaud,cd COD,GK,Montpellier,23,1998,9.3,0,0,0,0,0,0,1,0.0,1,0,0,0,0,0,5,1,Matches
Jason Berthomier,fr FRA,MF,Clermont Foot,31,1990,19.2,29,14,5,17,7,12,34,35.3,22,14,2,12,8,37,4,1,Matches
Giulian Biancone,fr FRA,"DF,MF",Troyes,21,2000,25.5,70,42,44,22,4,40,69,58.0,29,23,8,15,53,123,71,1,Matches
El Bilal Touré,ml MLI,FW,Reims,19,2001,13.3,13,6,4,6,3,2,7,28.6,5,10,3,7,6,19,19,0,Matches
Jean-Claude Billong,cm CMR,DF,Clermont Foot,27,1993,10.9,17,8,14,1,2,8,11,72.7,3,9,1,8,10,27,35,0,Matches
Nathan Bitumazala,fr FRA,DF,Paris S-G,18,2002,0.1,0,0,0,0,0,0,0,,0,1,0,1,0,0,0,0,Matches
Marco Bizot,nl NED,GK,Brest,30,1991,38.0,3,1,3,0,0,3,5,60.0,2,1,0,1,0,3,24,1,Matches

Ludovic Blas,fr FRA,"MF,FW",Nantes,23,1997,32.9,33,18,7,20,6,15,44,34.1,29,33,3,30,31,64,6,1,Matches
Myron Boadu,nl NED,FW,Monaco,20,2001,10.7,9,7,2,3,4,1,5,20.0,4,6,0,6,2,11,1,0,Matches
Jérôme Boateng,de GER,DF,Lyon,32,1988,18.0,20,15,11,9,0,9,17,52.9,8,20,10,10,20,40,73,0,Matches
Antonin Bobichon,fr FRA,"MF,FW",Angers,25,1995,0.4,1,0,0,1,0,0,0,,0,0,0,0,1,2,0,0,Matches
Quentin Boisgard,fr FRA,"MF,FW",Lorient,24,1997,10.6,19,11,6,10,3,8,17,47.1,9,15,0,15,6,25,5,0,Matches
Charles Boli,fr FRA,"MF,DF",Lens,22,1998,0.4,2,1,0,2,0,0,0,,0,0,0,0,0,2,0,0,Matches
Sven Botman,nl NED,DF,Lille,21,2000,25.0,24,11,13,11,0,12,18,66.7,6,32,21,11,26,50,116,0,Matches
Denis Bouanga,ga GAB,"FW,MF",Saint-Étienne,26,1994,27.1,46,25,14,13,19,22,63,34.9,41,30,0,30,8,54,34,1,Matches
Hicham Boudaoui,dz ALG,MF,Nice,21,1999,18.0,31,18,15,10,6,13,36,36.1,23,17,4,13,18,49,15,0,Matches
Ryad Boudebouz,dz ALG,"MF,FW",Saint-Étienne,31,1990,25.0,27,15,11,12,4,12,29,41.4,17,17,2,15,10,37,5,0,Matches
Sofiane Boufal,ma MAR,"FW,MF",Angers,27,1993,25.9,44,29,19,16,9,18,38,47.4,20,19,2,17,7,51,1,0,Matches
Farid Boulaya,dz ALG,"MF,FW",Metz,28,1993,17.0,18,10,7,9,2,14,38,36.8,24,8,2,6,12,30,5,0,Matches
Ismaël Boura,km COM,DF,Lens,20,2000,1.1,2,2,1,1,0,0,0,,0,1,1,0,2,4,5,0,Matches
Benjamin Bourigeaud,fr FRA,"FW,MF",Rennes,27,1994,35.5,46,24,16,18,12,24,67,35.8,43,33,3,30,30,76,44,0,Matches
Redwan Bourles,fr FRA,"MF,FW",Lorient,18,2003,0.2,0,0,0,0,0,0,0,,0,0,0,0,0,0,0,0,Matches
Domagoj Bradarić,hr CRO,DF,Lille,21,1999,4.6,11,9,8,2,1,7,12,58.3,5,5,2,3,10,21,7,1,Matches
Bilal Brahimi,dz ALG,MF,Nice,21,2000,4.2,1,1,0,1,0,0,2,0.0,2,1,0,1,2,3,1,0,Matches
Bilal Brahimi,dz ALG,FW,Angers,21,2000,3.8,1,1,0,1,0,0,3,0.0,3,0,0,0,1,2,1,0,Matches
Lilian Brassier,fr FRA,DF,Brest,21,1999,25.1,40,24,23,13,4,10,21,47.6,11,31,21,10,32,72,86,0,Matches
Jimmy Briand,fr FRA,"FW,MF",Bordeaux,35,1985,2.5,2,0,2,0,0,0,2,0.0,2,0,0,0,1,3,2,0,Matches
Dylan Bronn,tn TUN,DF,Metz,26,1995,28.3,47,29,33,13,1,20,31,64.5,11,32,19,13,40,87,78,1,Matches
Osman Bukari,gh GHA,"FW,MF",Nantes,22,1998,11.2,18,8,7,6,5,8,22,36.4,14,8,0,8,8,26,1,0,Matches
Maxime Busi,be BEL,DF,Reims,21,1999,14.4,26,15,20,5,1,19,36,52.8,17,19,5,14,17,43,28,0,Matches
Oriol Busquets,es ESP,MF,Clermont Foot,22,1999,2.2,3,3,0,3,0,2,6,33.3,4,7,4,3,1,4,2,0,Matches
Marcin Bułka,pl POL,GK,Nice,21,1999,1.0,0,0,0,0,0,0,0,,0,0,0,0,0,0,0,0,Matches

Rémy Cabella,fr FRA,"MF,FW",Montpellier,31,1990,3.5,15,7,4,8,3,5,15,33.3,10,7,0,7,5,20,1,0,Matches
Jimmy Cabot,fr FRA,DF,Angers,27,1994,22.3,81,44,59,15,7,47,83,56.6,36,29,0,29,32,113,30,0,Matches
Anthony Caci,fr FRA,DF,Strasbourg,24,1997,26.6,65,34,35,24,6,33,55,60.0,22,22,3,19,33,98,49,1,Matches
Mathieu Cafaro,fr FRA,"MF,FW",Reims,24,1997,2.1,4,2,3,1,0,0,7,0.0,7,2,0,2,3,7,1,0,Matches
Yannick Cahuzac,fr FRA,MF,Lens,36,1985,6.9,5,2,2,3,0,0,5,0.0,5,8,2,6,9,14,12,0,Matches
Marc-Aurèle Caillard,fr FRA,GK,Metz,27,1994,17.1,0,0,0,0,0,0,2,0.0,2,0,0,0,2,2,9,1,Matches
Jens Cajuste,se SWE,"MF,FW",Reims,21,1999,4.0,10,6,6,2,2,6,17,35.3,11,7,2,5,5,15,6,0,Matches
Duje Ćaleta-Car,hr CRO,DF,Marseille,24,1996,22.9,21,8,15,6,0,11,14,78.6,3,11,7,4,24,45,55,2,Matches
Lucas Calodat,fr FRA,DF,Saint-Étienne,19,2002,0.0,0,0,0,0,0,0,0,,0,0,0,0,0,0,0,0,Matches
Mahdi Camara,fr FRA,"MF,DF",Saint-Étienne,23,1998,34.1,101,57,39,50,12,39,70,55.7,31,44,8,36,57,158,35,1,Matches
Mamadou Camara,ml MLI,FW,Troyes,20,2001,0.4,1,1,1,0,0,0,0,,0,0,0,0,0,1,0,0,Matches
Eduardo Camavinga,fr FRA,MF,Rennes,18,2002,1.6,4,1,2,1,1,2,5,40.0,3,1,1,0,1,5,3,0,Matches
Fali Candé,gw GNB,DF,Metz,23,1998,10.8,30,18,13,15,2,13,31,41.9,18,11,2,9,6,36,21,0,Matches
Pierrick Capelle,fr FRA,"MF,DF",Angers,34,1987,13.3,36,24,16,17,3,18,52,34.6,34,12,1,11,16,52,20,0,Matches
Maxence Caqueret,fr FRA,MF,Lyon,21,2000,25.9,73,40,29,36,8,30,80,37.5,50,38,10,28,43,116,26,2,Matches
Irvin Cardona,fr FRA,"FW,MF",Brest,23,1997,14.8,13,7,5,4,4,3,16,18.8,13,10,0,10,5,18,17,0,Matches
Igor Carioca,br BRA,DF,Lorient,24,1996,17.5,27,16,16,8,3,15,43,34.9,28,17,2,15,25,52,28,0,Matches
Moreto Cassamã,gw GNB,MF,Reims,23,1998,8.9,12,6,7,4,1,3,19,15.8,16,10,5,5,9,21,5,0,Matches
Jean-Charles Castelletto,cm CMR,DF,Nantes,26,1995,27.9,45,24,27,17,1,25,35,71.4,10,38,27,11,30,75,73,0,Matches
Zeki Çelik,tr TUR,DF,Lille,24,1997,30.0,64,37,43,17,4,36,63,57.1,27,32,9,23,43,107,62,2,Matches
Fabien Centonze,fr FRA,DF,Metz,25,1996,17.6,33,21,22,9,2,13,32,40.6,19,37,8,29,32,65,51,0,Matches
El Chadaille Bitshiabu,fr FRA,DF,Paris S-G,16,2005,0.1,0,0,0,0,0,0,0,,0,0,0,0,0,0,2,0,Matches
Nassim Chadli,fr FRA,"MF,DF",Troyes,20,2001,1.1,5,3,3,0,2,2,4,50.0,2,1,0,1,0,5,0,0,Matches
Mehdi Chahiri,ma MAR,DF,Strasbourg,25,1996,0.2,1,1,1,0,0,1,1,100.0,0,0,0,0,0,1,0,0,Matches
Dylan Chambost,fr FRA,"MF,FW",Troyes,23,1997,8.4,16,11,6,9,1,4,25,16.0,21,9,2,7,8,24,4,0,Matches

Brendan Chardonnet,fr FRA,DF,Brest,26,1994,29.8,44,25,32,11,1,29,40,72.5,11,42,29,13,55,99,141,0,Matches
Xavier Chavalerin,fr FRA,MF,Troyes,30,1991,30.2,49,26,19,25,5,12,55,21.8,43,32,5,27,39,88,36,0,Matches
Xavier Chavalerin,fr FRA,MF,Reims,30,1991,2.4,4,4,2,1,1,1,3,33.3,2,2,0,2,5,9,2,1,Matches
Rayan Cherki,fr FRA,"FW,MF",Lyon,17,2003,4.9,6,2,1,3,2,4,9,44.4,5,2,0,2,1,7,0,0,Matches
Pedro Chirivella,es ESP,MF,Nantes,24,1997,29.3,49,31,14,26,9,25,70,35.7,45,23,2,21,37,86,11,0,Matches
Joris Chotard,fr FRA,MF,Montpellier,19,2001,32.6,59,30,33,23,3,36,78,46.2,42,27,15,12,42,101,56,0,Matches
Alexis Claude-Maurice,fr FRA,MF,Nice,23,1998,2.3,2,0,1,0,1,1,4,25.0,3,7,0,7,3,5,1,0,Matches
Jonathan Clauss,fr FRA,DF,Lens,28,1992,33.8,63,34,33,20,10,22,55,40.0,33,43,1,42,73,136,51,0,Matches
Marcus Coco,fr FRA,"MF,FW",Nantes,25,1996,10.3,34,14,17,11,6,8,18,44.4,10,11,1,10,10,44,15,0,Matches
Abdu Conté,pt POR,DF,Troyes,23,1998,15.0,22,12,16,5,1,12,24,50.0,12,12,2,10,4,26,10,0,Matches
Sébastien Corchia,fr FRA,DF,Nantes,30,1990,14.7,33,20,17,11,5,24,42,57.1,18,24,3,21,13,46,36,0,Matches
Maxwel Cornet,ci CIV,DF,Lyon,24,1996,0.7,3,1,1,0,2,3,4,75.0,1,0,0,0,1,4,1,0,Matches
David Costa,pt POR,"MF,FW",Lens,20,2001,16.3,22,12,9,6,7,11,26,42.3,15,12,0,12,13,35,5,0,Matches
Benoît Costil,fr FRA,GK,Bordeaux,34,1987,25.0,1,0,1,0,0,1,2,50.0,1,0,0,0,0,1,6,3,Matches
Kalifa Coulibaly,ml MLI,FW,Nantes,29,1991,9.4,5,1,1,1,3,0,4,0.0,4,2,2,0,0,5,11,0,Matches
Nicolas Cozza,fr FRA,DF,Montpellier,22,1999,30.8,80,47,50,23,7,35,65,53.8,30,35,19,16,38,118,82,1,Matches
Enzo Crivelli,fr FRA,"FW,MF",Saint-Étienne,26,1995,1.1,1,0,0,0,1,0,0,,0,0,0,0,0,1,1,0,Matches
Wylan Cyprien,fr FRA,MF,Nantes,26,1995,16.6,33,17,12,18,3,13,32,40.6,19,16,6,10,10,43,14,2,Matches
Lucas Da Cunha,fr FRA,MF,Nice,20,2001,4.4,13,7,2,7,4,6,11,54.5,5,2,0,2,1,14,2,0,Matches
Lucas Da Cunha,fr FRA,"FW,MF",Clermont Foot,20,2001,9.3,17,11,5,8,4,9,18,50.0,9,13,0,13,1,18,3,0,Matches
Damien Da Silva,fr FRA,DF,Lyon,33,1988,12.5,13,9,7,5,1,5,9,55.6,4,15,10,5,22,35,53,1,Matches
Colin Dagba,fr FRA,DF,Paris S-G,22,1998,1.8,4,2,2,2,0,3,6,50.0,3,4,2,2,2,6,1,0,Matches
Flavius Daniliuc,at AUT,DF,Nice,20,2001,14.4,46,31,26,17,3,34,43,79.1,9,13,7,6,14,60,34,1,Matches
Kevin Danso,at AUT,DF,Lens,22,1998,31.0,41,29,29,12,0,23,34,67.6,11,38,25,13,40,81,111,0,Matches
Dante,br BRA,DF,Nice,37,1983,31.9,42,29,30,12,0,23,33,69.7,10,43,27,16,49,91,96,1,Matches

Jonathan David,ca CAN,FW,Lille,21,2000,31.2,24,9,7,11,6,9,30,30.0,21,14,4,10,5,29,15,0,Matches
Konrad De La Fuente,us USA,"FW,MF",Marseille,20,2001,8.7,11,7,8,2,1,7,11,63.6,4,5,0,5,2,13,4,0,Matches
Romain Del Castillo,fr FRA,"MF,FW",Rennes,25,1996,0.3,2,1,0,1,1,2,2,100.0,0,0,0,0,1,3,0,0,Matches
Romain Del Castillo,fr FRA,"MF,FW",Brest,25,1996,10.8,27,16,3,17,7,12,31,38.7,19,12,0,12,7,34,3,0,Matches
Thomas Delaine,fr FRA,DF,Metz,29,1992,25.7,48,35,34,12,2,22,42,52.4,20,20,7,13,27,75,31,0,Matches
Sacha Delaye,fr FRA,"MF,FW",Montpellier,19,2002,2.8,8,6,3,2,3,2,8,25.0,6,1,0,1,1,9,1,1,Matches
Andy Delort,dz ALG,FW,Nice,29,1991,27.2,15,9,3,5,7,7,12,58.3,5,13,4,9,9,24,14,0,Matches
Andy Delort,dz ALG,FW,Montpellier,29,1991,3.0,2,0,0,1,1,0,1,0.0,1,1,0,1,0,2,4,0,Matches
Moussa Dembélé,fr FRA,FW,Lyon,25,1996,24.5,18,9,5,5,8,6,15,40.0,9,13,0,13,8,26,30,1,Matches
Jason Denayer,be BEL,DF,Lyon,26,1995,11.1,11,4,8,3,0,6,7,85.7,1,8,7,1,16,27,52,0,Matches
Arthur Desmas,fr FRA,GK,Clermont Foot,27,1994,14.5,0,0,0,0,0,0,3,0.0,3,0,0,0,0,0,1,3,Matches
Ángel Di María,ar ARG,FW,Paris S-G,33,1988,18.3,29,18,6,13,10,14,37,37.8,23,17,0,17,6,35,3,0,Matches
Yadaly Diaby,gn GUI,"FW,MF",Clermont Foot,20,2000,0.7,0,0,0,0,0,0,1,0.0,1,0,0,0,2,2,2,0,Matches
Ibrahim Diakité,gn GUI,MF,Reims,17,2003,0.0,0,0,0,0,0,0,1,0.0,1,0,0,0,0,0,0,0,Matches
Abdou Diallo,sn SEN,DF,Paris S-G,25,1996,9.7,22,14,10,9,3,8,14,57.1,6,6,2,4,10,32,19,1,Matches
Habib Diallo,sn SEN,FW,Strasbourg,26,1995,17.1,9,5,0,8,1,0,8,0.0,8,13,4,9,4,13,11,0,Matches
Habib Diarra,sn SEN,MF,Strasbourg,17,2004,1.2,2,1,1,1,0,1,1,100.0,0,0,0,0,0,2,0,0,Matches
Stéphane Diarra,fr FRA,"MF,FW",Lorient,22,1998,5.8,11,9,7,3,1,5,10,50.0,5,4,0,4,7,18,1,0,Matches
Krépin Diatta,sn SEN,"MF,DF",Monaco,22,1999,3.2,3,2,1,0,2,1,3,33.3,2,2,0,2,1,4,0,0,Matches
Bamba Dieng,sn SEN,FW,Marseille,21,2000,10.8,17,11,5,5,7,4,14,28.6,10,7,0,7,5,22,8,0,Matches
Elhadji Dieye,sn SEN,"FW,MF",Saint-Étienne,19,2002,0.4,3,2,2,1,0,0,1,0.0,1,2,0,2,1,4,0,0,Matches
Javairô Dilrosun,nl NED,"MF,FW",Bordeaux,23,1998,19.2,13,4,2,8,3,7,24,29.2,17,14,1,13,11,24,5,0,Matches
Junior Dina Ebimbe,fr FRA,MF,Paris S-G,20,2000,3.5,9,4,3,4,2,2,3,66.7,1,5,3,2,2,11,1,0,Matches
Tristan Dingomé,cm CMR,"MF,FW",Troyes,30,1991,12.0,23,11,10,12,1,10,18,55.6,8,7,1,6,9,32,3,0,Matches
Sinaly Diomande,ci CIV,DF,Lyon,20,2001,6.4,6,3,4,2,0,5,6,83.3,1,6,6,0,12,18,26,0,Matches

Sofiane Diop,fr FRA,"MF,FW",Monaco,21,2000,21.6,38,20,12,19,7,15,47,31.9,32,10,0,10,23,61,4,0,Matches
Andy Diouf,fr FRA,MF,Rennes,18,2003,0.2,1,1,1,0,0,1,1,100.0,0,1,0,1,0,1,0,0,Matches
Assane Dioussé,sn SEN,MF,Saint-Étienne,23,1997,0.3,1,1,1,0,0,1,1,100.0,0,0,0,0,0,1,0,0,Matches
Axel Disasi,fr FRA,DF,Monaco,23,1998,30.2,42,27,20,21,1,23,39,59.0,16,40,30,10,26,68,75,0,Matches
Tiago Djaló,pt POR,DF,Lille,21,2000,25.9,60,39,39,19,2,26,39,66.7,13,26,10,16,24,84,71,0,Matches
Alexander Djiku,gh GHA,DF,Strasbourg,26,1994,29.9,50,37,33,13,4,18,35,51.4,17,30,13,17,61,111,90,2,Matches
Bryan Djile Nokoué,cm CMR,"DF,MF",Saint-Étienne,19,2002,0.6,3,3,1,2,0,2,2,100.0,0,1,0,1,1,4,2,0,Matches
Ouparine Djoco,gw GNB,GK,Clermont Foot,23,1998,23.5,0,0,0,0,0,0,0,,0,0,0,0,1,1,14,2,Matches
Jeremy Doku,be BEL,"FW,MF",Rennes,19,2002,5.2,10,5,3,5,2,3,6,50.0,3,4,0,4,3,13,0,0,Matches
Kasper Dolberg,dk DEN,FW,Nice,23,1997,16.6,9,4,4,3,2,3,9,33.3,6,15,1,14,6,15,17,0,Matches
Brandon Domingues,fr FRA,"MF,FW",Troyes,21,2000,2.6,6,2,2,4,0,2,3,66.7,1,3,0,3,3,9,0,0,Matches
Anastasios Donis,gr GRE,"FW,MF",Reims,24,1996,4.1,8,7,4,2,2,2,6,33.3,4,3,0,3,0,8,1,0,Matches
Gianluigi Donnarumma,it ITA,GK,Paris S-G,22,1999,17.0,0,0,0,0,0,0,0,,0,0,0,0,0,0,9,2,Matches
Jodel Dossou,bj BEN,FW,Clermont Foot,29,1992,22.3,36,17,15,14,7,15,43,34.9,28,14,0,14,5,41,7,0,Matches
Lohann Doucet,fr FRA,"MF,DF",Nantes,18,2002,0.1,0,0,0,0,0,0,0,,0,0,0,0,1,1,0,0,Matches
Cheick Doucouré,ml MLI,MF,Lens,21,2000,32.7,75,43,34,34,7,35,79,44.3,44,30,7,23,68,143,24,0,Matches
Fodé Doucouré,ml MLI,"DF,FW",Reims,20,2001,1.7,12,9,9,3,0,9,11,81.8,2,1,0,1,4,16,6,0,Matches
Ismaël Doukouré,fr FRA,DF,Strasbourg,18,2003,0.2,0,0,0,0,0,0,0,,0,0,0,0,0,0,1,0,Matches
Kamory Doumbia,ml MLI,"MF,FW",Reims,18,2003,3.9,8,2,2,5,1,5,13,38.5,8,9,3,6,3,11,3,0,Matches
Moussa Doumbia,ml MLI,FW,Reims,26,1994,1.0,0,0,0,0,0,0,1,0.0,1,0,0,0,0,0,0,0,Matches
Souleyman Doumbia,ci CIV,"DF,FW",Angers,24,1996,24.7,30,20,16,9,5,13,27,48.1,14,25,4,21,39,69,51,0,Matches
Julian Draxler,de GER,"FW,MF",Paris S-G,27,1993,6.1,3,2,0,3,0,0,4,0.0,4,3,0,3,5,8,3,0,Matches
Matthieu Dreyer,fr FRA,GK,Lorient,32,1989,16.0,1,1,1,0,0,1,1,100.0,0,0,0,0,0,1,9,0,Matches
Leo Dubois,fr FRA,DF,Lyon,26,1994,19.4,43,27,22,14,7,27,46,58.7,19,27,3,24,22,65,35,1,Matches
Jean-Kevin Duverne,ht HAI,DF,Brest,24,1997,33.4,71,44,43,21,7,42,90,46.7,48,40,5,35,53,124,92,0,Matches

Enzo Ebosse,cm CMR,DF,Angers,22,1999,21.0,25,14,19,6,0,11,19,57.9,8,19,9,10,15,40,42,0,Matches
Hugo Ekitike,fr FRA,FW,Reims,19,2002,14.1,18,10,8,6,4,4,11,36.4,7,9,2,7,6,24,15,0,Matches
Alberth Elis,hn HON,"FW,MF",Bordeaux,25,1996,15.7,19,10,5,5,9,11,25,44.0,14,9,0,9,7,26,10,0,Matches
Renaud Emond,be BEL,"FW,MF",Nantes,29,1991,2.1,1,0,0,1,0,0,4,0.0,4,2,1,1,0,1,1,0,Matches
Maxime Estève,fr FRA,DF,Montpellier,19,2002,20.6,27,18,22,4,1,15,27,55.6,12,31,24,7,22,49,69,1,Matches
Fábio,br BRA,DF,Nantes,31,1990,18.5,61,40,31,23,7,36,74,48.6,38,29,7,22,35,96,31,1,Matches
Cesc Fàbregas,es ESP,MF,Monaco,34,1987,0.4,1,0,0,1,0,1,1,100.0,0,0,0,0,1,2,0,0,Matches
Wout Faes,be BEL,DF,Reims,23,1998,37.0,40,24,30,9,1,25,33,75.8,8,47,37,10,53,93,169,2,Matches
Romain Faivre,fr FRA,"FW,MF",Lyon,23,1998,9.9,10,4,2,6,2,4,13,30.8,9,4,0,4,3,13,2,0,Matches
Romain Faivre,fr FRA,MF,Brest,23,1998,19.9,30,18,12,13,5,12,30,40.0,18,11,0,11,13,43,10,0,Matches
Wuilker Faríñez,ve VEN,GK,Lens,23,1998,12.3,0,0,0,0,0,0,0,,0,0,0,0,0,0,4,0,Matches
Noah Fatar,fr FRA,"DF,MF",Angers,19,2002,0.1,1,0,0,0,1,0,1,0.0,1,0,0,0,1,2,0,0,Matches
Julien Faussurier,fr FRA,"MF,DF",Brest,34,1987,5.4,10,6,3,3,4,6,13,46.2,7,12,1,11,5,15,6,0,Matches
Jordan Ferri,fr FRA,MF,Montpellier,29,1992,32.3,55,35,28,23,4,29,87,33.3,58,21,5,16,30,85,35,0,Matches
Karol Fila,pl POL,DF,Strasbourg,23,1998,6.2,10,8,5,4,1,4,8,50.0,4,7,2,5,4,14,6,0,Matches
Alexis Flips,fr FRA,"MF,DF",Reims,21,2000,11.7,37,21,21,9,7,22,45,48.9,23,21,0,21,24,61,17,0,Matches
Mamadou Fofana,ml MLI,DF,Metz,23,1998,0.4,1,1,0,1,0,1,2,50.0,1,2,1,1,1,2,2,0,Matches
Seko Fofana,ci CIV,MF,Lens,26,1995,37.3,27,19,11,13,3,12,58,20.7,46,24,2,22,26,53,17,1,Matches
Youssouf Fofana,fr FRA,MF,Monaco,22,1999,24.3,69,43,19,41,9,29,56,51.8,27,29,7,22,32,101,22,2,Matches
Thomas Foket,be BEL,"DF,FW",Reims,26,1994,24.8,28,19,12,13,3,18,40,45.0,22,26,4,22,33,61,35,0,Matches
Thomas Fontaine,mg MAD,DF,Lorient,30,1991,1.9,2,0,1,0,1,0,1,0.0,1,3,3,0,2,4,4,0,Matches
José Fonte,pt POR,DF,Lille,37,1983,38.0,23,12,14,7,2,11,25,44.0,14,39,32,7,44,67,159,1,Matches
Steven Fortes,cv CPV,DF,Lens,29,1992,1.0,2,0,2,0,0,1,2,50.0,1,2,1,1,0,2,4,0,Matches
Przemysław Frankowski,pl POL,DF,Lens,26,1995,27.2,57,39,22,27,8,36,74,48.6,38,27,0,27,28,85,52,0,Matches
Fransérgio,br BRA,MF,Bordeaux,30,1990,14.0,24,10,8,12,4,12,43,27.9,31,18,6,12,23,47,23,0,Matches

Angelo Fulgini,fr FRA,"MF,FW",Angers,24,1996,32.5,35,25,8,18,9,14,44,31.8,30,21,5,16,22,57,5,1,Matches
Gauthier Gallon,fr FRA,GK,Troyes,28,1993,31.0,3,0,3,0,0,1,1,100.0,0,0,0,0,2,5,12,1,Matches
Kévin Gameiro,fr FRA,FW,Strasbourg,34,1987,26.5,19,10,5,9,5,6,18,33.3,12,22,1,21,6,25,1,0,Matches
Idrissa Gana Gueye,sn SEN,MF,Paris S-G,31,1989,18.2,60,36,24,24,12,18,44,40.9,26,23,4,19,24,84,13,0,Matches
Ignatius Ganago,cm CMR,FW,Lens,22,1999,11.4,3,2,1,2,0,2,6,33.3,4,4,0,4,2,5,3,0,Matches
Djeidi Gassama,fr FRA,FW,Paris S-G,17,2003,0.0,0,0,0,0,0,0,0,,0,1,1,0,0,0,0,0,Matches
Johan Gastien,fr FRA,MF,Clermont Foot,33,1988,30.5,56,34,26,25,5,27,74,36.5,47,45,11,34,53,109,49,1,Matches
Valère Germain,fr FRA,FW,Montpellier,31,1990,21.9,23,14,6,11,6,8,31,25.8,23,13,1,12,9,32,27,0,Matches
Gerson,br BRA,"MF,FW",Marseille,24,1997,28.3,42,17,16,20,6,8,35,22.9,27,26,4,22,16,58,16,2,Matches
Willem Geubbels,fr FRA,"FW,MF",Nantes,19,2001,6.0,8,5,4,2,2,5,12,41.7,7,5,0,5,6,14,5,0,Matches
Ismaël Gharbi,es ESP,FW,Paris S-G,17,2004,0.0,0,0,0,0,0,0,0,,0,0,0,0,0,0,0,0,Matches
Lamine Ghezali,fr FRA,DF,Saint-Étienne,22,1999,0.0,0,0,0,0,0,0,0,,0,1,0,1,0,0,0,0,Matches
Nicholas Gioacchini,us USA,"FW,MF",Montpellier,21,2000,5.5,7,5,3,2,2,4,10,40.0,6,8,0,8,4,11,5,0,Matches
Jimmy Giraudon,fr FRA,DF,Troyes,29,1992,18.0,14,6,10,4,0,7,22,31.8,15,24,14,10,37,51,68,1,Matches
Andrei Girotto,br BRA,"DF,MF",Nantes,29,1992,35.0,85,52,49,32,4,52,103,50.5,51,67,33,34,69,154,143,0,Matches
Aleksandr Golovin,ru RUS,"FW,MF",Monaco,25,1996,16.7,40,22,10,18,12,18,41,43.9,23,26,1,25,12,52,8,0,Matches
Angel Gomes,eng ENG,"MF,FW",Lille,20,2000,10.6,23,13,6,12,5,10,15,66.7,5,4,0,4,3,26,4,0,Matches
Alfred Gomis,sn SEN,GK,Rennes,27,1993,25.0,1,0,1,0,0,1,2,50.0,1,0,0,0,1,2,8,2,Matches
Vagner Gonçalves,cv CPV,FW,Metz,25,1996,1.0,2,1,0,2,0,1,1,100.0,0,0,0,0,1,3,0,0,Matches
Álvaro González,es ESP,DF,Marseille,31,1990,5.0,1,1,1,0,0,1,1,100.0,0,0,0,0,1,2,9,0,Matches
Amine Gouiri,dz ALG,"FW,MF",Nice,21,2000,30.6,22,13,2,13,7,10,32,31.3,22,22,5,17,11,33,17,1,Matches
Lucas Gourna-Douath,fr FRA,MF,Saint-Étienne,17,2003,20.0,45,26,22,18,5,21,36,58.3,15,22,3,19,13,58,9,2,Matches
Jonathan Gradit,fr FRA,DF,Lens,28,1992,34.1,60,28,24,28,8,25,45,55.6,20,39,27,12,65,125,106,0,Matches
Andrew Gravillon,gp GLP,DF,Reims,23,1998,23.7,32,24,19,13,0,17,27,63.0,10,25,15,10,33,65,83,1,Matches
Adrian Grbić,at AUT,"FW,MF",Lorient,24,1996,5.8,2,1,0,2,0,2,6,33.3,4,3,1,2,0,2,7,0,Matches

Ivo Grbić,hr CRO,GK,Lille,25,1996,21.0,0,0,0,0,0,0,0,,0,0,0,0,0,0,14,1,Matches
Etienne Green,eng ENG,GK,Saint-Étienne,21,2000,13.3,1,1,1,0,0,0,0,,0,0,0,0,1,2,9,0,Matches
Gabriel Gudmundsson,se SWE,"DF,MF",Lille,22,1999,14.9,43,31,24,16,3,17,35,48.6,18,15,3,12,20,63,13,0,Matches
Noah Guede-Nadje,fr FRA,MF,Angers,17,2003,0.0,0,0,0,0,0,0,0,,0,0,0,0,0,0,0,0,Matches
Mattéo Guendouzi,fr FRA,MF,Marseille,22,1999,35.0,45,30,10,26,9,13,47,27.7,34,15,1,14,16,61,18,0,Matches
Yanis Guermouche,fr FRA,"MF,FW",Montpellier,20,2001,0.1,2,1,0,1,1,1,1,100.0,0,0,0,0,0,2,0,0,Matches
Evann Guessand,ci CIV,FW,Nice,20,2001,4.9,9,8,2,5,2,3,8,37.5,5,4,0,4,0,9,1,0,Matches
Lamine Gueye,sn SEN,"FW,MF",Metz,23,1998,6.2,5,5,1,1,3,3,7,42.9,4,4,0,4,6,11,1,0,Matches
Pape Gueye,sn SEN,MF,Marseille,22,1999,17.0,38,19,15,22,1,16,31,51.6,15,15,3,12,24,62,16,0,Matches
Josuha Guilavogui,fr FRA,"MF,DF",Bordeaux,30,1990,14.8,39,16,18,17,4,14,29,48.3,15,16,8,8,36,75,23,0,Matches
Frederic Guilbert,fr FRA,DF,Strasbourg,26,1994,28.0,69,39,33,24,12,32,62,51.6,30,37,11,26,55,124,39,0,Matches
Bruno Guimarães,br BRA,MF,Lyon,23,1997,18.2,50,31,20,25,5,23,59,39.0,36,21,4,17,21,71,11,1,Matches
Serhou Guirassy,gn GUI,FW,Rennes,25,1996,11.3,4,2,1,2,1,1,7,14.3,6,4,0,4,1,5,8,0,Matches
Malo Gusto,fr FRA,DF,Lyon,18,2003,20.9,55,35,29,21,5,24,40,60.0,16,21,6,15,33,88,41,1,Matches
Massadio Haïdara,ml MLI,DF,Lens,28,1992,12.0,28,21,18,7,3,15,24,62.5,9,18,4,14,22,50,31,0,Matches
Oualid El Hajjam,ma MAR,DF,Troyes,30,1991,11.9,22,11,12,6,4,15,23,65.2,8,12,6,6,22,44,28,0,Matches
Achraf Hakimi,ma MAR,DF,Paris S-G,22,1998,27.5,74,51,38,27,9,40,72,55.6,32,26,5,21,28,102,23,2,Matches
Pierre-Yves Hamel,fr FRA,"FW,MF",Lorient,27,1994,0.3,0,0,0,0,0,0,1,0.0,1,0,0,0,2,2,0,0,Matches
Pierre-Yves Hamel,fr FRA,FW,Clermont Foot,27,1994,5.8,11,6,0,5,6,5,6,83.3,1,2,1,1,0,11,0,0,Matches
Romain Hamouma,fr FRA,"FW,MF",Saint-Étienne,34,1987,9.8,10,7,1,5,4,2,13,15.4,11,8,0,8,4,14,1,0,Matches
Amine Harit,ma MAR,"FW,MF",Marseille,24,1997,12.9,18,11,9,9,0,9,17,52.9,8,10,0,10,4,22,2,0,Matches
Henrique,br BRA,DF,Lyon,27,1994,12.3,13,7,10,1,2,5,16,31.3,11,13,1,12,22,35,14,0,Matches
Luis Henrique,br BRA,"FW,MF",Marseille,19,2001,7.8,4,3,2,1,1,2,5,40.0,3,2,0,2,5,9,1,0,Matches
Christophe Hérelle,mq MTQ,DF,Brest,28,1992,21.5,48,28,30,16,2,17,26,65.4,9,20,15,5,44,92,84,1,Matches
Jérôme Hergault,fr FRA,DF,Lorient,35,1986,3.9,3,1,1,2,0,2,5,40.0,3,4,1,3,4,7,7,0,Matches

Ander Herrera,es ESP,MF,Paris S-G,31,1989,12.1,29,17,7,16,6,14,39,35.9,25,22,8,14,14,43,8,0,Matches
Franck Honorat,fr FRA,"FW,MF",Brest,24,1996,32.2,54,38,25,13,16,27,47,57.4,20,24,2,22,15,69,25,0,Matches
Fraser Hornby,sct SCO,"FW,MF",Reims,21,1999,3.9,3,1,1,2,0,0,2,0.0,2,3,0,3,4,7,5,0,Matches
Cédric Hountondji,bj BEN,DF,Clermont Foot,27,1994,22.6,33,17,20,12,1,16,24,66.7,8,23,12,11,34,67,76,0,Matches
Suk Hyun-jun,kr KOR,"FW,MF",Troyes,30,1991,1.7,0,0,0,0,0,0,0,,0,2,0,2,0,0,2,0,Matches
Mauro Icardi,ar ARG,FW,Paris S-G,28,1993,11.4,5,3,1,3,1,3,7,42.9,4,3,0,3,5,10,12,0,Matches
Jonathan Iglesias,uy URU,MF,Clermont Foot,32,1988,6.4,18,11,6,10,2,10,18,55.6,8,8,2,6,5,23,2,1,Matches
Juan Ignacio Ramírez,uy URU,FW,Saint-Étienne,24,1997,1.4,2,1,0,1,1,0,0,,0,0,0,0,0,2,0,0,Matches
Danylo Ihnatenko,ua UKR,MF,Bordeaux,24,1997,7.7,17,9,8,7,2,10,24,41.7,14,9,2,7,6,23,17,1,Matches
Jonathan Ikone,fr FRA,"MF,FW",Lille,23,1998,11.8,11,3,6,4,1,4,11,36.4,7,13,1,12,5,16,4,0,Matches
Bonke Innocent,ng NGA,MF,Lorient,25,1996,9.7,27,16,10,16,1,11,26,42.3,15,11,3,8,16,43,14,0,Matches
Wilson Isidor,fr FRA,"FW,MF",Monaco,20,2000,0.6,0,0,0,0,0,0,4,0.0,4,1,0,1,0,0,0,0,Matches
Ismail Jakobs,sn SEN,"DF,FW",Monaco,21,1999,13.4,32,16,14,15,3,16,35,45.7,19,16,1,15,17,49,31,0,Matches
Marin Jakoliš,hr CRO,FW,Angers,24,1996,2.5,2,1,0,1,1,0,6,0.0,6,0,0,0,1,3,0,0,Matches
Abdel Jalil Medioub,dz ALG,DF,Bordeaux,23,1997,6.9,9,5,5,3,1,3,4,75.0,1,8,4,4,12,21,34,0,Matches
Léo Jardim,br BRA,GK,Lille,26,1995,17.0,0,0,0,0,0,0,0,,0,0,0,0,1,1,10,0,Matches
Corentin Jean,fr FRA,"FW,MF",Lens,26,1995,2.8,9,6,4,4,1,3,6,50.0,3,5,0,5,1,10,0,0,Matches
Jemerson,br BRA,DF,Metz,28,1992,13.4,37,25,30,7,0,18,26,69.2,8,23,8,15,25,62,33,1,Matches
Moritz Jenz,de GER,DF,Lorient,22,1999,15.3,26,12,18,6,2,11,24,45.8,13,19,11,8,28,54,55,0,Matches
Lenny Joseph,fr FRA,"FW,MF",Metz,20,2000,1.7,2,1,1,1,0,0,0,,0,3,0,3,0,2,0,0,Matches
Issa Kaboré,bf BFA,"DF,MF",Troyes,20,2001,25.0,45,22,22,14,9,20,38,52.6,18,27,2,25,20,65,38,1,Matches
Tino Kadewere,zw ZIM,FW,Lyon,25,1996,5.6,7,5,2,2,3,4,13,30.8,9,7,0,7,4,11,1,1,Matches
Gaël Kakuta,cd COD,"MF,FW",Lens,30,1991,18.6,22,14,2,13,7,4,20,20.0,16,10,0,10,4,26,3,0,Matches
Arnaud Kalimuendo,fr FRA,FW,Lens,19,2002,23.9,9,8,1,3,5,2,7,28.6,5,6,1,5,8,17,0,0,Matches
Arnaud Kalimuendo,fr FRA,FW,Paris S-G,19,2002,0.1,0,0,0,0,0,0,0,,0,0,0,0,0,0,0,0,Matches

Samuel Kalu,ng NGA,"FW,MF",Bordeaux,23,1997,3.6,8,5,3,4,1,2,5,40.0,3,2,0,2,3,11,1,0,Matches
Boubacar Kamara,fr FRA,"MF,DF",Marseille,21,1999,30.9,68,38,27,36,5,26,47,55.3,21,29,10,19,46,114,44,1,Matches
Hassane Kamara,ci CIV,"MF,DF",Nice,27,1994,6.0,13,10,4,6,3,5,8,62.5,3,10,2,8,9,22,4,0,Matches
Jean-Armel Kana-Biyik,cm CMR,DF,Metz,32,1989,7.4,10,6,8,2,0,4,9,44.4,5,11,4,7,16,26,22,1,Matches
Nordine Kandil,fr FRA,"MF,FW",Strasbourg,19,2001,1.0,2,1,2,0,0,1,1,100.0,0,1,1,0,0,2,0,0,Matches
Eiji Kawashima,jp JPN,GK,Strasbourg,38,1983,1.0,0,0,0,0,0,0,0,,0,0,0,0,0,0,0,0,Matches
Ilan Kebbal,dz ALG,"MF,FW",Reims,23,1998,19.7,31,15,13,10,8,12,44,27.3,32,16,0,16,13,44,3,0,Matches
Thilo Kehrer,de GER,DF,Paris S-G,24,1996,16.8,21,14,9,11,1,9,21,42.9,12,19,11,8,24,45,29,0,Matches
Habib Keita,ml MLI,"MF,FW",Lyon,19,2002,0.1,0,0,0,0,0,0,0,,0,0,0,0,0,0,0,0,Matches
Saîf-Eddine Khaoui,tn TUN,"MF,FW",Clermont Foot,26,1995,10.3,19,10,5,10,4,9,18,50.0,9,9,0,9,14,33,5,0,Matches
Wahbi Khazri,tn TUN,"FW,MF",Saint-Étienne,30,1991,24.7,33,18,7,17,9,9,34,26.5,25,21,0,21,12,45,7,0,Matches
Presnel Kimpembe,fr FRA,DF,Paris S-G,25,1995,28.6,34,19,18,15,1,14,23,60.9,9,20,14,6,38,72,73,1,Matches
Thibault Klidje,tg TOG,"MF,FW",Bordeaux,20,2001,1.0,0,0,0,0,0,0,1,0.0,1,1,1,0,2,2,0,0,Matches
Justin Kluivert,nl NED,MF,Nice,22,1999,20.8,19,9,6,12,1,5,21,23.8,16,13,1,12,14,33,6,0,Matches
Samuel Koeberlé,fr FRA,FW,Reims,16,2004,0.0,0,0,0,0,0,0,0,,0,0,0,0,0,0,0,0,Matches
Philippe Koffi,ci CIV,FW,Reims,19,2002,4.2,4,0,0,3,1,0,2,0.0,2,2,1,1,3,7,3,0,Matches
Sead Kolašinac,ba BIH,DF,Marseille,28,1993,4.9,7,6,2,3,2,5,8,62.5,3,4,0,4,0,7,7,1,Matches
Randal Kolo Muani,fr FRA,"FW,MF",Nantes,22,1998,32.8,28,14,7,10,11,10,25,40.0,15,14,3,11,6,34,31,0,Matches
Timothée Kolodziejczak,fr FRA,DF,Saint-Étienne,29,1991,28.5,43,24,22,14,7,20,36,55.6,16,29,7,22,60,103,72,1,Matches
Ghislain Konan,ci CIV,DF,Reims,25,1995,26.9,35,19,19,15,1,16,30,53.3,14,35,8,27,28,63,45,0,Matches
Ibrahima Koné,ml MLI,FW,Lorient,22,1999,8.1,7,4,0,3,4,2,3,66.7,1,8,3,5,1,8,3,0,Matches
Youssouf Koné,ml MLI,DF,Troyes,26,1995,10.9,30,18,21,8,1,19,30,63.3,11,8,3,5,10,40,25,0,Matches
Laurent Koscielny,fr FRA,DF,Bordeaux,35,1985,10.4,14,9,10,3,1,8,13,61.5,5,17,12,5,12,26,39,0,Matches
Rominigue Kouamé,ml MLI,MF,Troyes,24,1996,33.0,47,22,24,20,3,19,58,32.8,39,33,5,28,46,93,22,2,Matches
Boubakar Kouyaté,ml MLI,DF,Metz,24,1997,29.6,84,50,56,28,0,48,77,62.3,29,63,33,30,79,163,217,3,Matches

Jean-Philippe Krasso,ci CIV,FW,Saint-Étienne,24,1997,5.0,7,5,0,5,2,2,10,20.0,8,7,1,6,0,7,1,0,Matches
Mykola Kukharevych,ua UKR,FW,Troyes,20,2001,0.2,0,0,0,0,0,0,0,,0,0,0,0,0,0,0,0,Matches
Enock Kwateng,fr FRA,DF,Bordeaux,24,1997,22.2,54,35,31,19,4,33,72,45.8,39,17,4,13,43,97,48,1,Matches
Grejohn Kyei,fr FRA,FW,Clermont Foot,25,1995,4.4,3,2,1,1,1,0,6,0.0,6,6,0,6,0,3,1,0,Matches
Gaëtan Laborde,fr FRA,FW,Montpellier,27,1994,3.8,2,2,1,1,0,2,4,50.0,2,3,0,3,5,7,5,0,Matches
Gaëtan Laborde,fr FRA,FW,Rennes,27,1994,30.3,19,7,5,8,6,3,22,13.6,19,29,3,26,8,27,16,0,Matches
Tom Lacoux,fr FRA,"DF,MF",Bordeaux,19,2002,10.1,18,13,11,5,2,9,24,37.5,15,14,4,10,9,27,20,1,Matches
Lenny Lacroix,fr FRA,DF,Metz,18,2003,2.2,9,7,8,1,0,5,8,62.5,3,5,1,4,10,19,5,0,Matches
Alban Lafont,fr FRA,GK,Nantes,22,1999,38.0,3,3,3,0,0,3,8,37.5,5,1,0,1,1,4,25,2,Matches
Mohamed Lamine Bayo,gn GUI,FW,Clermont Foot,23,1998,26.8,12,5,4,3,5,3,24,12.5,21,7,1,6,7,19,14,0,Matches
Didier Lamkel Zé,cm CMR,FW,Metz,24,1996,6.7,3,1,1,0,2,1,3,33.3,2,3,1,2,1,4,7,0,Matches
Julien Laporte,fr FRA,DF,Lorient,27,1993,32.1,63,45,35,26,2,32,64,50.0,32,37,22,15,54,117,174,0,Matches
Yasser Larouci,dz ALG,DF,Troyes,20,2001,3.8,6,5,2,4,0,3,3,100.0,0,1,0,1,7,13,5,0,Matches
Paul Lasne,fr FRA,MF,Brest,32,1989,9.4,26,12,6,16,4,8,18,44.4,10,11,2,9,24,50,10,0,Matches
Armand Lauriente,fr FRA,"FW,MF",Lorient,22,1998,27.5,33,18,9,16,8,11,30,36.7,19,27,2,25,15,48,3,0,Matches
Théo Le Bris,fr FRA,MF,Lorient,18,2002,0.7,2,1,1,1,0,1,2,50.0,1,2,0,2,0,2,1,0,Matches
Jérémy Le Douaron,fr FRA,"FW,MF",Brest,23,1998,16.1,11,5,4,4,3,1,17,5.9,16,15,0,15,4,15,14,0,Matches
Enzo Le Fée,fr FRA,"MF,FW",Lorient,21,2000,24.4,70,44,25,36,9,41,90,45.6,49,25,1,24,29,99,18,0,Matches
Vincent Le Goff,fr FRA,DF,Lorient,31,1989,34.0,61,38,38,19,4,37,62,59.7,25,18,3,15,37,98,50,0,Matches
Maxime Le Marchand,fr FRA,DF,Strasbourg,31,1989,9.6,17,8,16,1,0,8,10,80.0,2,9,5,4,14,31,32,0,Matches
Jean-Louis Leca,fr FRA,GK,Lens,35,1985,25.7,0,0,0,0,0,0,0,,0,1,0,1,1,1,11,1,Matches
Félix Lemaréchal,fr FRA,MF,Monaco,17,2003,0.1,0,0,0,0,0,0,1,0.0,1,0,0,0,0,0,0,0,Matches
Mario Lemina,ga GAB,MF,Nice,27,1993,21.9,62,35,25,33,4,28,38,73.7,10,32,9,23,48,110,37,0,Matches
Fabien Lemoine,fr FRA,MF,Lorient,34,1987,12.4,35,22,20,14,1,17,41,41.5,24,21,4,17,14,49,24,1,Matches
Léo Leroy,fr FRA,MF,Montpellier,21,2000,7.0,31,21,17,11,3,12,34,35.3,22,20,4,16,8,39,8,0,Matches

Alexandre Letellier,fr FRA,GK,Paris S-G,30,1990,0.1,0,0,0,0,0,0,0,,0,0,0,0,0,0,0,0,Matches
Yanis Lhery,fr FRA,"FW,MF",Saint-Étienne,18,2003,0.8,0,0,0,0,0,0,0,,0,4,0,4,0,0,0,0,Matches
Dimitri Liénard,fr FRA,"DF,MF",Strasbourg,33,1988,22.7,71,43,40,21,10,46,77,59.7,31,12,0,12,21,92,28,0,Matches
Isaac Lihadji,fr FRA,"MF,FW",Lille,19,2002,2.6,3,3,1,1,1,1,5,20.0,4,1,0,1,2,5,0,0,Matches
Pol Lirola,es ESP,"DF,FW",Marseille,23,1997,19.7,28,16,15,9,4,13,28,46.4,15,15,0,15,13,41,22,0,Matches
Bradley Locko,fr FRA,"MF,DF",Reims,19,2002,11.2,28,19,13,11,4,14,24,58.3,10,20,8,12,14,42,15,0,Matches
Anthony Lopes,pt POR,GK,Lyon,30,1990,33.1,0,0,0,0,0,0,0,,0,0,0,0,3,3,12,3,Matches
Pau López,es ESP,GK,Marseille,26,1994,29.0,0,0,0,0,0,0,1,0.0,1,0,0,0,0,0,12,1,Matches
Dion Lopy,sn SEN,MF,Reims,19,2002,18.2,53,29,22,24,7,21,53,39.6,32,20,4,16,22,75,17,0,Matches
Samuel Loric,fr FRA,DF,Lorient,21,2000,3.0,7,5,2,3,2,5,8,62.5,3,2,0,2,5,12,9,0,Matches
Jordan Lotomba,ch SUI,DF,Nice,22,1998,19.8,33,17,21,9,3,16,30,53.3,14,17,4,13,12,45,28,0,Matches
Johaneko Louisjean,fr FRA,DF,Bordeaux,17,2004,0.1,0,0,0,0,0,0,0,,0,0,0,0,0,0,0,0,Matches
Jean Lucas,br BRA,MF,Monaco,23,1998,16.1,43,25,14,24,5,17,40,42.5,23,15,5,10,13,56,4,1,Matches
Castello Lukeba,fr FRA,DF,Lyon,18,2002,23.3,34,19,27,7,0,15,23,65.2,8,18,9,9,38,72,64,2,Matches
Levi Lumeka,eng ENG,"DF,FW",Troyes,22,1998,0.7,0,0,0,0,0,0,2,0.0,2,0,0,0,0,0,2,0,Matches
Yannis M'Bemba,ga GAB,"DF,FW",Nantes,20,2001,0.1,0,0,0,0,0,0,0,,0,0,0,0,0,0,1,0,Matches
Deiver Machado,co COL,"DF,MF",Lens,27,1993,5.8,16,14,11,1,4,12,14,85.7,2,9,1,8,3,19,12,1,Matches
Yvann Macon,fr FRA,DF,Saint-Étienne,22,1998,17.0,41,22,24,14,3,16,42,38.1,26,18,4,14,18,59,27,0,Matches
Louis Mafouta,cf CTA,FW,Metz,27,1994,5.8,0,0,0,0,0,0,5,0.0,5,1,0,1,0,0,4,0,Matches
Hugo Magnetti,fr FRA,MF,Brest,23,1998,16.3,50,34,27,20,3,22,50,44.0,28,14,3,11,25,75,13,0,Matches
Yohann Magnin,fr FRA,"MF,DF",Clermont Foot,24,1997,19.1,53,31,22,26,5,24,42,57.1,18,17,7,10,20,73,36,0,Matches
Habib Maïga,ci CIV,MF,Metz,25,1996,14.1,47,28,29,13,5,24,48,50.0,24,20,7,13,14,61,18,0,Matches
Josh Maja,ng NGA,FW,Bordeaux,22,1998,0.1,0,0,0,0,0,0,0,,0,1,0,1,0,0,0,0,Matches
Abdul Majeed Waris,gh GHA,"FW,MF",Strasbourg,29,1991,3.6,5,3,2,3,0,5,10,50.0,5,2,0,2,0,5,1,0,Matches
Lovro Majer,hr CRO,"MF,FW",Rennes,23,1998,20.4,32,21,9,14,9,11,42,26.2,31,26,2,24,11,43,9,0,Matches

Béni Makouana,cg CGO,"FW,MF",Montpellier,18,2002,3.6,2,2,0,0,2,0,1,0.0,1,1,0,1,3,5,2,0,Matches
Hianga Mananga Mbock,fr FRA,MF,Brest,21,1999,8.9,18,12,8,7,3,9,21,42.9,12,5,2,3,5,23,6,0,Matches
Vincent Manceau,fr FRA,DF,Angers,32,1989,26.2,32,19,18,13,1,14,37,37.8,23,23,6,17,32,64,72,0,Matches
Steve Mandanda,fr FRA,GK,Marseille,36,1985,9.0,0,0,0,0,0,0,1,0.0,1,1,0,1,1,1,4,1,Matches
Reinildo Mandava,mz MOZ,DF,Lille,27,1994,16.9,43,23,29,11,3,32,51,62.7,19,13,4,9,37,80,55,0,Matches
Anthony Mandrea,dz ALG,GK,Angers,24,1996,10.0,0,0,0,0,0,0,0,,0,0,0,0,0,0,9,0,Matches
Eliaquim Mangala,fr FRA,DF,Saint-Étienne,30,1991,13.1,17,12,12,5,0,8,12,66.7,4,11,8,3,17,34,61,1,Matches
Thomas Mangani,fr FRA,MF,Angers,34,1987,24.4,58,30,23,34,1,31,68,45.6,37,38,11,27,36,94,29,0,Matches
Ricardo Mangas,pt POR,DF,Bordeaux,23,1998,26.1,35,22,22,8,5,26,41,63.4,15,18,4,14,25,60,47,3,Matches
Myziane Maolida,km COM,MF,Nice,22,1999,0.4,1,0,0,1,0,0,0,,0,1,0,1,0,1,0,0,Matches
Sekou Mara,fr FRA,"FW,MF",Bordeaux,19,2002,10.1,8,4,1,1,6,1,8,12.5,7,7,0,7,2,10,6,0,Matches
Marcelo,br BRA,DF,Bordeaux,34,1987,10.0,9,5,7,2,0,4,6,66.7,2,4,3,1,13,22,46,1,Matches
Marcelo,br BRA,DF,Lyon,34,1987,2.0,4,3,0,4,0,4,6,66.7,2,3,2,1,4,8,10,0,Matches
Guillermo Maripán,cl CHI,DF,Monaco,27,1994,20.4,36,24,27,9,0,20,40,50.0,20,21,14,7,25,61,66,1,Matches
Marquinhos,br BRA,DF,Paris S-G,27,1994,31.8,37,14,25,11,1,20,35,57.1,15,35,19,16,16,53,102,0,Matches
Jonas Martin,fr FRA,MF,Rennes,31,1990,23.4,35,20,12,21,2,19,53,35.8,34,17,3,14,22,57,28,1,Matches
Gelson Martins,pt POR,"MF,FW",Monaco,26,1995,21.2,42,27,10,26,6,21,59,35.6,38,26,1,25,17,59,4,0,Matches
Pape Matar Sarr,sn SEN,MF,Metz,18,2002,23.7,45,26,21,23,1,18,39,46.2,21,33,3,30,29,74,22,0,Matches
Eliot Matazo,be BEL,MF,Monaco,19,2002,8.8,8,7,4,4,0,2,11,18.2,9,11,3,8,13,21,9,0,Matches
Chrislain Matsima,fr FRA,DF,Monaco,19,2002,1.5,3,2,1,2,0,2,7,28.6,5,3,3,0,1,4,6,1,Matches
Azor Matusiwa,nl NED,MF,Reims,23,1998,27.4,58,32,28,26,4,26,55,47.3,29,49,19,30,62,120,43,0,Matches
Stephy Mavididi,eng ENG,"FW,MF",Montpellier,23,1998,25.5,24,13,11,7,6,14,39,35.9,25,23,2,21,8,32,11,0,Matches
Derek Mazou-Sacko,fr FRA,"FW,DF",Troyes,16,2004,0.0,1,0,0,0,1,1,1,100.0,0,0,0,0,0,1,1,0,Matches
Kylian Mbappé,fr FRA,FW,Paris S-G,22,1998,33.6,11,8,1,4,6,7,13,53.8,6,6,0,6,5,16,13,0,Matches
Amadou Mbengue,sn SEN,"DF,MF",Metz,19,2002,6.8,19,10,10,9,0,11,22,50.0,11,7,2,5,10,29,19,0,Matches

Jason Mbock,fr FRA,FW,Angers,21,1999,0.2,0,0,0,0,0,0,0,,0,0,0,0,0,0,0,0,Matches
Moustapha Mbow,sn SEN,DF,Reims,21,2000,1.0,6,6,3,2,1,3,3,100.0,0,0,0,0,1,7,6,0,Matches
Nathanael Mbuku,fr FRA,"FW,MF",Reims,19,2002,15.8,14,13,4,7,3,2,8,25.0,6,14,0,14,11,25,4,0,Matches
Facundo Medina,ar ARG,DF,Lens,22,1999,28.8,61,42,34,23,4,38,62,61.3,24,24,8,16,37,98,78,3,Matches
Farid El Melali,dz ALG,FW,Angers,24,1997,0.2,0,0,0,0,0,0,1,0.0,1,1,0,1,0,0,1,0,Matches
Birger Meling,no NOR,DF,Rennes,26,1994,20.3,43,27,25,11,7,23,31,74.2,8,23,7,16,22,65,40,0,Matches
Houboulang Mendes,gw GNB,DF,Lorient,23,1998,35.8,58,28,37,18,3,40,57,70.2,17,41,21,20,41,99,128,4,Matches
Nuno Mendes,pt POR,DF,Paris S-G,19,2002,18.4,48,29,23,18,7,25,47,53.2,22,27,5,22,21,69,17,1,Matches
Pedro Mendes,pt POR,DF,Montpellier,30,1990,0.2,1,1,1,0,0,0,0,,0,1,1,0,0,1,2,0,Matches
Thiago Mendes,br BRA,"MF,DF",Lyon,29,1992,20.7,36,22,18,16,2,12,30,40.0,18,24,5,19,34,70,56,1,Matches
Arial Mendy,sn SEN,"DF,FW",Clermont Foot,26,1994,8.8,6,4,4,2,0,2,11,18.2,9,6,1,5,7,13,17,0,Matches
Batista Mendy,fr FRA,"MF,DF",Angers,21,2000,26.8,49,28,21,22,6,23,45,51.1,22,37,6,31,34,83,40,0,Matches
Gideon Mensah,gh GHA,DF,Bordeaux,23,1998,13.4,37,24,19,12,6,18,38,47.4,20,11,2,9,16,53,21,0,Matches
Quentin Merlin,fr FRA,"DF,MF",Nantes,19,2002,21.4,45,28,19,20,6,26,49,53.1,23,25,4,21,27,72,29,2,Matches
Lionel Messi,ar ARG,"FW,MF",Paris S-G,34,1987,23.9,10,3,1,5,4,3,13,23.1,10,5,0,5,4,14,0,0,Matches
Mexer,mz MOZ,DF,Bordeaux,32,1988,13.6,14,10,11,3,0,11,17,64.7,6,12,7,5,21,35,60,2,Matches
Edouard Michut,fr FRA,MF,Paris S-G,18,2003,0.8,0,0,0,0,0,0,2,0.0,2,2,0,2,1,1,2,0,Matches
Georges Mikautadze,ge GEO,FW,Metz,20,2000,0.0,0,0,0,0,0,0,0,,0,0,0,0,0,0,0,0,Matches
William Mikelbrencis,fr FRA,DF,Metz,17,2004,6.8,11,5,6,4,1,6,9,66.7,3,6,3,3,5,16,9,0,Matches
Arkadiusz Milik,pl POL,FW,Marseille,27,1994,15.7,9,2,0,5,4,4,18,22.2,14,9,1,8,3,12,10,1,Matches
Terem Moffi,ng NGA,FW,Lorient,22,1999,30.1,17,10,3,12,2,9,32,28.1,23,11,2,9,4,21,22,0,Matches
Dion Moise Sahi,ci CIV,"FW,MF",Strasbourg,19,2001,1.4,0,0,0,0,0,0,0,,0,1,0,1,1,1,1,0,Matches
Florent Mollet,fr FRA,"FW,MF",Montpellier,29,1991,29.2,31,22,14,12,5,14,57,24.6,43,27,4,23,24,55,13,0,Matches
Thomas Monconduit,fr FRA,MF,Lorient,30,1991,25.0,41,25,19,17,5,20,57,35.1,37,21,10,11,22,63,51,1,Matches
Jérémy Morel,mg MAD,DF,Lorient,37,1984,6.7,13,9,8,4,1,6,6,100.0,0,9,7,2,7,20,31,0,Matches

Lebo Mothiba,za RSA,"FW,MF",Troyes,25,1996,5.8,8,4,4,3,1,2,5,40.0,3,3,0,3,2,10,0,0,Matches
Lebo Mothiba,za RSA,FW,Strasbourg,25,1996,0.0,0,0,0,0,0,0,0,,0,0,0,0,0,0,0,0,Matches
Baptiste Mouazan,fr FRA,MF,Lorient,19,2001,1.1,4,3,2,2,0,1,3,33.3,2,3,0,3,1,5,1,0,Matches
Aimen Moueffek,fr FRA,MF,Saint-Étienne,20,2001,4.8,7,4,2,3,2,2,8,25.0,6,3,0,3,2,9,4,0,Matches
Harold Moukoudi,cm CMR,DF,Saint-Étienne,23,1997,18.5,25,12,17,8,0,14,25,56.0,11,27,14,13,35,60,48,0,Matches
Jessy Moulin,fr FRA,GK,Troyes,35,1986,7.0,0,0,0,0,0,0,0,,0,0,0,0,1,1,7,0,Matches
Steve Mounié,bj BEN,FW,Brest,26,1994,25.7,17,6,3,12,2,4,27,14.8,23,13,1,12,6,23,12,0,Matches
Samuel Moutoussamy,cd COD,MF,Nantes,24,1996,16.8,48,32,20,20,8,23,62,37.1,39,14,2,12,17,65,16,0,Matches
Marshall Munetsi,zw ZIM,"MF,DF",Reims,25,1996,20.9,34,17,21,11,2,17,39,43.6,22,39,13,26,43,77,72,2,Matches
Junior Mwanga,fr FRA,DF,Bordeaux,18,2003,1.0,5,2,4,1,0,3,3,100.0,0,1,0,1,0,5,1,0,Matches
Kévin N'Doram,fr FRA,MF,Metz,25,1996,13.7,10,8,3,5,2,3,20,15.0,17,24,5,19,19,29,21,0,Matches
Eric N'Jo,fr FRA,DF,Troyes,17,2004,1.1,0,0,0,0,0,0,1,0.0,1,1,1,0,2,2,1,0,Matches
Vital N'Simba,cd COD,DF,Clermont Foot,28,1993,31.0,66,45,38,23,5,36,63,57.1,27,28,7,21,29,95,30,0,Matches
Mickael Nade,fr FRA,DF,Saint-Étienne,22,1999,28.5,57,35,37,18,2,23,38,60.5,15,29,15,14,60,117,84,0,Matches
Paul Nardi,fr FRA,GK,Lorient,27,1994,22.0,1,0,1,0,0,1,2,50.0,1,0,0,0,0,1,10,2,Matches
Keylor Navas,cr CRC,GK,Paris S-G,34,1986,20.6,0,0,0,0,0,0,0,,0,0,0,0,0,0,5,1,Matches
Papa Ndiaga Yade,mr MTN,"DF,FW",Metz,21,2000,7.7,15,10,8,7,0,8,18,44.4,10,4,1,3,10,25,9,0,Matches
Tanguy Ndombele,fr FRA,MF,Lyon,24,1996,7.8,25,14,5,17,3,12,19,63.2,7,8,3,5,3,28,6,2,Matches
Dan Ndoye,ch SUI,"FW,MF",Nice,20,2000,2.3,0,0,0,0,0,0,2,0.0,2,4,0,4,0,0,0,0,Matches
Neymar,br BRA,"FW,MF",Paris S-G,29,1992,20.6,29,19,5,12,12,12,36,33.3,24,9,1,8,4,33,2,1,Matches
Yvan Neyou,cm CMR,MF,Saint-Étienne,24,1997,10.4,29,13,14,12,3,9,27,33.3,18,8,3,5,23,52,13,0,Matches
Opa Nguette,sn SEN,"FW,MF",Metz,27,1994,11.6,21,14,9,6,6,5,14,35.7,9,13,3,10,2,23,9,0,Matches
Sikou Niakaté,ml MLI,DF,Metz,22,1999,7.3,8,7,8,0,0,4,11,36.4,7,5,3,2,27,35,34,0,Matches
Ibrahima Niane,sn SEN,FW,Metz,22,1999,17.6,1,1,0,1,0,0,5,0.0,5,6,1,5,3,4,16,0,Matches
M'Baye Niang,sn SEN,FW,Bordeaux,26,1994,8.6,4,0,0,2,2,0,4,0.0,4,9,1,8,1,5,4,0,Matches

Cheikh Niasse,sn SEN,"FW,MF",Lille,21,2000,0.5,2,2,0,2,0,2,3,66.7,1,1,1,0,1,3,2,0,Matches
Casimir Ninga,td CHA,FW,Angers,28,1993,4.5,5,1,1,4,0,2,5,40.0,3,2,0,2,1,6,0,0,Matches
Arnaud Nordin,fr FRA,"FW,MF",Saint-Étienne,23,1998,20.8,21,11,8,8,5,8,22,36.4,14,19,0,19,6,27,8,0,Matches
Alexander Nübel,de GER,GK,Monaco,24,1996,38.0,0,0,0,0,0,0,1,0.0,1,0,0,0,0,0,11,1,Matches
Gerzino Nyamsi,fr FRA,DF,Strasbourg,24,1997,33.2,35,21,24,9,2,20,27,74.1,7,25,16,9,25,60,90,1,Matches
Florent Ogier,fr FRA,DF,Clermont Foot,32,1989,27.0,31,17,18,12,1,17,31,54.8,14,41,27,14,37,68,89,0,Matches
Warmed Omari,km COM,DF,Rennes,21,2000,31.1,33,17,22,10,1,15,23,65.2,8,20,13,7,31,64,94,5,Matches
Jonas Omlin,ch SUI,GK,Montpellier,27,1994,28.7,2,1,2,0,0,2,3,66.7,1,0,0,0,0,2,12,3,Matches
Amadou Onana,be BEL,MF,Lille,19,2001,15.1,48,31,17,27,4,18,25,72.0,7,10,3,7,30,78,19,0,Matches
Jean Onana,cm CMR,MF,Bordeaux,21,2000,20.4,70,49,33,33,4,35,86,40.7,51,37,5,32,36,106,23,1,Matches
Otávio,br BRA,MF,Bordeaux,27,1994,12.7,36,23,13,21,2,16,39,41.0,23,9,3,6,18,54,11,0,Matches
Dango Ouattara,bf BFA,"MF,FW",Lorient,19,2002,9.0,21,15,9,11,1,11,23,47.8,12,10,1,9,14,35,15,1,Matches
Remi Oudin,fr FRA,"MF,FW",Bordeaux,24,1996,19.3,34,18,19,13,2,18,32,56.3,14,14,3,11,27,61,21,0,Matches
Alexandre Oukidja,dz ALG,GK,Metz,33,1988,20.8,0,0,0,0,0,0,1,0.0,1,1,0,1,1,1,17,2,Matches
Azzedine Ounahi,ma MAR,MF,Angers,21,2000,18.1,39,22,16,22,1,11,40,27.5,29,19,1,18,26,65,13,0,Matches
Ambroise Oyongo,cm CMR,DF,Montpellier,30,1991,7.3,13,4,7,4,2,9,15,60.0,6,5,1,4,6,19,17,0,Matches
Vincent Pajot,fr FRA,MF,Metz,30,1990,25.7,86,56,35,47,4,20,46,43.5,26,33,6,27,51,137,38,0,Matches
Nicolas Pallois,fr FRA,DF,Nantes,33,1987,27.2,51,33,40,11,0,34,59,57.6,25,40,19,21,53,104,116,1,Matches
Erik Palmer-Brown,us USA,DF,Troyes,24,1997,19.3,37,22,29,8,0,20,26,76.9,6,26,18,8,34,71,87,1,Matches
Emerson Palmieri,it ITA,DF,Lyon,26,1994,25.2,46,25,16,22,8,22,34,64.7,12,23,8,15,27,73,66,0,Matches
Lucas Paquetá,br BRA,"MF,FW",Lyon,23,1997,30.0,68,38,24,26,18,17,51,33.3,34,43,5,38,9,77,22,0,Matches
Rubén Pardo,es ESP,MF,Bordeaux,28,1992,0.1,0,0,0,0,0,0,0,,0,0,0,0,0,0,0,0,Matches
Leandro Paredes,ar ARG,MF,Paris S-G,27,1994,9.3,23,13,9,11,3,12,24,50.0,12,10,6,4,10,33,5,2,Matches
Strahinja Pavlović,rs SRB,DF,Monaco,20,2001,5.0,23,16,8,13,2,8,12,66.7,4,5,3,2,9,32,15,0,Matches
Dimitri Payet,fr FRA,"FW,MF",Marseille,34,1987,28.8,16,8,4,10,2,7,31,22.6,24,9,0,9,9,25,3,0,Matches

Timothee Pembele,fr FRA,DF,Bordeaux,18,2002,15.7,20,8,8,10,2,10,29,34.5,19,12,3,9,16,36,24,0,Matches
Brayann Pereira,fr FRA,"DF,MF",Lens,18,2003,0.2,1,1,1,0,0,1,1,100.0,0,0,0,0,0,1,1,0,Matches
Danilo Pereira,pt POR,MF,Paris S-G,29,1991,22.6,33,17,10,20,3,14,28,50.0,14,19,10,9,37,70,29,1,Matches
Mathias Pereira Lage,pt POR,DF,Angers,24,1996,11.6,21,7,10,7,4,8,30,26.7,22,18,7,11,21,42,22,0,Matches
Luan Peres Petroni,br BRA,DF,Marseille,27,1994,29.8,65,35,33,25,7,36,52,69.2,16,26,12,14,43,108,64,1,Matches
Lucas Perrin,fr FRA,DF,Strasbourg,22,1998,27.8,43,32,24,17,2,26,45,57.8,19,28,11,17,42,85,67,0,Matches
Danijel Petković,me MNE,GK,Angers,28,1993,15.0,0,0,0,0,0,0,1,0.0,1,0,0,0,1,1,9,5,Matches
Léo Pétrot,fr FRA,DF,Lorient,24,1997,20.2,31,17,23,8,0,21,29,72.4,8,33,17,16,22,53,86,0,Matches
Romain Philippoteaux,fr FRA,MF,Brest,33,1988,0.3,1,1,0,1,0,0,0,,0,0,0,0,0,1,0,0,Matches
Jérôme Phojo,fr FRA,DF,Clermont Foot,28,1993,0.1,0,0,0,0,0,0,0,,0,0,0,0,0,0,1,0,Matches
Jérémy Pied,fr FRA,"DF,FW",Lille,32,1989,0.1,0,0,0,0,0,0,0,,0,0,0,0,1,1,0,0,Matches
Ronaël Pierre-Gabriel,fr FRA,DF,Brest,23,1998,28.3,79,45,52,21,6,42,73,57.5,31,22,7,15,48,127,74,0,Matches
Julian Pollersbeck,de GER,GK,Lyon,26,1994,4.8,0,0,0,0,0,0,0,,0,0,0,0,1,1,1,0,Matches
Gaëtan Poussin,fr FRA,GK,Bordeaux,22,1999,13.0,1,1,1,0,0,1,1,100.0,0,0,0,0,0,1,15,1,Matches
Sanjin Prcić,ba BIH,MF,Strasbourg,27,1993,24.3,47,28,14,27,6,14,29,48.3,15,18,3,15,47,94,19,0,Matches
Nicolas de Préville,fr FRA,"FW,MF",Metz,30,1991,21.9,17,8,7,8,2,3,19,15.8,16,12,4,8,5,22,11,0,Matches
Nemanja Radonjić,rs SRB,FW,Marseille,25,1996,0.2,0,0,0,0,0,0,0,,0,0,0,0,0,0,0,0,Matches
Rafinha,br BRA,"FW,MF",Paris S-G,28,1993,2.4,14,8,3,9,2,7,11,63.6,4,3,0,3,4,18,0,0,Matches
Predrag Rajković,rs SRB,GK,Reims,25,1995,38.0,2,2,2,0,0,2,3,66.7,1,1,0,1,1,3,21,1,Matches
Adil Rami,fr FRA,DF,Troyes,35,1985,13.0,10,9,6,4,0,7,8,87.5,1,17,9,8,16,26,43,0,Matches
Sergio Ramos,es ESP,DF,Paris S-G,35,1986,8.9,12,5,6,6,0,8,15,53.3,7,4,2,2,8,20,27,0,Matches
Elba Rashani,xk KVX,"FW,MF",Clermont Foot,28,1993,19.5,40,21,15,21,4,17,55,30.9,38,34,3,31,11,51,20,0,Matches
Jeff Reine-Adélaïde,fr FRA,"MF,DF",Lyon,23,1998,2.2,5,3,4,1,0,4,5,80.0,1,2,0,2,0,5,0,1,Matches
Tiago Ribeiro,pt POR,FW,Monaco,19,2002,0.0,0,0,0,0,0,0,0,,0,0,0,0,0,0,0,0,Matches
Sergio Rico,es ESP,GK,Paris S-G,27,1993,0.3,0,0,0,0,0,0,0,,0,0,0,0,0,0,1,0,Matches

Renaud Ripart,fr FRA,"MF,FW",Troyes,28,1993,21.0,38,21,18,15,5,18,50,36.0,32,21,1,20,19,57,21,1,Matches
Mihailo Ristić,rs SRB,DF,Montpellier,25,1995,20.0,44,32,26,16,2,25,43,58.1,18,16,6,10,17,61,48,0,Matches
Maxence Rivera,fr FRA,FW,Saint-Étienne,19,2002,0.1,0,0,0,0,0,0,0,,0,0,0,0,0,0,0,0,Matches
Patrick Roberts,eng ENG,MF,Troyes,24,1997,0.2,0,0,0,0,0,0,0,,0,0,0,0,0,0,0,0,Matches
Stian Rode Gregersen,no NOR,DF,Bordeaux,26,1995,21.7,39,26,23,12,4,18,33,54.5,15,26,16,10,38,77,103,2,Matches
Gerson Rodrigues,lu LUX,"FW,MF",Troyes,26,1995,9.4,12,9,2,6,4,1,17,5.9,16,8,1,7,0,12,2,0,Matches
Valentin Rongier,fr FRA,"MF,DF",Marseille,26,1994,24.4,77,51,36,36,5,28,60,46.7,32,26,5,21,33,110,14,0,Matches
Pablo Rosario,nl NED,MF,Nice,24,1997,30.3,59,37,18,32,9,26,66,39.4,40,33,7,26,38,97,43,0,Matches
Roli Pereira de Sa,fr FRA,MF,Nantes,24,1996,6.4,12,4,3,5,4,3,20,15.0,17,6,0,6,6,18,3,0,Matches
Mathys Saban,fr FRA,"FW,MF",Saint-Étienne,19,2002,0.8,4,2,2,2,0,1,1,100.0,0,1,0,1,0,4,0,0,Matches
Falaye Sacko,ml MLI,DF,Saint-Étienne,26,1995,7.4,15,10,14,1,0,13,16,81.3,3,11,7,4,4,19,18,2,Matches
Rafiki Said,km COM,"MF,FW",Brest,21,2000,1.4,4,3,1,2,1,3,4,75.0,1,2,0,2,0,4,0,0,Matches
Wesley Saïd,fr FRA,"FW,MF",Lens,26,1995,7.3,10,5,1,8,1,1,9,11.1,8,4,0,4,2,12,0,0,Matches
Mamadou Sakho,fr FRA,DF,Montpellier,31,1990,28.6,34,22,26,8,0,16,26,61.5,10,41,34,7,41,75,134,4,Matches
Bakary Sako,ml MLI,"FW,MF",Saint-Étienne,33,1988,1.7,0,0,0,0,0,0,1,0.0,1,3,1,2,0,0,0,0,Matches
William Saliba,fr FRA,DF,Marseille,20,2001,36.0,54,32,36,16,2,27,35,77.1,8,24,16,8,48,102,85,0,Matches
Romain Salin,fr FRA,GK,Rennes,37,1984,1.0,0,0,0,0,0,0,0,,0,0,0,0,0,0,0,0,Matches
Yoann Salmier,gf GUF,DF,Troyes,28,1992,29.6,58,33,44,11,3,26,34,76.5,8,30,14,16,40,98,94,0,Matches
Mama Samba Baldé,gw GNB,"MF,FW",Troyes,25,1995,19.1,40,28,16,14,10,8,26,30.8,18,32,1,31,5,45,9,0,Matches
Junior Sambia,fr FRA,"DF,FW",Montpellier,24,1996,17.0,22,13,12,7,3,13,22,59.1,9,22,3,19,21,43,31,0,Matches
Renato Sanches,pt POR,"MF,FW",Lille,23,1997,18.3,19,7,8,10,1,9,26,34.6,17,14,3,11,14,33,7,0,Matches
Philippe Sandler,nl NED,DF,Troyes,24,1997,0.8,0,0,0,0,0,0,0,,0,1,1,0,3,3,6,0,Matches
Baptiste Santamaria,fr FRA,"MF,DF",Rennes,26,1995,28.0,52,27,15,31,6,24,44,54.5,20,33,12,21,33,85,42,0,Matches
Pablo Sarabia,es ESP,FW,Paris S-G,29,1992,0.2,0,0,0,0,0,0,1,0.0,1,0,0,0,0,0,0,0,Matches
Martin Satriano,uy URU,FW,Brest,20,2001,10.4,5,2,1,1,3,2,7,28.6,5,8,0,8,2,7,3,0,Matches

Téji Savanier,fr FRA,MF,Montpellier,29,1991,26.8,46,27,18,19,9,21,59,35.6,38,23,1,22,25,71,12,1,Matches
Morgan Schneiderlin,fr FRA,MF,Nice,31,1989,7.2,21,12,9,11,1,6,13,46.2,7,8,2,6,20,41,18,0,Matches
Alidu Seidu,gh GHA,DF,Clermont Foot,21,2000,15.7,34,20,20,13,1,16,27,59.3,11,25,11,14,34,68,49,1,Matches
Matz Sels,be BEL,GK,Strasbourg,29,1992,37.0,1,1,1,0,0,0,0,,0,0,0,0,1,2,22,0,Matches
Xherdan Shaqiri,ch SUI,"FW,MF",Lyon,29,1991,7.5,7,3,0,5,2,2,10,20.0,8,2,0,2,2,9,2,0,Matches
Mahame Siby,ml MLI,DF,Strasbourg,25,1996,0.2,0,0,0,0,0,0,0,,0,0,0,0,1,1,2,0,Matches
Aboubakar Sidibé,fr FRA,DF,Clermont Foot,25,1996,0.1,0,0,0,0,0,0,0,,0,0,0,0,0,0,0,0,Matches
Djibril Sidibé,fr FRA,DF,Monaco,29,1992,10.5,24,13,13,8,3,9,24,37.5,15,10,1,9,16,40,13,0,Matches
Kaj Sierhuis,nl NED,FW,Reims,23,1998,0.9,1,1,1,0,0,1,3,33.3,2,0,0,0,0,1,1,0,Matches
Caio Henrique Oliveira Silva,br BRA,DF,Monaco,24,1997,29.6,53,30,31,18,4,28,59,47.5,31,30,6,24,27,80,37,3,Matches
Gabriel Silva,br BRA,"DF,MF",Saint-Étienne,30,1991,7.9,12,7,7,2,3,9,13,69.2,4,9,3,6,18,30,13,0,Matches
Moses Simon,ng NGA,"FW,MF",Nantes,26,1995,25.9,17,11,6,5,6,11,23,47.8,12,14,3,11,12,29,5,0,Matches
Xavi Simons,nl NED,"MF,FW",Paris S-G,18,2003,1.5,1,1,0,1,0,1,2,50.0,1,3,0,3,0,1,0,0,Matches
Issouf Sissokho,ml MLI,MF,Bordeaux,19,2002,4.8,17,8,2,13,2,8,17,47.1,9,8,1,7,7,24,0,0,Matches
Ibrahima Sissoko,ml MLI,"MF,DF",Strasbourg,23,1997,25.6,47,23,18,20,9,19,46,41.3,27,32,11,21,35,82,31,0,Matches
Nelson Sissoko,fr FRA,DF,Saint-Étienne,24,1997,0.5,2,0,2,0,0,1,1,100.0,0,0,0,0,0,2,2,0,Matches
Sambou Sissoko,fr FRA,"MF,DF",Reims,22,1999,2.0,12,6,6,4,2,6,8,75.0,2,2,0,2,2,14,7,0,Matches
Islam Slimani,dz ALG,FW,Lyon,33,1988,6.4,3,2,0,1,2,1,6,16.7,5,4,0,4,2,5,5,0,Matches
Florian Sotoca,fr FRA,"FW,MF",Lens,30,1990,27.6,31,19,7,20,4,12,51,23.5,39,31,4,27,25,56,41,0,Matches
Sambou Soumano,sn SEN,"FW,MF",Lorient,20,2001,5.0,4,1,1,2,1,2,2,100.0,0,3,0,3,1,5,7,0,Matches
Arnaud Souquet,fr FRA,DF,Montpellier,29,1992,25.9,56,35,30,17,9,32,65,49.2,33,21,7,14,34,90,60,1,Matches
Saidou Sow,gn GUI,DF,Saint-Étienne,19,2002,11.0,28,17,21,6,1,16,21,76.2,5,15,5,10,23,51,34,0,Matches
Calvin Stengs,nl NED,MF,Nice,22,1998,11.9,16,7,6,9,1,7,20,35.0,13,10,0,10,8,24,6,0,Matches
Kamaldeen Sulemana,gh GHA,"MF,FW",Rennes,19,2002,11.3,23,12,7,9,7,10,17,58.8,7,10,1,9,4,27,5,0,Matches
Abdoulaye Sylla,gn GUI,DF,Nantes,21,2000,1.7,4,4,2,1,1,2,4,50.0,2,5,3,2,1,5,3,0,Matches

Waniss Taibi,fr FRA,"MF,FW",Angers,19,2002,1.5,8,7,4,4,0,2,4,50.0,2,0,0,0,1,9,1,0,Matches
Flavien Tait,fr FRA,MF,Rennes,28,1993,23.6,28,19,13,9,6,13,40,32.5,27,15,4,11,19,47,13,1,Matches
Florian Tardieu,fr FRA,MF,Troyes,29,1992,29.2,58,25,31,21,6,31,71,43.7,40,31,9,22,42,100,38,0,Matches
Oussama Targhalline,ma MAR,FW,Marseille,19,2002,0.1,0,0,0,0,0,0,0,,0,0,0,0,0,0,0,0,Matches
Loum Tchaouna,fr FRA,"FW,MF",Rennes,17,2003,1.0,3,1,1,2,0,1,5,20.0,4,0,0,0,2,5,0,0,Matches
Enzo Tchato,cm CMR,FW,Montpellier,18,2002,0.1,0,0,0,0,0,0,0,,0,0,0,0,0,0,1,0,Matches
Warren Tchimbembé,cg CGO,MF,Metz,23,1998,2.3,1,1,0,1,0,0,1,0.0,1,2,1,1,2,3,2,0,Matches
Aurélien Tchouaméni,fr FRA,MF,Monaco,21,2000,32.5,86,45,33,49,4,29,55,52.7,26,39,7,32,101,187,34,0,Matches
Mathys Tel,fr FRA,"FW,MF",Rennes,16,2005,0.6,2,1,1,1,0,0,0,,0,0,0,0,1,3,2,0,Matches
Jordan Tell,gp GLP,FW,Clermont Foot,24,1997,3.2,5,5,0,3,2,1,4,25.0,3,3,0,3,0,5,1,0,Matches
Martin Terrier,fr FRA,"FW,MF",Rennes,24,1997,30.9,55,33,22,16,17,25,43,58.1,18,29,3,26,18,73,17,0,Matches
Tetê,br BRA,"FW,MF",Lyon,21,2000,6.5,10,5,4,5,1,3,13,23.1,10,4,0,4,3,13,1,0,Matches
Sada Thioub,sn SEN,FW,Angers,26,1995,0.0,0,0,0,0,0,0,0,,0,0,0,0,0,0,0,0,Matches
Sada Thioub,sn SEN,"DF,MF",Saint-Étienne,26,1995,10.6,13,8,5,8,0,6,14,42.9,8,9,0,9,10,23,8,0,Matches
Romain Thomas,fr FRA,DF,Angers,33,1988,28.5,49,37,28,21,0,30,57,52.6,27,35,19,16,44,93,126,0,Matches
Adrien Thomasson,fr FRA,MF,Strasbourg,27,1993,26.5,64,31,18,27,19,30,93,32.3,63,56,4,52,29,93,16,1,Matches
Matheus Thuler,br BRA,DF,Montpellier,22,1999,9.5,21,12,17,4,0,8,15,53.3,7,9,7,2,9,30,30,0,Matches
Khéphren Thuram,fr FRA,MF,Nice,20,2001,21.1,33,19,11,18,4,17,35,48.6,18,31,11,20,28,61,19,0,Matches
Cheikh Tidiane Sabaly,sn SEN,"FW,MF",Metz,22,1999,1.7,6,3,1,4,1,2,2,100.0,0,1,0,1,0,6,1,0,Matches
Jean-Clair Todibo,fr FRA,DF,Nice,21,1999,34.6,59,37,43,15,1,39,60,65.0,21,45,21,24,51,110,130,2,Matches
Karl Toko Ekambi,cm CMR,FW,Lyon,28,1992,25.5,13,7,4,6,3,4,21,19.0,17,26,0,26,20,33,5,0,Matches
Yoann Touzghar,tn TUN,FW,Troyes,34,1986,16.2,5,2,1,3,1,1,3,33.3,2,3,1,2,3,8,8,0,Matches
Amadou Traore,fr FRA,FW,Bordeaux,19,2002,0.2,0,0,0,0,0,0,0,,0,0,0,0,0,0,0,0,Matches
Boubacar Traoré,ml MLI,MF,Metz,19,2001,19.2,43,26,18,23,2,10,39,25.6,29,29,5,24,25,68,11,1,Matches
Charles Traore,ml MLI,DF,Nantes,29,1992,8.0,16,12,10,4,2,2,13,15.4,11,11,4,7,15,31,30,0,Matches

Hamari Traoré,ml MLI,DF,Rennes,29,1992,32.1,63,36,25,26,12,41,59,69.5,18,29,8,21,37,100,81,1,Matches
Ismaël Traoré,ci CIV,DF,Angers,34,1986,35.7,28,17,16,11,1,13,28,46.4,15,25,17,8,44,72,122,1,Matches
Miguel Trauco,pe PER,"DF,MF",Saint-Étienne,28,1992,12.4,25,18,16,8,1,12,22,54.5,10,13,4,9,23,48,17,0,Matches
Adrien Truffert,fr FRA,DF,Rennes,19,2001,18.2,29,21,17,9,3,11,24,45.8,13,25,5,20,19,48,30,0,Matches
Matthieu Udol,fr FRA,DF,Metz,25,1996,11.2,23,14,11,10,2,12,18,66.7,6,20,7,13,31,54,29,1,Matches
Ike Ugbo,ca CAN,FW,Troyes,22,1998,9.0,3,1,0,1,2,0,1,0.0,1,4,1,3,2,5,1,0,Matches
Lesley Ugochukwu,fr FRA,MF,Rennes,17,2004,4.5,13,9,5,5,3,9,19,47.4,10,7,2,5,4,17,2,0,Matches
Hwang Ui-jo,kr KOR,FW,Bordeaux,28,1992,27.9,10,4,4,4,2,4,13,30.8,9,9,1,8,5,15,18,0,Matches
Cengiz Ünder,tr TUR,"FW,MF",Marseille,24,1997,24.4,18,13,5,6,7,5,18,27.8,13,13,2,11,14,32,9,0,Matches
Jere Uronen,fi FIN,DF,Brest,27,1994,9.8,28,15,15,10,3,14,24,58.3,10,12,3,9,16,44,21,0,Matches
Vanderson,br BRA,"FW,DF",Monaco,20,2001,12.4,35,19,10,19,6,15,23,65.2,8,17,4,13,13,48,12,0,Matches
Jonathan Varane,fr FRA,MF,Lens,19,2001,0.0,0,0,0,0,0,0,0,,0,0,0,0,0,0,0,0,Matches
Marco Verratti,it ITA,MF,Paris S-G,28,1992,21.5,60,40,16,30,14,32,64,50.0,32,36,10,26,18,78,14,2,Matches
Kevin Volland,de GER,"MF,FW",Monaco,29,1992,27.1,24,10,2,18,4,6,31,19.4,25,20,0,20,3,27,9,0,Matches
Elye Wahi,fr FRA,FW,Montpellier,18,2003,19.8,18,10,9,6,3,6,16,37.5,10,7,0,7,4,22,4,0,Matches
Timothy Weah,us USA,"MF,FW",Lille,21,2000,18.0,19,7,8,8,3,10,20,50.0,10,16,1,15,10,29,7,0,Matches
Georginio Wijnaldum,nl NED,MF,Paris S-G,30,1990,18.4,15,9,2,12,1,11,19,57.9,8,13,3,10,9,24,7,0,Matches
Christopher Wooh,cm CMR,DF,Lens,19,2001,11.7,29,11,20,8,1,11,18,61.1,7,21,14,7,21,50,40,1,Matches
Xeka,pt POR,MF,Lille,26,1994,18.0,47,27,18,24,5,27,56,48.2,29,23,3,20,24,71,26,1,Matches
Sekou Yansané,gn GUI,FW,Paris S-G,18,2003,0.2,0,0,0,0,0,0,1,0.0,1,0,0,0,0,0,1,0,Matches
Yusuf Yazıcı,tr TUR,"MF,FW",Lille,24,1997,5.7,10,5,3,6,1,1,9,11.1,8,4,0,4,2,12,1,0,Matches
Burak Yılmaz,tr TUR,FW,Lille,36,1985,24.6,7,2,0,2,5,2,17,11.8,15,8,1,7,2,9,11,0,Matches
Leny Yoro,fr FRA,MF,Lille,15,2005,0.1,1,0,0,1,0,0,0,,0,1,0,1,0,1,0,0,Matches
Zaydou Youssouf,fr FRA,MF,Saint-Étienne,22,1999,17.3,48,26,21,25,2,14,34,41.2,20,11,3,8,17,65,13,0,Matches
Akim Zedadka,dz ALG,DF,Clermont Foot,26,1995,37.1,72,44,34,29,9,37,71,52.1,34,32,8,24,58,130,48,0,Matches

Arber Zeneli,xk KVX,FW,Reims,26,1995,4.5,1,0,0,0,1,1,5,20.0,4,0,0,0,1,2,1,0,Matches
Mehdi Zerkane,dz ALG,"MF,DF",Bordeaux,22,1999,0.9,0,0,0,0,0,0,1,0.0,1,1,1,0,2,2,0,0,Matches
Edon Zhegrova,xk KVX,"MF,FW",Lille,22,1999,5.3,14,5,2,8,4,5,6,83.3,1,4,1,3,2,16,2,0,Matches
Tanguy Zoukrou,fr FRA,DF,Troyes,18,2003,0.9,1,0,1,0,0,1,2,50.0,1,0,0,0,0,1,2,0,Matches
