Player,Nation,Position,Squad,Age,Year of birth,90s Played,Tackles,Tackles Won,Tackles (Def 3rd),Tackles (Mid 3rd),Tackles (Att 3rd),Dribblers Tackled,Dribbles Challenged,% of Dribblers Tackled,Challenges Lost,Blocks,Shots Blocked,Passes Blocked,Interceptions,Tkl+Int,Clearances,Errors,Matches


Max Aarons,eng ENG,DF,Norwich City,21,2000,32.0,64,44,49,15,0,37,55,67.3,18,39,19,20,28,92,96,1,Matches
Che Adams,sct SCO,FW,Southampton,25,1996,22.7,13,6,5,5,3,2,16,12.5,14,18,2,16,8,21,18,0,Matches
Rayan Aït-Nouri,dz ALG,"DF,MF",Wolves,20,2001,20.3,64,36,46,15,3,22,44,50.0,22,24,2,22,22,86,39,1,Matches
Kristoffer Ajer,no NOR,DF,Brentford,23,1998,22.2,29,18,21,6,2,13,21,61.9,8,19,11,8,26,55,74,0,Matches
Nathan Aké,nl NED,DF,Manchester City,26,1995,10.3,16,9,7,8,1,6,8,75.0,2,7,5,2,8,24,23,0,Matches
Marc Albrighton,eng ENG,"FW,DF",Leicester City,31,1989,12.6,31,19,16,9,6,10,47,21.3,37,15,3,12,14,45,20,0,Matches
Thiago Alcántara,es ESP,MF,Liverpool,30,1991,17.0,48,29,14,24,10,10,42,23.8,32,22,2,20,26,74,13,2,Matches
Trent Alexander-Arnold,eng ENG,DF,Liverpool,22,1998,31.7,40,23,19,13,8,27,60,45.0,33,22,4,18,43,83,40,0,Matches
Alisson,br BRA,GK,Liverpool,28,1992,36.0,3,1,3,0,0,3,5,60.0,2,1,0,1,0,3,28,1,Matches
Allan,br BRA,MF,Everton,30,1991,24.3,74,44,28,39,7,34,105,32.4,71,40,9,31,23,97,39,1,Matches
Dele Alli,eng ENG,MF,Tottenham,25,1996,7.3,14,8,10,3,1,5,17,29.4,12,22,5,17,6,20,16,0,Matches
Dele Alli,eng ENG,"MF,FW",Everton,25,1996,3.8,7,2,3,4,0,0,4,0.0,4,7,2,5,6,13,10,0,Matches
Miguel Almirón,py PAR,"MF,FW",Newcastle Utd,27,1994,19.1,47,29,23,17,7,11,44,25.0,33,14,1,13,20,67,13,0,Matches
Marcos Alonso,es ESP,DF,Chelsea,30,1990,24.1,41,29,20,12,9,17,36,47.2,19,29,5,24,43,84,53,0,Matches
Steven Alzate,co COL,MF,Brighton,22,1998,4.5,10,4,4,5,1,4,7,57.1,3,2,1,1,10,20,10,0,Matches
Daniel Amartey,gh GHA,DF,Leicester City,26,1994,23.6,26,13,19,7,0,19,29,65.5,10,30,22,8,21,47,93,4,Matches
Joachim Andersen,dk DEN,DF,Crystal Palace,25,1996,32.4,30,23,21,9,0,16,27,59.3,11,29,19,10,37,67,125,3,Matches
Michail Antonio,jm JAM,FW,West Ham,31,1990,33.0,23,17,5,9,9,7,18,38.9,11,19,1,18,3,26,13,0,Matches
Cameron Archer,eng ENG,"FW,MF",Aston Villa,20,2001,0.3,0,0,0,0,0,0,0,,0,0,0,0,0,0,0,0,Matches
Alphonse Areola,fr FRA,GK,West Ham,28,1993,1.0,0,0,0,0,0,0,0,,0,0,0,0,0,0,1,0,Matches
Adam Armstrong,eng ENG,FW,Southampton,24,1997,15.7,10,4,2,2,6,0,6,0.0,6,13,1,12,3,13,6,0,Matches
Stuart Armstrong,sct SCO,MF,Southampton,29,1992,16.4,27,19,15,6,6,9,23,39.1,14,10,1,9,8,35,15,0,Matches
Kepa Arrizabalaga,es ESP,GK,Chelsea,26,1994,4.0,0,0,0,0,0,0,0,,0,0,0,0,0,0,4,0,Matches
Harrison Ashby,sct SCO,DF,West Ham,19,2001,0.1,0,0,0,0,0,0,0,,0,1,0,1,1,1,1,0,Matches
Pierre-Emerick Aubameyang,ga GAB,FW,Arsenal,32,1989,11.5,11,5,6,4,1,3,10,30.0,7,12,1,11,0,11,4,0,Matches

Jordan Ayew,gh GHA,FW,Crystal Palace,29,1991,22.4,47,30,20,20,7,17,31,54.8,14,33,3,30,15,62,15,0,Matches
Luke Ayling,eng ENG,DF,Leeds United,29,1991,25.2,74,42,46,23,5,51,97,52.6,46,46,25,21,28,102,52,1,Matches
César Azpilicueta,es ESP,DF,Chelsea,31,1989,23.0,51,28,18,27,6,16,35,45.7,19,32,9,23,23,74,65,1,Matches
Daniel Bachmann,at AUT,GK,Watford,27,1994,12.0,0,0,0,0,0,0,0,,0,0,0,0,1,1,5,0,Matches
Leon Bailey,jm JAM,"FW,MF",Aston Villa,23,1997,8.5,17,11,6,8,3,6,13,46.2,7,10,1,9,1,18,2,0,Matches
Eric Bailly,ci CIV,DF,Manchester Utd,27,1994,2.4,5,4,4,0,1,3,4,75.0,1,4,2,2,3,8,11,0,Matches
Folarin Balogun,us USA,FW,Arsenal,20,2001,0.8,1,1,0,0,1,0,0,,0,1,0,1,0,1,1,0,Matches
Patrick Bamford,eng ENG,FW,Leeds United,27,1993,6.2,1,0,0,1,0,0,3,0.0,3,8,2,6,2,3,8,0,Matches
Shandon Baptiste,gd GRN,MF,Brentford,23,1998,10.1,14,4,9,4,1,6,15,40.0,9,10,0,10,11,25,12,0,Matches
Ross Barkley,eng ENG,"MF,FW",Chelsea,27,1993,2.0,0,0,0,0,0,0,1,0.0,1,1,0,1,1,1,0,0,Matches
Ashley Barnes,eng ENG,FW,Burnley,31,1989,9.0,11,2,2,7,2,2,9,22.2,7,8,1,7,2,13,5,0,Matches
Harvey Barnes,eng ENG,"FW,MF",Leicester City,23,1997,23.3,31,16,9,11,11,7,23,30.4,16,24,1,23,5,36,7,0,Matches
Lewis Bate,eng ENG,MF,Leeds United,18,2002,1.6,1,0,0,0,1,0,8,0.0,8,1,0,1,1,2,1,0,Matches
Mads Bech Sørensen,dk DEN,DF,Brentford,22,1999,9.3,8,7,6,2,0,6,7,85.7,1,9,6,3,6,14,25,0,Matches
Jan Bednarek,pl POL,DF,Southampton,25,1996,29.2,32,15,18,13,1,19,33,57.6,14,48,27,21,72,104,141,0,Matches
Donny van de Beek,nl NED,MF,Manchester Utd,24,1997,0.8,6,4,4,1,1,1,2,50.0,1,5,1,4,2,8,1,0,Matches
Donny van de Beek,nl NED,MF,Everton,24,1997,5.4,15,7,8,6,1,6,13,46.2,7,6,2,4,6,21,4,0,Matches
Asmir Begović,ba BIH,GK,Everton,34,1987,3.0,0,0,0,0,0,0,0,,0,0,0,0,0,0,3,0,Matches
Saïd Benrahma,dz ALG,"FW,MF",West Ham,25,1995,24.1,28,17,16,9,3,15,38,39.5,23,17,1,16,9,37,8,0,Matches
Rodrigo Bentancur,uy URU,MF,Tottenham,24,1997,15.1,36,18,14,14,8,16,32,50.0,16,24,9,15,20,56,35,0,Matches
Christian Benteke,be BEL,FW,Crystal Palace,30,1990,12.7,3,2,1,2,0,2,6,33.3,4,7,3,4,2,5,33,0,Matches
Jóhann Berg Guðmundsson,is ISL,MF,Burnley,30,1990,12.2,16,6,7,7,2,5,20,25.0,15,11,2,9,12,28,22,0,Matches
Steven Bergwijn,nl NED,"FW,MF",Tottenham,23,1997,6.3,3,2,2,1,0,1,10,10.0,9,3,0,3,1,4,8,0,Matches
Ryan Bertrand,eng ENG,DF,Leicester City,31,1989,3.7,8,5,3,4,1,2,5,40.0,3,8,3,5,1,9,7,0,Matches
Mads Bidstrup,dk DEN,MF,Brentford,20,2001,0.5,1,0,0,1,0,0,3,0.0,3,0,0,0,1,2,2,0,Matches

Yves Bissouma,ml MLI,MF,Brighton,24,1996,23.5,76,49,35,37,4,21,37,56.8,16,33,3,30,50,126,49,0,Matches
Willy Boly,ci CIV,DF,Wolves,30,1991,10.0,25,19,18,7,0,8,15,53.3,7,14,6,8,14,39,35,0,Matches
Jarrod Bowen,eng ENG,FW,West Ham,24,1996,33.1,36,20,20,11,5,17,44,38.6,27,29,2,27,21,57,14,0,Matches
Jarrad Branthwaite,eng ENG,DF,Everton,19,2002,4.3,4,1,3,1,0,3,8,37.5,5,3,2,1,1,5,20,0,Matches
Armando Broja,al ALB,FW,Southampton,19,2001,21.9,12,5,2,7,3,2,9,22.2,7,17,1,16,3,15,11,0,Matches
Josh Brownhill,eng ENG,MF,Burnley,25,1995,32.8,73,37,25,42,6,21,53,39.6,32,37,12,25,68,141,42,1,Matches
Lewis Brunt,eng ENG,MF,Leicester City,20,2000,0.3,0,0,0,0,0,0,0,,0,1,0,1,0,0,0,0,Matches
Emi Buendía,ar ARG,"MF,FW",Aston Villa,24,1996,21.1,38,18,16,13,9,21,51,41.2,30,21,3,18,9,47,11,0,Matches
Dan Burn,eng ENG,DF,Newcastle Utd,29,1992,16.0,16,11,11,4,1,7,11,63.6,4,22,14,8,20,36,101,0,Matches
Dan Burn,eng ENG,DF,Brighton,29,1992,11.4,22,12,13,8,1,6,15,40.0,9,14,10,4,24,46,51,0,Matches
Jack Butland,eng ENG,GK,Crystal Palace,28,1993,8.5,0,0,0,0,0,0,0,,0,0,0,0,0,0,1,0,Matches
Sam Byram,eng ENG,DF,Norwich City,27,1993,11.4,24,15,17,6,1,19,27,70.4,8,21,11,10,22,46,48,0,Matches
Willy Caballero,ar ARG,GK,Southampton,39,1981,2.0,0,0,0,0,0,0,0,,0,0,0,0,0,0,2,1,Matches
Moisés Caicedo,ec ECU,MF,Brighton,19,2001,7.3,16,10,7,7,2,5,12,41.7,7,18,4,14,10,26,7,0,Matches
Dominic Calvert-Lewin,eng ENG,FW,Everton,24,1997,14.3,11,8,1,6,4,3,8,37.5,5,5,2,3,3,14,12,0,Matches
Chem Campbell,wls WAL,MF,Wolves,18,2002,0.1,1,1,0,1,0,0,0,,0,0,0,0,0,1,0,0,Matches
João Cancelo,pt POR,DF,Manchester City,27,1994,35.9,83,54,33,35,15,46,91,50.5,45,25,3,22,59,142,45,1,Matches
Sergi Canós,es ESP,"DF,FW",Brentford,24,1997,23.1,56,25,32,15,9,33,60,55.0,27,32,3,29,22,78,38,0,Matches
Todd Cantwell,eng ENG,"FW,MF",Norwich City,23,1998,4.9,15,13,8,6,1,6,17,35.3,11,2,0,2,3,18,2,0,Matches
Matty Cash,pl POL,DF,Aston Villa,23,1997,37.5,89,50,52,34,3,47,78,60.3,31,54,16,38,49,138,100,2,Matches
Timothy Castagne,be BEL,DF,Leicester City,25,1995,23.6,67,31,38,22,7,27,43,62.8,16,28,9,19,29,96,54,1,Matches
Jonny Castro,es ESP,DF,Wolves,27,1994,11.4,25,15,13,11,1,11,20,55.0,9,14,3,11,13,38,11,0,Matches
Craig Cathcart,nir NIR,DF,Watford,32,1989,26.6,32,15,25,6,1,16,30,53.3,14,39,29,10,28,60,132,3,Matches
Edinson Cavani,uy URU,FW,Manchester Utd,34,1987,8.5,4,1,0,3,1,2,8,25.0,6,6,0,6,2,6,8,0,Matches
Kayky Chagas,br BRA,FW,Manchester City,18,2003,0.1,0,0,0,0,0,0,0,,0,0,0,0,0,0,0,0,Matches

Trevoh Chalobah,eng ENG,DF,Chelsea,22,1999,16.1,40,27,22,18,0,24,31,77.4,7,16,6,10,19,59,43,2,Matches
Calum Chambers,eng ENG,DF,Arsenal,26,1995,1.9,5,3,3,1,1,3,4,75.0,1,6,3,3,0,5,10,0,Matches
Calum Chambers,eng ENG,DF,Aston Villa,26,1995,9.2,16,8,10,6,0,4,6,66.7,2,14,8,6,5,21,42,0,Matches
Daniel Chesters,eng ENG,MF,West Ham,19,2002,0.0,0,0,0,0,0,0,0,,0,0,0,0,0,0,0,0,Matches
Ben Chilwell,eng ENG,DF,Chelsea,24,1996,6.0,8,3,2,6,0,2,5,40.0,3,7,0,7,4,12,14,1,Matches
Chiquinho,pt POR,"DF,FW",Wolves,21,2000,2.3,9,6,4,5,0,4,5,80.0,1,5,0,5,2,11,1,0,Matches
Hamza Choudhury,eng ENG,"DF,MF",Leicester City,23,1997,3.2,9,3,4,4,1,3,5,60.0,2,0,0,0,12,21,10,0,Matches
Andreas Christensen,dk DEN,DF,Chelsea,25,1996,16.6,14,8,9,4,1,4,7,57.1,3,14,6,8,29,43,57,1,Matches
Carney Chukwuemeka,eng ENG,"MF,FW",Aston Villa,17,2003,3.3,7,1,2,5,0,3,5,60.0,2,3,0,3,1,8,2,1,Matches
Ciaran Clark,ie IRL,DF,Newcastle Utd,31,1989,11.3,13,10,4,7,2,9,14,64.3,5,14,11,3,13,26,43,1,Matches
Tom Cleverley,eng ENG,MF,Watford,31,1989,18.0,37,20,19,17,1,18,33,54.5,15,23,6,17,18,55,19,3,Matches
Nathaniel Clyne,eng ENG,DF,Crystal Palace,30,1991,15.0,21,10,11,9,1,10,20,50.0,10,7,2,5,15,36,32,0,Matches
Conor Coady,eng ENG,DF,Wolves,28,1993,37.3,31,14,23,7,1,16,28,57.1,12,46,40,6,28,59,140,0,Matches
Séamus Coleman,ie IRL,DF,Everton,32,1988,29.5,61,36,35,16,10,33,51,64.7,18,30,11,19,32,93,80,2,Matches
Nathan Collins,ie IRL,DF,Burnley,20,2001,18.6,37,15,27,8,2,17,27,63.0,10,38,25,13,24,61,83,2,Matches
Aaron Connolly,ie IRL,"FW,MF",Brighton,21,2000,1.7,0,0,0,0,0,0,1,0.0,1,2,0,2,0,0,0,0,Matches
Liam Cooper,sct SCO,DF,Leeds United,29,1991,20.2,41,23,27,13,1,23,33,69.7,10,29,18,11,43,84,72,2,Matches
Jack Cork,eng ENG,MF,Burnley,32,1989,18.6,20,6,6,11,3,7,20,35.0,13,17,4,13,17,37,29,1,Matches
Maxwel Cornet,ci CIV,"FW,MF",Burnley,24,1996,19.6,16,9,7,5,4,7,15,46.7,8,13,4,9,10,26,14,0,Matches
Hélder Costa,ao ANG,MF,Leeds United,27,1994,0.2,0,0,0,0,0,0,0,,0,1,0,1,0,0,0,0,Matches
Vladimír Coufal,cz CZE,DF,West Ham,28,1992,24.5,45,25,24,14,7,18,36,50.0,18,31,9,22,22,67,64,1,Matches
Philippe Coutinho,br BRA,"MF,FW",Aston Villa,29,1992,14.8,17,12,4,11,2,6,21,28.6,15,11,1,10,7,24,4,0,Matches
Aaron Cresswell,eng ENG,DF,West Ham,31,1989,30.3,28,18,18,6,4,13,25,52.0,12,31,18,13,35,63,66,0,Matches
Charlie Cresswell,eng ENG,DF,Leeds United,18,2002,1.6,5,2,1,4,0,3,3,100.0,0,1,1,0,2,7,6,0,Matches
Cucho,co COL,"FW,MF",Watford,22,1999,12.7,13,5,5,5,3,5,27,18.5,22,13,1,12,5,18,9,0,Matches

Marc Cucurella,es ESP,DF,Brighton,23,1998,34.3,93,62,43,32,18,44,71,62.0,27,42,14,28,30,123,74,0,Matches
Luke Cundle,eng ENG,MF,Wolves,19,2002,2.0,4,3,0,4,0,1,1,100.0,0,0,0,0,1,5,1,0,Matches
Patson Daka,zm ZAM,FW,Leicester City,22,1998,12.9,15,10,2,8,5,2,19,10.5,17,7,0,7,2,17,8,0,Matches
Stuart Dallas,nir NIR,"DF,MF",Leeds United,30,1991,32.4,93,55,58,31,4,56,105,53.3,49,45,14,31,57,150,63,2,Matches
Diogo Dalot,pt POR,DF,Manchester Utd,22,1999,20.0,55,41,35,12,8,31,57,54.4,26,24,13,11,29,84,59,0,Matches
Karl Darlow,wls WAL,GK,Newcastle Utd,30,1990,8.0,0,0,0,0,0,0,0,,0,0,0,0,0,0,5,1,Matches
Josh Dasilva,eng ENG,"MF,FW",Brentford,22,1998,2.9,2,1,0,1,1,1,2,50.0,1,3,0,3,1,3,7,0,Matches
Ben Davies,wls WAL,DF,Tottenham,28,1993,28.2,36,21,20,12,4,13,26,50.0,13,32,19,13,30,66,75,1,Matches
Tom Davies,eng ENG,MF,Everton,23,1998,2.6,3,1,1,1,1,2,5,40.0,3,2,1,1,2,5,9,0,Matches
Keinan Davis,eng ENG,FW,Aston Villa,23,1998,0.1,0,0,0,0,0,0,0,,0,0,0,0,0,0,0,0,Matches
Craig Dawson,eng ENG,DF,West Ham,31,1990,30.6,29,17,20,8,1,14,25,56.0,11,59,52,7,29,58,139,0,Matches
Kevin De Bruyne,be BEL,MF,Manchester City,30,1991,24.5,32,16,4,15,13,12,37,32.4,25,32,2,30,6,38,16,0,Matches
Troy Deeney,eng ENG,FW,Watford,33,1988,0.3,0,0,0,0,0,0,1,0.0,1,0,0,0,0,0,2,0,Matches
Liam Delap,eng ENG,FW,Manchester City,18,2003,0.1,0,0,0,0,0,0,0,,0,0,0,0,0,0,0,0,Matches
Fabian Delph,eng ENG,MF,Everton,31,1989,7.4,18,15,10,7,1,8,21,38.1,13,12,5,7,14,32,10,0,Matches
Leander Dendoncker,be BEL,MF,Wolves,26,1995,21.7,42,17,25,14,3,22,50,44.0,28,37,10,27,9,51,38,1,Matches
Emmanuel Dennis,ng NGA,"FW,MF",Watford,23,1997,28.7,51,35,20,22,9,17,52,32.7,35,36,2,34,15,66,13,0,Matches
Kiernan Dewsbury-Hall,eng ENG,MF,Leicester City,22,1998,23.4,39,24,20,14,5,19,40,47.5,21,37,8,29,21,60,26,1,Matches
Ibrahima Diallo,fr FRA,MF,Southampton,22,1999,11.4,22,11,10,9,3,10,24,41.7,14,7,0,7,9,31,10,0,Matches
Rúben Dias,pt POR,DF,Manchester City,24,1997,26.7,26,19,11,12,3,8,15,53.3,7,19,13,6,23,49,66,0,Matches
Luis Díaz,co COL,FW,Liverpool,24,1997,10.6,9,7,3,5,1,2,8,25.0,6,7,0,7,4,13,2,0,Matches
Eric Dier,eng ENG,DF,Tottenham,27,1994,34.1,15,9,6,8,1,7,14,50.0,7,37,32,5,27,42,142,1,Matches
Lucas Digne,fr FRA,DF,Aston Villa,28,1993,14.1,13,10,8,3,2,9,19,47.4,10,15,8,7,23,36,40,0,Matches
Lucas Digne,fr FRA,DF,Everton,28,1993,13.0,33,19,26,4,3,21,28,75.0,7,16,5,11,14,47,30,0,Matches
Issa Diop,fr FRA,DF,West Ham,24,1997,10.7,10,8,5,5,0,4,11,36.4,7,14,13,1,7,17,44,0,Matches

Moussa Djenepo,ml MLI,MF,Southampton,23,1998,5.1,9,3,3,5,1,3,11,27.3,8,6,1,5,2,11,6,1,Matches
Lewis Dobbin,eng ENG,"FW,MF",Everton,18,2003,0.4,2,1,0,1,1,1,2,50.0,1,0,0,0,0,2,0,0,Matches
Matt Doherty,ie IRL,DF,Tottenham,29,1992,9.7,18,12,5,11,2,8,14,57.1,6,11,2,9,13,31,20,0,Matches
Abdoulaye Doucouré,ml MLI,MF,Everton,28,1993,28.2,75,43,30,37,8,32,71,45.1,39,33,8,25,28,103,32,0,Matches
Kieran Dowell,eng ENG,"FW,MF",Norwich City,23,1997,10.1,18,7,8,7,3,9,32,28.1,23,10,1,9,7,25,4,0,Matches
Cody Drameh,eng ENG,"DF,MF",Leeds United,19,2001,1.4,4,2,3,1,0,1,3,33.3,2,0,0,0,1,5,4,0,Matches
Martin Dúbravka,sk SVK,GK,Newcastle Utd,32,1989,26.0,1,1,1,0,0,0,1,0.0,1,0,0,0,0,1,8,2,Matches
Shane Duffy,ie IRL,DF,Brighton,29,1992,16.0,15,12,12,3,0,8,14,57.1,6,24,18,6,16,31,76,1,Matches
Paul Dummett,wls WAL,DF,Newcastle Utd,29,1991,2.2,7,3,3,4,0,5,8,62.5,3,5,0,5,3,10,5,0,Matches
Lewis Dunk,eng ENG,DF,Brighton,29,1991,28.6,10,8,5,5,0,5,11,45.5,6,32,28,4,27,37,113,3,Matches
Ederson,br BRA,GK,Manchester City,27,1993,37.0,2,1,2,0,0,0,2,0.0,2,0,0,0,0,2,12,0,Matches
Odsonne Édouard,fr FRA,FW,Crystal Palace,23,1998,17.4,16,10,2,7,7,7,21,33.3,14,20,5,15,0,16,18,0,Matches
CJ Egan-Riley,eng ENG,DF,Manchester City,18,2003,0.0,1,1,1,0,0,1,1,100.0,0,0,0,0,0,1,0,0,Matches
Anthony Elanga,se SWE,FW,Manchester Utd,19,2002,13.5,26,20,12,12,2,15,29,51.7,14,17,1,16,9,35,7,0,Matches
Harvey Elliott,eng ENG,MF,Liverpool,18,2003,3.8,3,0,1,1,1,0,6,0.0,6,8,1,7,4,7,2,0,Matches
Mohamed Elneny,eg EGY,MF,Arsenal,29,1992,9.0,16,8,10,5,1,7,12,58.3,5,7,1,6,14,30,13,0,Matches
Mohamed Elyounoussi,no NOR,"MF,FW",Southampton,26,1994,22.7,36,17,14,15,7,11,39,28.2,28,23,2,21,12,48,28,0,Matches
Emerson,br BRA,"DF,MF",Tottenham,22,1999,25.4,72,47,50,16,6,36,67,53.7,31,25,2,23,22,94,92,1,Matches
Christian Eriksen,dk DEN,MF,Brentford,29,1992,10.4,13,6,4,5,4,8,17,47.1,9,9,1,8,9,22,14,0,Matches
Oghenekaro Etebo,ng NGA,MF,Watford,25,1995,4.5,11,8,7,4,0,3,8,37.5,5,3,1,2,5,16,5,0,Matches
Jonny Evans,nir NIR,DF,Leicester City,33,1988,15.0,24,14,14,8,2,14,22,63.6,8,17,13,4,20,44,59,0,Matches
Eberechi Eze,eng ENG,"MF,FW",Crystal Palace,23,1998,6.7,10,6,5,2,3,6,11,54.5,5,4,1,3,5,15,1,0,Matches
Łukasz Fabiański,pl POL,GK,West Ham,36,1985,37.0,0,0,0,0,0,0,0,,0,0,0,0,0,0,11,0,Matches
Fabinho,br BRA,MF,Liverpool,27,1993,25.7,46,25,17,23,6,24,70,34.3,46,33,10,23,39,85,25,1,Matches
Kiko Femenía,es ESP,DF,Watford,30,1991,23.8,35,22,23,10,2,21,37,56.8,16,24,8,16,37,72,51,0,Matches

Evan Ferguson,ie IRL,MF,Brighton,16,2004,0.3,0,0,0,0,0,0,0,,0,0,0,0,0,0,0,0,Matches
Nathan Ferguson,eng ENG,DF,Crystal Palace,20,2000,0.1,0,0,0,0,0,0,0,,0,0,0,0,0,0,0,0,Matches
Bruno Fernandes,pt POR,MF,Manchester Utd,26,1994,34.6,54,28,26,22,6,26,91,28.6,65,36,0,36,17,71,42,2,Matches
Álvaro Fernández,es ESP,GK,Brentford,23,1998,12.0,0,0,0,0,0,0,0,,0,0,0,0,0,0,5,2,Matches
Federico Fernández,ar ARG,DF,Newcastle Utd,32,1989,5.8,3,0,3,0,0,2,5,40.0,3,10,10,0,4,7,28,0,Matches
Fernandinho,br BRA,"MF,DF",Manchester City,36,1985,10.7,21,10,7,10,4,9,27,33.3,18,8,2,6,8,29,13,1,Matches
Roberto Firmino,br BRA,FW,Liverpool,29,1991,11.0,23,14,5,8,10,3,16,18.8,13,20,0,20,4,27,3,0,Matches
Junior Firpo,do DOM,"DF,MF",Leeds United,24,1996,19.0,61,29,30,26,5,31,59,52.5,28,22,6,16,24,85,37,0,Matches
Ashley Fletcher,eng ENG,FW,Watford,25,1995,0.3,2,1,1,1,0,1,1,100.0,0,1,1,0,0,2,0,0,Matches
Phil Foden,eng ENG,FW,Manchester City,21,2000,23.6,16,8,10,4,2,7,17,41.2,10,9,0,9,11,27,5,0,Matches
Wesley Fofana,fr FRA,DF,Leicester City,20,2000,7.0,12,8,11,1,0,7,11,63.6,4,5,2,3,12,24,26,1,Matches
Pablo Fornals,es ESP,"FW,MF",West Ham,25,1996,31.1,54,28,21,21,12,22,84,26.2,62,49,2,47,27,81,16,1,Matches
Adam Forshaw,eng ENG,MF,Leeds United,29,1991,17.0,53,23,21,27,5,21,54,38.9,33,17,1,16,19,72,12,2,Matches
Marcus Forss,fi FIN,"FW,MF",Brentford,22,1999,2.3,3,3,0,2,1,2,4,50.0,2,5,0,5,1,4,0,0,Matches
Fraser Forster,eng ENG,GK,Southampton,33,1988,19.0,1,0,1,0,0,0,1,0.0,1,0,0,0,0,1,23,2,Matches
Ben Foster,eng ENG,GK,Watford,38,1983,26.0,0,0,0,0,0,0,3,0.0,3,0,0,0,0,0,9,4,Matches
Tariqe Fosu,gh GHA,DF,Brentford,25,1995,0.2,0,0,0,0,0,0,0,,0,1,0,1,0,0,0,0,Matches
Ryan Fraser,sct SCO,"FW,MF",Newcastle Utd,27,1994,16.3,10,3,5,3,2,5,13,38.5,8,11,1,10,11,21,11,0,Matches
Fred,br BRA,MF,Manchester Utd,28,1993,22.5,63,27,32,24,7,22,79,27.8,57,38,11,27,32,95,24,0,Matches
Ryan Fredericks,eng ENG,DF,West Ham,28,1992,3.4,2,2,2,0,0,0,1,0.0,1,2,1,1,4,6,6,0,Matches
Leo Fuhr Hjelde,no NOR,"MF,DF",Leeds United,17,2003,1.7,5,4,3,2,0,3,3,100.0,0,3,3,0,4,9,7,0,Matches
Conor Gallagher,eng ENG,MF,Crystal Palace,21,2000,31.6,69,38,35,20,14,21,69,30.4,48,58,9,49,29,98,26,0,Matches
Alejandro Garnacho,ar ARG,"FW,MF",Manchester Utd,17,2004,0.1,0,0,0,0,0,0,1,0.0,1,0,0,0,0,0,0,0,Matches
Dwight Gayle,eng ENG,"FW,DF",Newcastle Utd,30,1990,0.4,1,0,0,1,0,0,1,0.0,1,0,0,0,1,2,0,0,Matches
Jean-Philippe Gbamin,ci CIV,MF,Everton,25,1995,0.7,1,1,1,0,0,0,2,0.0,2,0,0,0,1,2,1,0,Matches

David de Gea,es ESP,GK,Manchester Utd,30,1990,38.0,0,0,0,0,0,0,0,,0,0,0,0,0,0,11,2,Matches
Joe Gelhardt,eng ENG,"FW,MF",Leeds United,19,2002,8.3,4,3,1,0,3,2,10,20.0,8,9,0,9,0,4,3,0,Matches
Anwar El Ghazi,nl NED,"FW,MF",Aston Villa,26,1995,4.3,4,4,2,2,0,2,7,28.6,5,6,0,6,1,5,2,0,Matches
Anwar El Ghazi,nl NED,"FW,MF",Everton,26,1995,0.1,1,1,1,0,0,1,1,100.0,0,3,0,3,0,1,0,0,Matches
Saman Ghoddos,ir IRN,"MF,DF",Brentford,27,1993,6.0,17,10,8,6,3,9,15,60.0,6,2,0,2,3,20,16,0,Matches
Dimitris Giannoulis,gr GRE,DF,Norwich City,25,1995,13.0,36,21,17,17,2,24,36,66.7,12,22,6,16,19,55,41,1,Matches
Morgan Gibbs-White,eng ENG,"DF,FW",Wolves,21,2000,0.1,0,0,0,0,0,0,0,,0,1,0,1,0,0,0,0,Matches
Ben Gibson,eng ENG,DF,Norwich City,28,1993,27.7,23,16,17,6,0,7,12,58.3,5,36,30,6,27,50,139,2,Matches
Bryan Gil,es ESP,"FW,MF",Tottenham,20,2001,1.0,3,0,1,0,2,1,2,50.0,1,2,0,2,0,3,0,0,Matches
Billy Gilmour,sct SCO,MF,Norwich City,20,2001,20.6,41,21,16,21,4,14,52,26.9,38,21,4,17,17,58,29,0,Matches
Ben Godfrey,eng ENG,DF,Everton,23,1998,22.5,47,32,29,14,4,24,39,61.5,15,41,19,22,15,62,100,2,Matches
André Gomes,pt POR,MF,Everton,28,1993,6.9,16,4,6,6,4,8,32,25.0,24,8,2,6,1,17,7,1,Matches
Toti Gomes,pt POR,DF,Wolves,22,1999,4.0,11,7,10,1,0,7,9,77.8,2,6,3,3,8,19,15,0,Matches
Joe Gomez,eng ENG,DF,Liverpool,24,1997,3.7,10,6,5,2,3,5,9,55.6,4,4,1,3,5,15,6,0,Matches
Charlie Goode,eng ENG,DF,Brentford,25,1995,5.0,7,5,5,2,0,4,4,100.0,0,4,2,2,2,9,8,0,Matches
Anthony Gordon,eng ENG,"MF,FW",Everton,20,2001,25.4,54,32,20,30,4,21,59,35.6,38,49,3,46,22,76,17,0,Matches
Kaide Gordon,eng ENG,FW,Liverpool,16,2004,0.1,1,0,0,0,1,0,0,,0,0,0,0,0,1,0,0,Matches
Dan Gosling,eng ENG,MF,Watford,31,1990,1.8,2,1,1,1,0,2,6,33.3,4,2,0,2,0,2,3,0,Matches
Demarai Gray,jm JAM,"MF,FW",Everton,25,1996,26.0,30,19,13,10,7,10,22,45.5,12,30,2,28,15,45,21,1,Matches
Jack Grealish,eng ENG,FW,Manchester City,25,1995,21.3,18,17,4,10,4,5,13,38.5,8,11,1,10,8,26,7,0,Matches
Mason Greenwood,eng ENG,"FW,MF",Manchester Utd,19,2001,14.1,15,9,9,1,5,3,9,33.3,6,5,0,5,1,16,6,0,Matches
Sam Greenwood,eng ENG,"MF,FW",Leeds United,19,2002,2.6,8,5,0,5,3,4,7,57.1,3,3,0,3,2,10,1,0,Matches
Pascal Groß,de GER,"MF,DF",Brighton,30,1991,22.6,28,15,15,11,2,12,33,36.4,21,34,8,26,18,46,23,0,Matches
Vicente Guaita,es ESP,GK,Crystal Palace,34,1987,29.5,1,0,1,0,0,1,1,100.0,0,0,0,0,1,2,8,1,Matches
Marc Guéhi,eng ENG,DF,Crystal Palace,21,2000,35.8,35,17,24,10,1,15,16,93.8,1,34,26,8,30,65,127,0,Matches

Bruno Guimarães,br BRA,MF,Newcastle Utd,23,1997,11.5,44,23,18,22,4,21,38,55.3,17,25,6,19,9,53,13,0,Matches
İlkay Gündoğan,de GER,MF,Manchester City,30,1990,20.6,23,9,10,12,1,12,31,38.7,19,11,1,10,15,38,10,0,Matches
Angus Gunn,sct SCO,GK,Norwich City,25,1996,9.0,0,0,0,0,0,0,0,,0,0,0,0,0,0,11,0,Matches
Grant Hanley,sct SCO,DF,Norwich City,29,1991,32.2,44,25,28,14,2,18,35,51.4,17,56,45,11,56,100,176,2,Matches
Jack Harrison,eng ENG,"FW,MF",Leeds United,24,1996,29.3,57,37,22,22,13,31,76,40.8,45,35,1,34,21,78,19,0,Matches
Kortney Hause,eng ENG,DF,Aston Villa,26,1995,4.4,3,3,2,0,1,3,4,75.0,1,8,5,3,6,9,13,0,Matches
Kai Havertz,de GER,"FW,MF",Chelsea,22,1999,20.1,17,8,5,7,5,4,14,28.6,10,28,1,27,4,21,32,1,Matches
Isaac Hayden,eng ENG,"MF,DF",Newcastle Utd,26,1995,11.1,28,14,11,14,3,12,29,41.4,17,17,8,9,14,42,24,0,Matches
Hwang Hee-chan,kr KOR,"FW,MF",Wolves,25,1996,20.2,27,13,9,16,2,14,44,31.8,30,10,0,10,13,40,7,1,Matches
Jordan Henderson,eng ENG,MF,Liverpool,31,1990,28.9,36,20,9,25,2,17,44,38.6,27,25,1,24,23,59,14,0,Matches
Jeff Hendrick,ie IRL,MF,Newcastle Utd,29,1992,0.8,1,1,0,1,0,1,1,100.0,0,0,0,0,0,1,1,0,Matches
Wayne Hennessey,wls WAL,GK,Burnley,34,1987,2.0,0,0,0,0,0,0,0,,0,0,0,0,1,1,0,1,Matches
Rico Henry,eng ENG,DF,Brentford,24,1997,30.8,28,20,18,8,2,12,34,35.3,22,31,10,21,26,54,76,1,Matches
Son Heung-min,kr KOR,"MF,FW",Tottenham,29,1992,33.4,15,6,5,7,3,5,23,21.7,18,27,6,21,13,28,8,0,Matches
Ki-Jana Hoever,nl NED,"DF,MF",Wolves,19,2002,3.4,10,6,5,5,0,7,12,58.3,5,6,0,6,6,16,8,0,Matches
Rob Holding,eng ENG,DF,Arsenal,25,1995,9.4,13,9,11,1,1,5,6,83.3,1,23,18,5,10,23,42,1,Matches
Mason Holgate,eng ENG,DF,Everton,24,1996,23.7,35,18,26,9,0,11,26,42.3,15,25,17,8,26,61,95,1,Matches
Callum Hudson-Odoi,eng ENG,"MF,FW",Chelsea,20,2000,10.7,14,10,5,6,3,8,23,34.8,15,8,0,8,2,16,6,1,Matches
Will Hughes,eng ENG,MF,Crystal Palace,26,1995,11.7,29,14,10,16,3,7,16,43.8,9,13,7,6,8,37,10,0,Matches
Pierre Højbjerg,dk DEN,MF,Tottenham,25,1995,35.5,78,45,31,38,9,38,85,44.7,47,61,13,48,48,126,54,0,Matches
Adam Idah,ie IRL,"FW,MF",Norwich City,20,2001,6.9,9,6,2,5,2,2,3,66.7,1,4,2,2,3,12,7,0,Matches
Kelechi Iheanacho,ng NGA,FW,Leicester City,24,1996,14.0,10,7,2,5,3,3,14,21.4,11,19,0,19,4,14,10,0,Matches
Danny Ings,eng ENG,FW,Aston Villa,29,1992,21.1,23,16,2,16,5,13,37,35.1,24,31,2,29,6,29,22,0,Matches
Tim Iroegbunam,eng ENG,MF,Aston Villa,18,2003,1.0,5,4,2,3,0,1,1,100.0,0,0,0,0,2,7,1,0,Matches
Alex Iwobi,ng NGA,"MF,DF",Everton,25,1996,22.6,40,19,23,12,5,21,52,40.4,31,39,3,36,20,60,25,2,Matches

Daniel James,wls WAL,FW,Manchester Utd,23,1997,1.4,2,1,0,2,0,0,0,,0,2,0,2,0,2,1,0,Matches
Daniel James,wls WAL,"FW,MF",Leeds United,23,1997,26.3,24,14,8,8,8,10,23,43.5,13,18,1,17,8,32,12,0,Matches
Reece James,eng ENG,DF,Chelsea,21,1999,20.7,33,25,14,18,1,9,22,40.9,13,20,2,18,17,50,22,0,Matches
Vitaly Janelt,de GER,MF,Brentford,23,1998,25.5,61,32,26,27,8,27,53,50.9,26,23,7,16,28,89,35,0,Matches
Pontus Jansson,se SWE,DF,Brentford,30,1991,36.9,40,21,32,8,0,22,34,64.7,12,37,27,10,52,92,187,0,Matches
Mathias Jensen,dk DEN,MF,Brentford,25,1996,17.8,33,18,12,16,5,22,63,34.9,41,32,3,29,22,55,13,0,Matches
Gabriel Jesus,br BRA,FW,Manchester City,24,1997,20.9,18,12,2,4,12,6,26,23.1,20,18,0,18,15,33,8,0,Matches
Raúl Jiménez,mx MEX,FW,Wolves,30,1991,29.2,29,14,6,16,7,6,30,20.0,24,31,5,26,13,42,26,0,Matches
João Pedro,br BRA,"FW,MF",Watford,19,2001,18.3,20,14,7,8,5,6,23,26.1,17,23,3,20,15,35,17,0,Matches
Joelinton,br BRA,"MF,FW",Newcastle Utd,24,1996,28.4,72,38,30,33,9,26,61,42.6,35,46,11,35,34,106,50,2,Matches
Ben Johnson,eng ENG,DF,West Ham,21,2000,15.5,33,16,15,15,3,21,28,75.0,7,16,8,8,22,55,55,0,Matches
Curtis Jones,eng ENG,MF,Liverpool,20,2001,9.5,11,9,3,6,2,1,10,10.0,9,4,0,4,6,17,4,0,Matches
Phil Jones,eng ENG,DF,Manchester Utd,29,1992,1.8,5,5,3,1,1,2,3,66.7,1,4,4,0,3,8,8,0,Matches
Jorginho,it ITA,MF,Chelsea,29,1991,25.3,64,33,27,31,6,29,83,34.9,54,27,4,23,36,100,21,1,Matches
Diogo Jota,pt POR,FW,Liverpool,24,1996,26.3,39,18,12,18,9,13,55,23.6,42,19,2,17,6,45,6,0,Matches
James Justin,eng ENG,DF,Leicester City,23,1998,11.1,22,13,11,8,3,7,15,46.7,8,16,4,12,17,39,34,0,Matches
Mathias Jørgensen,dk DEN,DF,Brentford,31,1990,5.8,10,4,3,5,2,7,10,70.0,3,6,1,5,10,20,13,0,Matches
Ozan Kabak,tr TUR,DF,Norwich City,21,2000,10.2,10,5,4,6,0,5,9,55.6,4,19,11,8,16,26,26,0,Matches
Christian Kabasele,be BEL,DF,Watford,30,1991,13.3,11,5,10,1,0,7,10,70.0,3,20,16,4,14,25,67,1,Matches
Samuel Kalu,ng NGA,FW,Watford,23,1997,2.5,2,2,0,2,0,1,1,100.0,0,2,0,2,3,5,3,0,Matches
Hassane Kamara,ci CIV,DF,Watford,27,1994,18.0,53,34,31,16,6,27,43,62.8,16,20,4,16,69,122,67,0,Matches
Harry Kane,eng ENG,FW,Tottenham,28,1993,35.9,15,5,2,10,3,7,18,38.9,11,26,8,18,3,18,39,0,Matches
N'Golo Kanté,fr FRA,MF,Chelsea,30,1991,19.7,59,31,20,27,12,25,40,62.5,15,37,2,35,31,90,8,0,Matches
Edo Kayembe,cd COD,MF,Watford,23,1998,8.9,21,13,11,9,1,8,16,50.0,8,6,1,5,9,30,13,0,Matches
Moise Kean,it ITA,FW,Everton,21,2000,0.0,0,0,0,0,0,0,0,,0,0,0,0,0,0,0,0,Matches

Michael Keane,eng ENG,DF,Everton,28,1993,31.0,46,25,32,13,1,28,45,62.2,17,33,28,5,62,108,128,2,Matches
Naby Keïta,gn GUI,MF,Liverpool,26,1995,13.0,46,23,17,19,10,26,42,61.9,16,33,2,31,14,60,8,0,Matches
Caoimhín Kelleher,ie IRL,GK,Liverpool,22,1998,2.0,1,1,1,0,0,1,1,100.0,0,0,0,0,0,1,1,0,Matches
Kenedy,br BRA,DF,Chelsea,25,1996,0.6,5,2,1,2,2,2,3,66.7,1,0,0,0,0,5,0,0,Matches
Jonjoe Kenny,eng ENG,DF,Everton,24,1997,11.3,17,7,11,6,0,13,21,61.9,8,8,1,7,20,37,31,0,Matches
Max Kilman,eng ENG,DF,Wolves,24,1997,29.9,50,26,38,10,2,24,37,64.9,13,36,21,15,45,95,113,3,Matches
Joshua King,no NOR,FW,Watford,29,1992,25.0,19,15,7,6,6,4,17,23.5,13,15,4,11,8,27,31,0,Matches
Kristoffer Klaesson,no NOR,GK,Leeds United,20,2000,0.4,0,0,0,0,0,0,0,,0,0,0,0,0,0,0,0,Matches
Mateusz Klich,pl POL,MF,Leeds United,31,1990,23.0,47,25,18,23,6,25,66,37.9,41,22,4,18,11,58,20,0,Matches
Robin Koch,de GER,"MF,DF",Leeds United,25,1996,17.5,21,13,9,10,2,9,34,26.5,25,26,10,16,20,41,44,0,Matches
Sead Kolašinac,ba BIH,DF,Arsenal,28,1993,1.0,0,0,0,0,0,0,0,,0,0,0,0,4,4,1,0,Matches
Ibrahima Konaté,fr FRA,DF,Liverpool,22,1999,11.0,16,10,9,6,1,7,10,70.0,3,13,9,4,16,32,37,1,Matches
Ezri Konsa,eng ENG,DF,Aston Villa,23,1997,27.5,25,15,13,11,1,10,13,76.9,3,31,22,9,15,40,86,2,Matches
Cheikhou Kouyaté,sn SEN,MF,Crystal Palace,31,1989,21.9,52,38,28,22,2,18,39,46.2,21,40,14,26,38,90,39,0,Matches
Mateo Kovačić,hr CRO,MF,Chelsea,27,1994,17.3,51,31,14,26,11,17,35,48.6,18,19,4,15,7,58,9,1,Matches
Emil Krafth,se SWE,DF,Newcastle Utd,26,1994,18.2,37,16,25,11,1,27,36,75.0,9,16,10,6,25,62,56,0,Matches
Alex Král,cz CZE,MF,West Ham,23,1998,0.0,0,0,0,0,0,0,0,,0,0,0,0,0,0,0,0,Matches
Tim Krul,nl NED,GK,Norwich City,33,1988,29.0,1,1,1,0,0,1,4,25.0,3,0,0,0,0,1,10,4,Matches
Juraj Kucka,sk SVK,MF,Watford,34,1987,21.3,59,39,32,25,2,27,73,37.0,46,30,9,21,27,86,46,2,Matches
Dejan Kulusevski,se SWE,"MF,FW",Tottenham,21,2000,14.0,19,13,7,10,2,5,23,21.7,18,14,0,14,13,32,3,0,Matches
Alexandre Lacazette,fr FRA,FW,Arsenal,30,1991,19.8,27,10,8,13,6,7,21,33.3,14,12,1,11,5,32,6,0,Matches
Adam Lallana,eng ENG,MF,Brighton,33,1988,17.3,34,17,14,14,6,12,41,29.3,29,16,6,10,16,50,13,1,Matches
Tariq Lamptey,gh GHA,"DF,FW",Brighton,20,2000,17.3,36,25,14,17,5,15,25,60.0,10,13,3,10,21,57,23,0,Matches
Manuel Lanzini,ar ARG,"MF,FW",West Ham,28,1993,19.8,28,15,10,11,7,10,35,28.6,25,16,0,16,19,47,10,0,Matches
Aymeric Laporte,es ESP,DF,Manchester City,27,1994,31.4,33,15,22,10,1,14,20,70.0,6,15,10,5,20,53,64,2,Matches

Jamaal Lascelles,eng ENG,DF,Newcastle Utd,27,1993,22.9,15,7,9,5,1,4,12,33.3,8,38,28,10,22,37,121,1,Matches
Pierre Lees-Melou,fr FRA,MF,Norwich City,28,1993,25.2,58,36,23,29,6,25,92,27.2,67,37,11,26,25,83,23,0,Matches
Aaron Lennon,eng ENG,"MF,FW",Burnley,34,1987,17.2,33,17,10,13,10,10,34,29.4,24,26,4,22,9,42,14,0,Matches
Bernd Leno,de GER,GK,Arsenal,29,1992,4.0,1,1,1,0,0,1,1,100.0,0,0,0,0,0,1,1,0,Matches
Jamal Lewis,nir NIR,DF,Newcastle Utd,23,1998,2.9,8,6,6,1,1,3,4,75.0,1,3,2,1,3,11,8,0,Matches
Victor Lindelöf,se SWE,DF,Manchester Utd,27,1994,26.2,16,11,9,7,0,9,14,64.3,5,26,17,9,25,41,96,0,Matches
Jesse Lingard,eng ENG,"FW,MF",Manchester Utd,28,1992,4.1,9,7,4,3,2,2,6,33.3,4,4,0,4,0,9,1,0,Matches
Valentino Livramento,eng ENG,DF,Southampton,18,2002,24.5,54,28,30,18,6,27,45,60.0,18,23,9,14,47,101,50,1,Matches
Diego Llorente,es ESP,DF,Leeds United,27,1993,26.0,53,31,32,19,2,33,47,70.2,14,35,17,18,40,93,77,2,Matches
Hugo Lloris,fr FRA,GK,Tottenham,34,1986,38.0,1,1,1,0,0,1,2,50.0,1,0,0,0,1,2,24,3,Matches
Giovani Lo Celso,ar ARG,"MF,FW",Tottenham,25,1996,2.6,8,4,4,2,2,4,10,40.0,6,6,1,5,1,9,0,1,Matches
Jürgen Locadia,cw CUW,"MF,FW",Brighton,27,1993,0.3,0,0,0,0,0,0,0,,0,0,0,0,0,0,0,0,Matches
Ruben Loftus-Cheek,eng ENG,"MF,DF",Chelsea,25,1996,15.5,29,10,16,11,2,10,19,52.6,9,15,6,9,11,40,17,0,Matches
Kevin Long,ie IRL,DF,Burnley,30,1990,4.6,3,2,1,2,0,1,2,50.0,1,4,1,3,1,4,20,0,Matches
Shane Long,ie IRL,FW,Southampton,34,1987,3.4,9,5,2,4,3,1,1,100.0,0,4,0,4,0,9,2,0,Matches
Sean Longstaff,eng ENG,MF,Newcastle Utd,23,1997,16.3,54,34,18,31,5,24,65,36.9,41,18,6,12,9,63,18,0,Matches
Ademola Lookman,ng NGA,"FW,MF",Leicester City,23,1997,16.1,32,14,10,13,9,10,28,35.7,18,19,1,18,10,42,4,0,Matches
Jonas Lössl,dk DEN,GK,Brentford,32,1989,2.0,0,0,0,0,0,0,0,,0,0,0,0,0,0,1,0,Matches
Imran Louza,ma MAR,MF,Watford,22,1999,15.7,41,21,18,20,3,16,38,42.1,22,28,6,22,42,83,20,1,Matches
Matthew Lowton,eng ENG,DF,Burnley,32,1989,19.7,38,24,20,10,8,20,37,54.1,17,25,11,14,26,64,68,0,Matches
Douglas Luiz,br BRA,MF,Aston Villa,23,1998,30.2,59,39,30,24,5,21,72,29.2,51,30,7,23,34,93,28,1,Matches
Romelu Lukaku,be BEL,FW,Chelsea,28,1993,17.7,2,1,0,1,1,1,5,20.0,4,11,1,10,0,2,20,0,Matches
Lyanco,br BRA,DF,Southampton,24,1997,10.1,18,15,11,7,0,10,18,55.6,8,18,13,5,13,31,50,1,Matches
Alexis Mac Allister,ar ARG,"MF,FW",Brighton,22,1998,23.6,65,40,23,30,12,29,68,42.6,39,37,7,30,13,78,22,0,Matches
James Maddison,eng ENG,"MF,FW",Leicester City,24,1996,27.3,40,20,8,24,8,14,46,30.4,32,18,3,15,11,51,12,0,Matches

Gabriel Magalhães,br BRA,DF,Arsenal,23,1997,34.0,50,30,36,12,2,30,41,73.2,11,34,26,8,13,63,112,4,Matches
Harry Maguire,eng ENG,DF,Manchester Utd,28,1993,27.9,34,21,22,8,4,19,31,61.3,12,36,29,7,32,66,101,3,Matches
Riyad Mahrez,dz ALG,FW,Manchester City,30,1991,16.6,11,3,5,4,2,5,19,26.3,14,15,1,14,6,17,6,0,Matches
Ainsley Maitland-Niles,eng ENG,MF,Arsenal,23,1997,3.0,8,4,5,3,0,2,4,50.0,2,2,0,2,4,12,4,0,Matches
Sadio Mané,sn SEN,FW,Liverpool,29,1992,31.3,33,20,7,14,12,8,26,30.8,18,30,1,29,8,41,15,0,Matches
Javier Manquillo,es ESP,DF,Newcastle Utd,27,1994,14.0,39,29,28,10,1,21,36,58.3,15,15,6,9,10,49,32,0,Matches
Fernando Marçal,br BRA,"MF,DF",Wolves,32,1989,16.1,42,22,27,14,1,21,37,56.8,16,25,4,21,28,70,52,0,Matches
Solly March,eng ENG,"DF,FW",Brighton,27,1994,19.4,30,17,11,9,10,7,22,31.8,15,22,3,19,17,47,25,0,Matches
Pablo Marí,es ESP,DF,Arsenal,27,1993,2.0,5,3,1,3,1,3,6,50.0,3,5,4,1,3,8,10,0,Matches
Anthony Martial,fr FRA,FW,Manchester Utd,25,1995,2.4,0,0,0,0,0,0,1,0.0,1,1,0,1,0,0,1,0,Matches
Gabriel Martinelli,br BRA,"FW,MF",Arsenal,20,2001,20.7,27,19,7,14,6,10,29,34.5,19,26,1,25,20,47,15,0,Matches
Emiliano Martínez,ar ARG,GK,Aston Villa,28,1992,36.0,1,1,1,0,0,1,3,33.3,2,0,0,0,0,1,6,1,Matches
Adam Masina,ma MAR,DF,Watford,27,1994,12.0,24,13,11,10,3,12,29,41.4,17,18,6,12,18,42,45,0,Matches
Arthur Masuaku,cd COD,"DF,FW",West Ham,27,1993,7.2,31,23,19,11,1,14,23,60.9,9,9,1,8,9,40,17,0,Matches
Juan Mata,es ESP,MF,Manchester Utd,33,1988,2.6,6,4,2,3,1,3,5,60.0,2,1,0,1,1,7,1,0,Matches
Jean-Philippe Mateta,fr FRA,FW,Crystal Palace,24,1997,12.7,8,4,2,5,1,3,18,16.7,15,11,3,8,4,12,13,0,Matches
Nemanja Matić,rs SRB,MF,Manchester Utd,32,1988,15.4,31,18,19,11,1,15,31,48.4,16,21,6,15,31,62,21,3,Matches
Joël Matip,cm CMR,DF,Liverpool,29,1991,31.0,47,34,23,19,5,20,31,64.5,11,26,14,12,44,91,93,1,Matches
Neal Maupay,fr FRA,FW,Brighton,24,1996,25.3,17,10,2,6,9,4,18,22.2,14,21,2,19,2,19,2,0,Matches
Bryan Mbeumo,cm CMR,FW,Brentford,21,1999,32.3,28,16,1,12,15,6,20,30.0,14,21,6,15,11,39,20,0,Matches
James McArthur,sct SCO,MF,Crystal Palace,33,1987,16.0,33,23,13,19,1,16,44,36.4,28,23,9,14,30,63,27,0,Matches
James Mcatee,eng ENG,"MF,FW",Manchester City,18,2002,0.2,0,0,0,0,0,0,2,0.0,2,0,0,0,0,0,0,0,Matches
Kasey McAteer,ie IRL,FW,Leicester City,19,2001,0.0,0,0,0,0,0,0,0,,0,0,0,0,0,0,0,0,Matches
Liam McCarron,sct SCO,FW,Leeds United,20,2001,0.1,0,0,0,0,0,0,0,,0,1,0,1,0,0,0,0,Matches
Alex McCarthy,eng ENG,GK,Southampton,31,1989,17.0,0,0,0,0,0,0,0,,0,0,0,0,0,0,4,0,Matches

John McGinn,sct SCO,MF,Aston Villa,26,1994,34.3,106,64,35,55,16,54,104,51.9,50,53,6,47,35,141,34,0,Matches
Stuart McKinstry,sct SCO,MF,Leeds United,18,2002,0.0,0,0,0,0,0,0,0,,0,0,0,0,0,0,0,0,Matches
Kenny McLean,sct SCO,MF,Norwich City,29,1992,30.1,42,22,18,20,4,17,59,28.8,42,29,7,22,34,76,54,0,Matches
Dwight McNeil,eng ENG,MF,Burnley,21,1999,34.5,78,49,27,38,13,33,73,45.2,40,64,11,53,35,113,31,1,Matches
Scott McTominay,sct SCO,MF,Manchester Utd,24,1996,26.5,65,33,32,24,9,30,61,49.2,31,45,10,35,31,96,60,1,Matches
Ben Mee,eng ENG,DF,Burnley,31,1989,20.4,26,12,16,7,3,12,19,63.2,7,28,22,6,24,50,94,1,Matches
Hannibal Mejbri,tn TUN,FW,Manchester Utd,18,2003,0.8,2,1,1,1,0,1,1,100.0,0,0,0,0,0,2,0,0,Matches
Benjamin Mendy,fr FRA,DF,Manchester City,27,1994,0.9,2,2,1,1,0,2,6,33.3,4,0,0,0,0,2,0,0,Matches
Edouard Mendy,sn SEN,GK,Chelsea,29,1992,34.0,1,0,1,0,0,1,3,33.3,2,0,0,0,0,1,13,4,Matches
Nampalys Mendy,sn SEN,MF,Leicester City,29,1992,11.5,12,6,8,4,0,6,17,35.3,11,7,4,3,11,23,11,1,Matches
Illan Meslier,fr FRA,GK,Leeds United,21,2000,37.6,1,1,1,0,0,1,1,100.0,0,0,0,0,0,1,27,1,Matches
Luka Milivojević,rs SRB,MF,Crystal Palace,30,1991,8.6,18,9,9,6,3,10,16,62.5,6,6,1,5,11,29,15,0,Matches
James Milner,eng ENG,"MF,DF",Liverpool,35,1986,9.5,28,16,12,11,5,12,29,41.4,17,19,5,14,17,45,20,0,Matches
Yerry Mina,co COL,DF,Everton,26,1994,9.4,12,10,12,0,0,10,13,76.9,3,13,9,4,11,23,38,1,Matches
Takumi Minamino,jp JPN,"FW,MF",Liverpool,26,1995,2.1,3,2,1,1,1,2,8,25.0,6,2,0,2,1,4,2,0,Matches
Tyrone Mings,eng ENG,DF,Aston Villa,28,1993,35.4,23,12,17,3,3,14,22,63.6,8,47,30,17,46,69,153,2,Matches
Tyrick Mitchell,eng ENG,DF,Crystal Palace,21,1999,34.5,104,57,67,26,11,46,67,68.7,21,47,5,42,41,145,101,0,Matches
Jakub Moder,pl POL,MF,Brighton,22,1999,18.9,42,25,18,17,7,23,42,54.8,19,25,2,23,10,52,22,1,Matches
Wesley Moraes,br BRA,FW,Aston Villa,24,1996,0.0,0,0,0,0,0,0,0,,0,0,0,0,0,0,0,0,Matches
Tyler Morton,eng ENG,MF,Liverpool,18,2002,0.7,0,0,0,0,0,0,2,0.0,2,0,0,0,3,3,0,0,Matches
Mason Mount,eng ENG,MF,Chelsea,22,1999,26.3,41,16,10,17,14,10,34,29.4,24,18,1,17,13,54,12,0,Matches
Lucas Moura,br BRA,"FW,MF",Tottenham,28,1992,19.7,25,10,7,14,4,8,35,22.9,27,19,0,19,18,43,19,0,Matches
João Moutinho,pt POR,MF,Wolves,34,1986,33.0,74,39,34,27,13,30,106,28.3,76,48,8,40,34,108,36,2,Matches
Bali Mumba,eng ENG,DF,Norwich City,19,2001,0.5,1,1,1,0,0,0,0,,0,0,0,0,0,1,5,0,Matches
Jacob Murphy,eng ENG,"FW,DF",Newcastle Utd,26,1995,16.4,49,26,34,11,4,26,41,63.4,15,20,2,18,23,72,17,0,Matches

Enock Mwepu,zm ZAM,MF,Brighton,23,1998,11.1,22,12,10,10,2,5,27,18.5,22,20,2,18,12,34,19,0,Matches
Vitaliy Mykolenko,ua UKR,DF,Everton,22,1999,11.7,25,15,15,7,3,12,21,57.1,9,15,2,13,16,41,37,0,Matches
Marvelous Nakamba,zw ZIM,MF,Aston Villa,27,1994,10.0,32,19,18,14,0,12,34,35.3,22,14,4,10,12,44,17,1,Matches
Wilfred Ndidi,ng NGA,"MF,DF",Leicester City,24,1996,18.0,60,32,32,27,1,22,55,40.0,33,36,8,28,42,102,54,1,Matches
Tanguy Ndombele,fr FRA,MF,Tottenham,24,1996,5.4,10,7,3,5,2,1,8,12.5,7,5,0,5,1,11,1,0,Matches
Reiss Nelson,eng ENG,FW,Arsenal,21,1999,0.2,1,0,0,0,1,0,1,0.0,1,1,0,1,0,1,0,0,Matches
Pedro Neto,pt POR,"FW,MF",Wolves,21,2000,5.2,4,4,2,0,2,0,9,0.0,9,0,0,0,6,10,1,0,Matches
Rúben Neves,pt POR,MF,Wolves,24,1997,29.6,68,37,23,41,4,24,87,27.6,63,39,5,34,41,109,49,3,Matches
Jeremy Ngakia,eng ENG,DF,Watford,20,2000,10.0,31,18,23,5,3,11,26,42.3,15,11,4,7,12,43,32,0,Matches
Saúl Ñíguez,es ESP,"DF,MF",Chelsea,26,1994,5.3,20,9,11,9,0,9,16,56.3,7,14,3,11,7,27,10,1,Matches
Eddie Nketiah,eng ENG,FW,Arsenal,22,1999,9.3,9,4,1,4,4,1,4,25.0,3,9,2,7,4,13,5,0,Matches
Nicolas Nkoulou,cm CMR,DF,Watford,31,1990,1.9,1,0,0,1,0,0,0,,0,2,1,1,2,3,8,0,Matches
Mark Noble,eng ENG,MF,West Ham,34,1987,3.7,8,2,7,1,0,5,11,45.5,6,4,1,3,4,12,2,1,Matches
Mathias Normann,no NOR,MF,Norwich City,25,1996,18.3,34,21,19,14,1,17,46,37.0,29,17,8,9,19,53,43,1,Matches
Christian Nørgaard,dk DEN,MF,Brentford,27,1994,33.9,109,60,42,58,9,52,101,51.5,49,48,9,39,64,173,58,1,Matches
Angelo Ogbonna,it ITA,DF,West Ham,33,1988,10.2,7,4,5,2,0,3,7,42.9,4,5,4,1,11,18,29,0,Matches
Michael Olise,fr FRA,"FW,MF",Crystal Palace,19,2001,12.7,22,18,8,11,3,7,24,29.2,17,17,0,17,6,28,6,0,Matches
Robin Olsen,se SWE,GK,Aston Villa,31,1990,1.0,0,0,0,0,0,0,0,,0,0,0,0,0,0,0,0,Matches
Andrew Omobamidele,ie IRL,DF,Norwich City,19,2002,4.2,8,6,5,3,0,5,11,45.5,6,8,8,0,5,13,13,0,Matches
Tyler Onyango,eng ENG,MF,Everton,18,2003,0.3,0,0,0,0,0,0,0,,0,0,0,0,0,0,1,0,Matches
Frank Onyeka,ng NGA,MF,Brentford,23,1998,11.6,25,17,13,9,3,8,27,29.6,19,16,2,14,14,39,13,0,Matches
Divock Origi,be BEL,FW,Liverpool,26,1995,1.5,0,0,0,0,0,0,2,0.0,2,1,0,1,1,1,2,0,Matches
Alex Oxlade-Chamberlain,eng ENG,"MF,FW",Liverpool,27,1993,8.7,15,11,2,8,5,3,14,21.4,11,12,2,10,6,21,5,0,Matches
Cole Palmer,eng ENG,"FW,MF",Manchester City,19,2002,1.4,2,1,1,1,0,0,2,0.0,2,3,0,3,1,3,0,0,Matches
Emerson Palmieri,it ITA,DF,Chelsea,26,1994,0.1,0,0,0,0,0,0,0,,0,0,0,0,0,0,0,0,Matches

Thomas Partey,gh GHA,MF,Arsenal,28,1993,22.5,43,29,22,17,4,18,44,40.9,26,22,4,18,23,66,35,2,Matches
Nicolas Pépé,ci CIV,"FW,MF",Arsenal,26,1995,7.7,8,5,3,5,0,3,9,33.3,6,9,1,8,8,16,2,0,Matches
Ricardo Pereira,pt POR,DF,Leicester City,27,1993,11.0,37,20,19,13,5,21,40,52.5,19,13,1,12,17,54,39,0,Matches
Ayoze Pérez,es ESP,"MF,FW",Leicester City,28,1993,4.9,4,2,0,3,1,0,13,0.0,13,11,1,10,2,6,5,0,Matches
Sonny Perkins,eng ENG,MF,West Ham,17,2004,0.0,0,0,0,0,0,0,0,,0,0,0,0,0,0,0,0,Matches
Romain Perraud,fr FRA,DF,Southampton,23,1997,18.0,34,22,18,14,2,16,29,55.2,13,24,6,18,17,51,42,0,Matches
Kalvin Phillips,eng ENG,MF,Leeds United,25,1995,17.7,54,25,24,25,5,24,57,42.1,33,37,9,28,24,78,18,0,Matches
Jaden Philogene Bidace,eng ENG,FW,Aston Villa,19,2002,0.1,0,0,0,0,0,0,0,,0,0,0,0,0,0,0,0,Matches
Jordan Pickford,eng ENG,GK,Everton,27,1994,35.0,1,1,1,0,0,0,1,0.0,1,1,0,1,1,2,14,1,Matches
Erik Pieters,nl NED,DF,Burnley,32,1988,8.1,28,15,15,11,2,17,28,60.7,11,18,7,11,10,38,38,0,Matches
Ethan Pinnock,jm JAM,DF,Brentford,28,1993,29.9,51,35,37,12,2,25,38,65.8,13,30,11,19,44,95,154,1,Matches
Daniel Podence,pt POR,"FW,MF",Wolves,25,1995,16.5,18,11,10,5,3,4,17,23.5,13,8,1,7,10,28,1,0,Matches
Paul Pogba,fr FRA,"MF,FW",Manchester Utd,28,1993,15.0,13,9,5,7,1,6,28,21.4,22,11,0,11,13,26,16,0,Matches
Nick Pope,eng ENG,GK,Burnley,29,1992,36.0,0,0,0,0,0,0,2,0.0,2,0,0,0,2,2,30,3,Matches
Isaac Price,nir NIR,MF,Everton,17,2003,0.2,0,0,0,0,0,0,0,,0,1,0,1,0,0,0,0,Matches
Teemu Pukki,fi FIN,FW,Norwich City,31,1990,36.1,23,11,2,14,7,6,29,20.7,23,21,1,20,4,27,3,0,Matches
Christian Pulisic,us USA,"MF,FW",Chelsea,22,1998,14.3,10,7,6,3,1,3,17,17.6,14,12,0,12,5,15,10,0,Matches
Przemysław Płacheta,pl POL,"FW,MF",Norwich City,23,1998,5.6,4,3,3,1,0,2,7,28.6,5,3,1,2,2,6,5,1,Matches
Jesurun Rak Sakyi,eng ENG,"FW,MF",Crystal Palace,18,2002,0.9,0,0,0,0,0,0,1,0.0,1,3,0,3,1,1,0,0,Matches
Aaron Ramsdale,eng ENG,GK,Arsenal,23,1998,34.0,2,1,2,0,0,1,2,50.0,1,0,0,0,0,2,26,3,Matches
Jacob Ramsey,eng ENG,MF,Aston Villa,20,2001,27.4,67,44,31,28,8,30,69,43.5,39,36,7,29,24,91,28,0,Matches
Raphinha,br BRA,"FW,MF",Leeds United,24,1996,32.4,51,29,25,14,12,22,71,31.0,49,43,0,43,29,80,28,1,Matches
Marcus Rashford,eng ENG,"FW,MF",Manchester Utd,23,1997,13.7,6,5,1,4,1,2,13,15.4,11,10,1,9,5,11,5,1,Matches
Milot Rashica,xk KVX,"FW,MF",Norwich City,25,1996,24.8,31,19,12,12,7,11,30,36.7,19,22,3,19,15,46,23,0,Matches
David Raya,es ESP,GK,Brentford,25,1995,24.0,0,0,0,0,0,0,0,,0,1,0,1,0,0,10,1,Matches

Nathan Redmond,eng ENG,"MF,FW",Southampton,27,1994,20.4,22,14,9,9,4,7,30,23.3,23,21,2,19,8,30,16,0,Matches
Sergio Reguilón,es ESP,"DF,MF",Tottenham,24,1996,21.3,40,24,15,18,7,22,43,51.2,21,20,8,12,31,71,45,1,Matches
Declan Rice,eng ENG,MF,West Ham,22,1999,35.3,80,42,45,32,3,38,71,53.5,33,45,21,24,63,143,52,1,Matches
Taylor Richards,eng ENG,MF,Brighton,20,2000,0.3,1,0,0,1,0,1,2,50.0,1,0,0,0,0,1,0,0,Matches
Richarlison,br BRA,FW,Everton,24,1997,28.0,40,23,18,15,7,15,31,48.4,16,42,4,38,12,52,34,0,Matches
Jaïro Riedewald,nl NED,MF,Crystal Palace,24,1996,1.3,1,1,0,1,0,1,2,50.0,1,1,0,1,1,2,2,0,Matches
Matt Ritchie,sct SCO,DF,Newcastle Utd,31,1989,14.9,22,15,10,10,2,10,27,37.0,17,10,2,8,13,35,26,0,Matches
Connor Roberts,wls WAL,DF,Burnley,25,1995,18.8,20,13,10,7,3,10,15,66.7,5,25,5,20,22,42,62,1,Matches
Tyler Roberts,wls WAL,"MF,FW",Leeds United,22,1999,11.0,16,7,6,7,3,9,16,56.3,7,11,1,10,5,21,11,0,Matches
Andrew Robertson,sct SCO,DF,Liverpool,27,1994,28.2,36,21,16,15,5,20,35,57.1,15,24,3,21,23,59,61,0,Matches
Joe Rodon,wls WAL,DF,Tottenham,23,1997,1.0,0,0,0,0,0,0,0,,0,2,1,1,0,0,7,0,Matches
Rodri,es ESP,MF,Manchester City,25,1996,32.0,72,43,24,38,10,32,59,54.2,27,28,5,23,28,100,45,0,Matches
Rodrigo,es ESP,"MF,FW",Leeds United,30,1991,25.2,20,9,7,6,7,4,32,12.5,28,12,0,12,11,31,27,1,Matches
Jay Rodriguez,eng ENG,FW,Burnley,32,1989,15.4,20,12,8,8,4,4,14,28.6,10,19,1,18,4,24,12,0,Matches
Mads Roerslev,dk DEN,DF,Brentford,22,1999,13.8,23,12,19,2,2,14,32,43.8,18,14,5,9,16,39,29,0,Matches
Cristian Romero,ar ARG,DF,Tottenham,23,1998,20.5,62,39,39,21,2,22,34,64.7,12,46,21,25,33,95,74,1,Matches
Oriol Romeu,es ESP,MF,Southampton,29,1991,32.1,77,39,25,45,7,28,73,38.4,45,39,8,31,51,128,43,0,Matches
Cristiano Ronaldo,pt POR,FW,Manchester Utd,36,1985,27.3,8,6,1,5,2,2,6,33.3,4,8,0,8,2,10,29,0,Matches
Salomón Rondón,ve VEN,FW,Everton,31,1989,8.8,6,1,1,2,3,4,14,28.6,10,5,0,5,0,6,10,0,Matches
Danny Rose,eng ENG,DF,Watford,31,1990,7.7,16,10,11,4,1,10,24,41.7,14,8,5,3,14,30,11,1,Matches
Jon Rowe,eng ENG,"FW,MF",Norwich City,18,2003,2.5,3,2,2,1,0,2,3,66.7,1,7,0,7,3,6,1,0,Matches
John Ruddy,eng ENG,GK,Wolves,34,1986,1.5,0,0,0,0,0,0,0,,0,0,0,0,0,0,3,0,Matches
Antonio Rüdiger,de GER,DF,Chelsea,28,1993,33.7,48,28,29,15,4,36,48,75.0,12,20,11,9,28,76,91,1,Matches
Lukas Rupp,de GER,MF,Norwich City,30,1991,8.5,9,4,5,3,1,4,15,26.7,11,11,1,10,9,18,7,0,Matches
José Sá,pt POR,GK,Wolves,28,1993,36.5,2,1,2,0,0,2,4,50.0,2,0,0,0,2,4,19,5,Matches

Allan Saint-Maximin,fr FRA,"FW,MF",Newcastle Utd,24,1997,31.2,13,8,6,4,3,3,17,17.6,14,13,2,11,11,24,3,0,Matches
Romain Saïss,ma MAR,DF,Wolves,31,1990,30.1,40,27,28,11,1,19,33,57.6,14,41,21,20,58,98,158,2,Matches
Bukayo Saka,eng ENG,"FW,MF",Arsenal,19,2001,33.1,40,21,12,17,11,13,39,33.3,26,28,2,26,22,62,23,0,Matches
Mohamed Salah,eg EGY,FW,Liverpool,29,1992,30.7,17,8,5,9,3,6,19,31.6,13,7,1,6,6,23,5,0,Matches
Mohammed Salisu,gh GHA,DF,Southampton,22,1999,33.0,80,47,54,22,4,40,65,61.5,25,49,26,23,78,158,158,4,Matches
Albert Sambi Lokonga,be BEL,MF,Arsenal,21,1999,12.6,22,18,11,9,2,12,14,85.7,2,12,7,5,13,35,12,4,Matches
Davinson Sánchez,co COL,DF,Tottenham,25,1996,18.1,41,22,25,14,2,19,28,67.9,9,24,16,8,30,71,54,3,Matches
Robert Sánchez,es ESP,GK,Brighton,23,1997,37.0,2,1,2,0,0,1,1,100.0,0,1,0,1,0,2,11,4,Matches
Jadon Sancho,eng ENG,"FW,MF",Manchester Utd,21,2000,21.1,14,8,9,4,1,8,22,36.4,14,19,0,19,15,29,5,3,Matches
Morgan Sanson,fr FRA,MF,Aston Villa,26,1994,4.0,12,8,7,2,3,3,7,42.9,4,13,0,13,10,22,2,1,Matches
Samir Santos,br BRA,DF,Watford,26,1994,18.6,24,11,18,6,0,8,19,42.1,11,21,11,10,43,67,85,3,Matches
Josh Sargent,us USA,"FW,MF",Norwich City,21,2000,17.5,26,14,15,7,4,14,39,35.9,25,29,2,27,11,37,18,2,Matches
Jeremy Sarmiento,ec ECU,"FW,MF",Brighton,19,2002,0.5,1,1,0,0,1,0,2,0.0,2,2,0,2,0,1,0,0,Matches
Ismaila Sarr,sn SEN,"FW,MF",Watford,23,1998,20.7,12,7,4,3,5,5,19,26.3,14,10,1,9,9,21,10,0,Matches
Malang Sarr,fr FRA,DF,Chelsea,22,1999,6.1,14,7,10,2,2,7,12,58.3,5,6,3,3,11,25,20,0,Matches
Dane Scarlett,eng ENG,MF,Tottenham,17,2004,0.0,0,0,0,0,0,0,0,,0,0,0,0,0,0,0,0,Matches
Fabian Schär,ch SUI,DF,Newcastle Utd,29,1991,24.0,16,11,11,3,2,8,16,50.0,8,27,18,9,32,48,95,2,Matches
Jeffrey Schlupp,gh GHA,"MF,FW",Crystal Palace,28,1992,20.6,46,25,16,23,7,24,50,48.0,26,39,9,30,18,64,32,0,Matches
Kasper Schmeichel,dk DEN,GK,Leicester City,34,1986,37.0,0,0,0,0,0,0,2,0.0,2,0,0,0,1,1,15,2,Matches
Ken Sema,se SWE,"MF,FW",Watford,27,1993,9.5,16,6,11,4,1,9,20,45.0,11,10,0,10,5,21,11,0,Matches
Nélson Semedo,pt POR,"MF,DF",Wolves,27,1993,23.7,58,39,39,17,2,25,49,51.0,24,23,4,19,21,79,64,1,Matches
Ryan Sessegnon,eng ENG,"DF,MF",Tottenham,21,2000,11.6,25,19,14,7,4,11,22,50.0,11,18,3,15,7,32,26,0,Matches
Jamie Shackleton,eng ENG,"DF,MF",Leeds United,21,1999,7.9,27,16,19,7,1,13,25,52.0,12,11,7,4,8,35,12,1,Matches
Luke Shaw,eng ENG,DF,Manchester Utd,26,1995,17.8,21,13,9,9,3,12,21,57.1,9,22,11,11,9,30,22,2,Matches
Jonjo Shelvey,eng ENG,MF,Newcastle Utd,29,1992,22.0,30,17,12,18,0,14,34,41.2,20,22,7,15,22,52,20,2,Matches

Shola Shoretire,eng ENG,MF,Manchester Utd,17,2004,0.2,0,0,0,0,0,0,0,,0,0,0,0,0,0,0,0,Matches
Francisco Sierralta,cl CHI,DF,Watford,24,1997,4.7,7,3,7,0,0,5,8,62.5,3,7,2,5,6,13,35,0,Matches
Bernardo Silva,pt POR,"MF,FW",Manchester City,26,1994,31.7,57,29,19,19,19,31,67,46.3,36,24,2,22,20,77,19,0,Matches
Fábio Silva,pt POR,FW,Wolves,19,2002,6.4,3,2,0,2,1,0,8,0.0,8,2,0,2,1,4,1,0,Matches
Thiago Silva,br BRA,DF,Chelsea,36,1984,29.4,32,21,19,12,1,11,22,50.0,11,54,31,23,44,76,100,0,Matches
Ellis Simms,eng ENG,FW,Everton,20,2001,0.7,0,0,0,0,0,0,0,,0,1,1,0,0,0,1,0,Matches
Moussa Sissoko,fr FRA,MF,Watford,31,1989,35.8,53,27,27,20,6,28,42,66.7,14,42,13,29,30,83,64,0,Matches
Oliver Skipp,eng ENG,MF,Tottenham,20,2000,15.0,33,19,14,18,1,15,31,48.4,16,19,7,12,12,45,10,1,Matches
William Smallbone,ie IRL,"MF,FW",Southampton,21,2000,1.5,4,4,2,2,0,1,3,33.3,2,4,0,4,2,6,0,0,Matches
Emile Smith Rowe,eng ENG,"MF,FW",Arsenal,21,2000,21.3,14,7,7,7,0,4,20,20.0,16,18,1,17,15,29,10,1,Matches
Cédric Soares,pt POR,DF,Arsenal,29,1991,16.5,38,26,23,9,6,16,25,64.0,9,18,7,11,16,54,31,1,Matches
Tomáš Souček,cz CZE,MF,West Ham,26,1995,34.0,66,32,27,33,6,28,65,43.1,37,34,13,21,52,118,98,1,Matches
Boubakary Soumaré,fr FRA,MF,Leicester City,22,1999,12.2,19,13,10,8,1,8,17,47.1,9,13,1,12,14,33,18,0,Matches
Çağlar Söyüncü,tr TUR,DF,Leicester City,25,1996,27.7,47,30,32,12,3,26,42,61.9,16,44,27,17,32,79,115,1,Matches
Tony Springett,ie IRL,"MF,FW",Norwich City,18,2002,1.6,2,1,1,1,0,1,4,25.0,3,0,0,0,0,2,2,0,Matches
Jason Steele,eng ENG,GK,Brighton,30,1990,1.0,0,0,0,0,0,0,0,,0,0,0,0,0,0,0,0,Matches
Jed Steer,eng ENG,GK,Aston Villa,28,1992,1.0,0,0,0,0,0,0,0,,0,0,0,0,0,0,0,0,Matches
Zack Steffen,us USA,GK,Manchester City,26,1995,1.0,0,0,0,0,0,0,0,,0,0,0,0,0,0,2,0,Matches
Dale Stephens,eng ENG,MF,Burnley,32,1989,1.4,4,1,0,3,1,3,8,37.5,5,4,1,3,1,5,1,0,Matches
Jack Stephens,eng ENG,DF,Southampton,27,1994,9.0,19,12,13,5,1,6,16,37.5,10,12,7,5,19,38,42,0,Matches
Raheem Sterling,eng ENG,FW,Manchester City,26,1994,23.6,23,10,3,11,9,10,23,43.5,13,12,0,12,12,35,3,0,Matches
Finley Stevens,wls WAL,DF,Brentford,18,2003,0.2,3,1,0,3,0,1,1,100.0,0,0,0,0,0,3,0,0,Matches
John Stones,eng ENG,DF,Manchester City,27,1994,12.4,5,3,3,2,0,2,3,66.7,1,3,3,0,11,16,27,1,Matches
Pascal Struijk,nl NED,"DF,MF",Leeds United,21,1999,22.8,61,39,34,23,4,30,50,60.0,20,35,23,12,33,94,60,2,Matches
Crysencio Summerville,nl NED,"MF,FW",Leeds United,19,2001,1.4,5,3,1,1,3,2,3,66.7,1,2,0,2,2,7,0,0,Matches

Jakob Sørensen,dk DEN,"MF,DF",Norwich City,23,1998,6.7,22,11,6,14,2,10,20,50.0,10,7,3,4,10,32,19,0,Matches
Japhet Tanganga,eng ENG,DF,Tottenham,22,1999,8.2,14,8,7,6,1,9,19,47.4,10,13,5,8,9,23,31,0,Matches
Matt Targett,eng ENG,DF,Aston Villa,25,1995,15.9,34,18,28,5,1,24,45,53.3,21,16,9,7,23,57,35,0,Matches
Matt Targett,eng ENG,DF,Newcastle Utd,25,1995,16.0,41,26,26,14,1,24,37,64.9,13,15,4,11,25,66,39,1,Matches
James Tarkowski,eng ENG,DF,Burnley,28,1992,34.5,65,45,47,17,1,33,47,70.2,14,75,61,14,48,113,186,4,Matches
Nuno Tavares,pt POR,DF,Arsenal,21,2000,13.1,21,14,10,7,4,8,18,44.4,10,15,5,10,9,30,33,1,Matches
Charlie Taylor,eng ENG,DF,Burnley,27,1993,30.3,45,26,31,11,3,26,44,59.1,18,42,20,22,58,103,95,2,Matches
Nathan Tella,ng NGA,"MF,FW",Southampton,22,1999,8.9,13,9,5,7,1,6,17,35.3,11,13,0,13,6,19,9,0,Matches
Alex Telles,br BRA,DF,Manchester Utd,28,1992,18.4,48,27,35,9,4,27,43,62.8,16,17,4,13,26,74,45,0,Matches
Luke Thomas,eng ENG,DF,Leicester City,20,2001,21.2,50,31,33,13,4,28,65,43.1,37,35,14,21,40,90,55,0,Matches
Dominic Thompson,eng ENG,DF,Brentford,21,2000,1.6,1,0,1,0,0,0,1,0.0,1,2,2,0,2,3,3,0,Matches
Youri Tielemans,be BEL,MF,Leicester City,24,1997,29.2,74,38,23,45,6,42,100,42.0,58,47,13,34,21,95,41,3,Matches
Kieran Tierney,sct SCO,DF,Arsenal,24,1997,21.3,18,14,11,7,0,10,11,90.9,1,23,5,18,15,33,54,0,Matches
Takehiro Tomiyasu,jp JPN,DF,Arsenal,22,1998,18.7,35,17,19,13,3,21,32,65.6,11,22,3,19,24,59,64,2,Matches
James Tomkins,eng ENG,DF,Crystal Palace,32,1989,6.1,8,3,6,2,0,6,8,75.0,2,8,8,0,4,12,18,0,Matches
Ivan Toney,eng ENG,FW,Brentford,25,1996,32.3,33,21,5,20,8,12,38,31.6,26,16,2,14,14,47,44,1,Matches
Ferrán Torres,es ESP,FW,Manchester City,21,2000,3.4,2,2,0,1,1,0,3,0.0,3,2,0,2,0,2,1,0,Matches
Cenk Tosun,tr TUR,MF,Everton,30,1991,0.1,0,0,0,0,0,0,0,,0,0,0,0,0,0,0,0,Matches
Andros Townsend,eng ENG,"MF,FW",Everton,30,1991,16.2,31,17,15,6,10,15,40,37.5,25,28,2,26,14,45,6,1,Matches
Adama Traoré,es ESP,"FW,MF",Wolves,25,1996,11.9,8,3,6,0,2,3,7,42.9,4,4,1,3,2,10,1,0,Matches
Bertrand Traoré,bf BFA,"MF,FW",Aston Villa,25,1995,2.4,3,3,0,1,2,1,2,50.0,1,0,0,0,0,3,1,0,Matches
Trézéguet,eg EGY,FW,Aston Villa,26,1994,0.1,0,0,0,0,0,0,0,,0,0,0,0,0,0,0,0,Matches
Francisco Trincão,pt POR,"FW,MF",Wolves,21,1999,14.8,28,15,9,13,6,3,19,15.8,16,17,1,16,12,40,1,1,Matches
Kieran Trippier,eng ENG,DF,Newcastle Utd,30,1990,4.8,17,10,8,8,1,10,16,62.5,6,10,3,7,10,27,10,0,Matches
William Troost-Ekong,ng NGA,DF,Watford,27,1993,15.4,18,9,11,6,1,10,15,66.7,5,24,14,10,7,25,82,1,Matches

Leandro Trossard,be BEL,"FW,MF",Brighton,26,1994,31.2,34,20,12,9,13,4,31,12.9,27,33,4,29,15,49,10,0,Matches
Kostas Tsimikas,gr GRE,DF,Liverpool,25,1996,9.7,27,12,12,8,7,12,16,75.0,4,6,2,4,10,37,22,2,Matches
Axel Tuanzebe,cd COD,DF,Aston Villa,23,1997,5.6,5,3,3,2,0,2,5,40.0,3,5,4,1,5,10,12,1,Matches
Ozan Tufan,tr TUR,MF,Watford,26,1995,3.7,3,2,1,1,1,1,5,20.0,4,2,0,2,2,5,4,0,Matches
Christos Tzolis,gr GRE,"FW,MF",Norwich City,19,2002,3.7,5,3,3,1,1,2,9,22.2,7,3,0,3,1,6,1,0,Matches
Yan Valery,tn TUN,DF,Southampton,22,1999,4.1,8,6,4,3,1,4,9,44.4,5,6,3,3,6,14,19,1,Matches
Virgil van Dijk,nl NED,DF,Liverpool,30,1991,34.0,16,10,11,5,0,11,16,68.8,5,21,14,7,31,47,109,0,Matches
Raphaël Varane,fr FRA,DF,Manchester Utd,28,1993,20.3,28,19,21,6,1,10,22,45.5,12,18,9,9,18,46,82,1,Matches
Jamie Vardy,eng ENG,FW,Leicester City,34,1987,20.1,6,5,0,4,2,1,7,14.3,6,9,0,9,1,7,17,0,Matches
Joël Veltman,nl NED,DF,Brighton,29,1992,31.9,74,48,47,21,6,21,53,39.6,32,46,16,30,45,119,89,0,Matches
Jannik Vestergaard,dk DEN,DF,Leicester City,28,1992,6.3,15,10,12,3,0,8,15,53.3,7,10,8,2,7,22,36,0,Matches
Nikola Vlašić,hr CRO,"FW,MF",West Ham,23,1997,6.2,11,7,4,6,1,5,20,25.0,15,4,0,4,2,13,1,0,Matches
Matěj Vydra,cz CZE,FW,Burnley,29,1992,7.5,12,7,3,4,5,3,7,42.9,4,5,1,4,0,12,9,0,Matches
Theo Walcott,eng ENG,"MF,FW",Southampton,32,1989,4.2,4,2,2,0,2,1,5,20.0,4,3,0,3,5,9,2,0,Matches
Kyle Walker,eng ENG,DF,Manchester City,31,1990,19.5,15,6,7,7,1,8,17,47.1,9,14,4,10,14,29,16,1,Matches
Kyle Walker-Peters,eng ENG,DF,Southampton,24,1997,29.3,57,33,28,21,8,26,38,68.4,12,29,8,21,37,94,53,1,Matches
Aaron Wan-Bissaka,eng ENG,DF,Manchester Utd,23,1997,19.9,49,36,25,18,6,14,20,70.0,6,24,14,10,34,83,41,2,Matches
Danny Ward,wls WAL,GK,Leicester City,28,1993,1.0,0,0,0,0,0,0,0,,0,0,0,0,0,0,1,0,Matches
Joel Ward,eng ENG,DF,Crystal Palace,31,1989,27.6,44,26,30,11,3,30,57,52.6,27,24,11,13,32,76,107,1,Matches
James Ward-Prowse,eng ENG,MF,Southampton,26,1994,35.7,41,24,12,24,5,19,70,27.1,51,43,15,28,40,81,45,1,Matches
Ollie Watkins,eng ENG,FW,Aston Villa,25,1995,32.8,17,13,2,7,8,2,15,13.3,13,25,3,22,12,29,27,0,Matches
Adam Webster,eng ENG,DF,Brighton,26,1995,15.9,26,8,17,7,2,13,20,65.0,7,25,17,8,17,43,66,2,Matches
Wout Weghorst,nl NED,FW,Burnley,28,1992,16.1,17,9,3,9,5,6,19,31.6,13,16,5,11,6,23,13,0,Matches
Danny Welbeck,eng ENG,"FW,MF",Brighton,30,1990,16.4,14,7,2,8,4,3,10,30.0,7,18,2,16,5,19,18,0,Matches
Timo Werner,de GER,"FW,MF",Chelsea,25,1996,14.3,8,4,3,3,2,2,20,10.0,18,9,0,9,2,10,4,0,Matches

Ashley Westwood,eng ENG,MF,Burnley,31,1990,25.4,21,12,8,12,1,10,31,32.3,21,21,9,12,30,51,16,1,Matches
Ben White,eng ENG,DF,Arsenal,23,1997,32.0,44,23,30,8,6,28,45,62.2,17,42,24,18,42,86,102,0,Matches
Brandon Williams,eng ENG,DF,Norwich City,20,2000,23.6,55,37,35,18,2,36,64,56.3,28,26,6,20,44,99,50,0,Matches
Neco Williams,wls WAL,DF,Liverpool,20,2001,0.1,0,0,0,0,0,0,0,,0,0,0,0,0,0,0,0,Matches
Joe Willock,eng ENG,MF,Newcastle Utd,21,1999,22.6,64,37,30,28,6,29,68,42.6,39,37,6,31,21,85,10,1,Matches
Callum Wilson,eng ENG,FW,Newcastle Utd,29,1992,15.4,9,8,1,5,3,1,4,25.0,3,7,2,5,3,12,10,0,Matches
Harry Winks,eng ENG,MF,Tottenham,25,1996,10.1,15,10,4,9,2,8,21,38.1,13,14,3,11,16,31,10,2,Matches
Yoane Wissa,cd COD,FW,Brentford,24,1996,14.3,12,6,5,4,3,1,16,6.3,15,12,5,7,8,20,6,0,Matches
Chris Wood,nz NZL,FW,Burnley,29,1991,15.2,7,5,0,3,4,3,10,30.0,7,13,4,9,0,7,3,0,Matches
Chris Wood,nz NZL,FW,Newcastle Utd,29,1991,14.7,2,0,1,1,0,1,2,50.0,1,5,2,3,2,4,9,0,Matches
Freddie Woodman,eng ENG,GK,Newcastle Utd,24,1997,4.0,0,0,0,0,0,0,0,,0,0,0,0,0,0,0,1,Matches
Granit Xhaka,ch SUI,"MF,DF",Arsenal,28,1992,25.9,32,18,16,12,4,16,41,39.0,25,21,6,15,21,53,31,0,Matches
Andriy Yarmolenko,ua UKR,"FW,MF",West Ham,31,1989,3.5,4,2,2,2,0,2,8,25.0,6,4,2,2,0,4,2,0,Matches
Ashley Young,eng ENG,"DF,FW",Aston Villa,36,1985,13.9,18,6,9,6,3,11,16,68.8,5,10,4,6,13,31,25,1,Matches
Nathan Young-Coombes,eng ENG,MF,Brentford,18,2003,0.0,0,0,0,0,0,0,0,,0,0,0,0,0,0,0,0,Matches
Wilfried Zaha,ci CIV,FW,Crystal Palace,28,1992,30.7,40,20,14,15,11,10,31,32.3,21,28,0,28,5,45,5,0,Matches
Christoph Zimmermann,de GER,DF,Norwich City,28,1993,1.7,6,3,5,1,0,3,4,75.0,1,0,0,0,1,7,4,0,Matches
Oleksandr Zinchenko,ua UKR,DF,Manchester City,24,1996,11.6,20,14,7,10,3,11,20,55.0,9,11,3,8,14,34,15,1,Matches
Hakim Ziyech,ma MAR,"MF,FW",Chelsea,28,1993,14.7,19,10,5,12,2,10,36,27.8,26,11,1,10,10,29,10,0,Matches
Kurt Zouma,fr FRA,DF,West Ham,26,1994,23.1,11,6,8,3,0,4,7,57.1,3,31,26,5,34,45,132,0,Matches
Martin Ødegaard,no NOR,"MF,FW",Arsenal,22,1998,30.9,49,21,6,24,19,22,61,36.1,39,18,1,17,11,60,11,1,Matches
