Player,Nation,Position,Squad,Age,Year of birth,90s Played,Tackles,Tackles Won,Tackles (Def 3rd),Tackles (Mid 3rd),Tackles (Att 3rd),Dribblers Tackled,Dribbles Challenged,% of Dribblers Tackled,Challenges Lost,Blocks,Shots Blocked,Passes Blocked,Interceptions,Tkl+Int,Clearances,Errors,Matches


Brenden Aaronson,us USA,"MF,FW",Leeds United,21,2000,26.4,45,18,16,22,7,15,46,32.6,31,43,3,40,5,50,6,1,Matches
George Abbott,eng ENG,MF,Tottenham,16,2005,0.0,0,0,0,0,0,0,0,,0,0,0,0,1,1,0,0,Matches
Che Adams,sct SCO,FW,Southampton,26,1996,22.1,17,13,7,8,2,7,12,58.3,5,13,4,9,4,21,22,0,Matches
Tyler Adams,us USA,MF,Leeds United,23,1999,24.0,89,46,44,35,10,50,77,64.9,27,48,8,40,35,124,29,0,Matches
Tosin Adarabioyo,eng ENG,DF,Fulham,24,1997,23.2,30,13,22,6,2,16,23,69.6,7,20,15,5,26,56,140,1,Matches
Nayef Aguerd,ma MAR,DF,West Ham,26,1996,17.7,27,18,18,8,1,13,20,65.0,7,26,24,2,18,45,79,2,Matches
Naouirou Ahamada,fr FRA,"MF,FW",Crystal Palace,20,2002,1.0,3,2,3,0,0,1,3,33.3,2,2,0,2,0,3,0,0,Matches
Rayan Aït-Nouri,dz ALG,DF,Wolves,21,2001,12.0,33,20,25,7,1,9,16,56.3,7,3,0,3,9,42,28,0,Matches
Kristoffer Ajer,no NOR,DF,Brentford,24,1998,8.5,11,8,5,4,2,9,16,56.3,7,6,5,1,7,18,22,0,Matches
Manuel Akanji,ch SUI,DF,Manchester City,27,1995,25.4,36,25,15,18,3,23,36,63.9,13,27,9,18,16,52,33,1,Matches
Nathan Aké,nl NED,DF,Manchester City,27,1995,20.8,26,12,15,9,2,11,15,73.3,4,20,10,10,20,46,48,0,Matches
Marc Albrighton,eng ENG,"FW,MF",Leicester City,32,1989,2.6,4,1,0,2,2,1,8,12.5,7,6,2,4,1,5,5,0,Matches
Thiago Alcántara,es ESP,MF,Liverpool,31,1991,13.9,43,24,20,21,2,14,23,60.9,9,15,3,12,21,64,13,2,Matches
Carlos Alcaraz,ar ARG,"MF,FW",Southampton,19,2002,11.4,10,5,2,7,1,6,22,27.3,16,14,5,9,1,11,11,0,Matches
Trent Alexander-Arnold,eng ENG,DF,Liverpool,23,1998,32.5,57,40,32,16,9,42,80,52.5,38,25,7,18,43,100,41,2,Matches
Alisson,br BRA,GK,Liverpool,29,1992,37.0,0,0,0,0,0,0,3,0.0,3,3,0,3,0,0,20,0,Matches
Dele Alli,eng ENG,MF,Everton,26,1996,0.4,0,0,0,0,0,0,0,,0,0,0,0,0,0,0,0,Matches
Miguel Almirón,py PAR,FW,Newcastle Utd,28,1994,27.7,46,30,16,19,11,18,42,42.9,24,25,2,23,10,56,17,0,Matches
Julián Álvarez,ar ARG,"FW,MF",Manchester City,22,2000,16.3,26,16,3,13,10,9,30,30.0,21,13,0,13,2,28,6,0,Matches
Daniel Amartey,gh GHA,DF,Leicester City,27,1994,17.9,19,8,13,5,1,12,14,85.7,2,24,17,7,8,27,71,0,Matches
Samuel Amo-Ameyaw,eng ENG,MF,Southampton,16,2006,0.0,0,0,0,0,0,0,1,0.0,1,0,0,0,0,0,0,0,Matches
Joachim Andersen,dk DEN,DF,Crystal Palace,26,1996,30.9,42,22,30,12,0,16,32,50.0,16,28,13,15,24,66,188,1,Matches
Elliot Anderson,eng ENG,"MF,FW",Newcastle Utd,19,2002,4.6,11,5,5,3,3,6,12,50.0,6,11,2,9,6,17,2,0,Matches
Jaidon Anthony,eng ENG,"MF,FW",Bournemouth,22,1999,14.0,30,17,15,9,6,8,24,33.3,16,30,3,27,10,40,19,0,Matches
Michail Antonio,jm JAM,FW,West Ham,32,1990,20.3,14,7,1,8,5,3,12,25.0,9,13,5,8,5,19,9,0,Matches

Antony,br BRA,FW,Manchester Utd,22,2000,20.0,22,9,9,9,4,8,28,28.6,20,18,0,18,11,33,6,0,Matches
Cameron Archer,eng ENG,"FW,MF",Aston Villa,21,2001,0.5,0,0,0,0,0,0,0,,0,0,0,0,0,0,0,0,Matches
Alphonse Areola,fr FRA,GK,West Ham,29,1993,3.4,0,0,0,0,0,0,0,,0,0,0,0,0,0,0,0,Matches
Joe Aribo,ng NGA,"MF,FW",Southampton,26,1996,13.6,31,20,15,12,4,11,20,55.0,9,14,1,13,10,41,11,0,Matches
Adam Armstrong,eng ENG,"FW,MF",Southampton,25,1997,14.8,14,9,6,5,3,3,10,30.0,7,15,3,12,5,19,6,0,Matches
Stuart Armstrong,sct SCO,"MF,FW",Southampton,30,1992,15.6,32,21,15,13,4,14,39,35.9,25,18,0,18,10,42,9,2,Matches
Kepa Arrizabalaga,es ESP,GK,Chelsea,27,1994,28.5,2,2,2,0,0,2,3,66.7,1,0,0,0,1,3,16,2,Matches
Pierre-Emerick Aubameyang,ga GAB,FW,Chelsea,33,1989,6.2,1,0,1,0,0,0,1,0.0,1,2,0,2,2,3,4,2,Matches
Ludwig Augustinsson,se SWE,DF,Aston Villa,28,1994,0.9,1,1,1,0,0,0,0,,0,0,0,0,0,1,1,0,Matches
Serge Aurier,ci CIV,DF,Nott'ham Forest,29,1992,21.6,64,41,41,18,5,23,33,69.7,10,34,11,23,29,93,75,0,Matches
Taiwo Awoniyi,ng NGA,FW,Nott'ham Forest,24,1997,15.6,17,10,2,10,5,6,12,50.0,6,18,4,14,4,21,20,0,Matches
Yasin Ayari,se SWE,MF,Brighton,18,2003,0.7,2,2,1,1,0,0,4,0.0,4,1,0,1,0,2,0,0,Matches
André Ayew,gh GHA,"FW,MF",Nott'ham Forest,32,1989,3.5,5,3,0,4,1,2,4,50.0,2,6,1,5,0,5,7,0,Matches
Jordan Ayew,gh GHA,"FW,MF",Crystal Palace,30,1991,30.2,66,41,23,20,23,21,53,39.6,32,35,4,31,15,81,31,0,Matches
Luke Ayling,eng ENG,DF,Leeds United,30,1991,22.8,66,37,42,15,9,42,85,49.4,43,34,11,23,26,92,52,2,Matches
César Azpilicueta,es ESP,DF,Chelsea,32,1989,17.0,43,25,23,15,5,22,37,59.5,15,26,5,21,19,62,54,1,Matches
Benoît Badiashile,fr FRA,DF,Chelsea,21,2001,10.1,14,8,10,4,0,9,14,64.3,5,5,2,3,16,30,34,1,Matches
Leon Bailey,jm JAM,"FW,MF",Aston Villa,24,1997,21.9,14,6,6,7,1,5,20,25.0,15,13,0,13,6,20,12,0,Matches
Stefan Bajcetic,es ESP,MF,Liverpool,17,2004,5.8,9,6,5,3,1,8,27,29.6,19,7,0,7,9,18,4,0,Matches
Dominic Ballard,eng ENG,"FW,MF",Southampton,17,2005,0.3,0,0,0,0,0,0,0,,0,0,0,0,1,1,0,0,Matches
Patrick Bamford,eng ENG,FW,Leeds United,28,1993,16.8,9,6,0,6,3,4,20,20.0,16,12,5,7,5,14,13,0,Matches
Shandon Baptiste,gd GRN,MF,Brentford,24,1998,6.9,15,9,6,6,3,7,17,41.2,10,10,2,8,7,22,10,0,Matches
Harvey Barnes,eng ENG,"FW,MF",Leicester City,24,1997,30.1,26,14,8,14,4,14,42,33.3,28,32,1,31,8,34,12,0,Matches
Gavin Bazunu,ie IRL,GK,Southampton,20,2002,32.0,1,0,1,0,0,1,1,100.0,0,0,0,0,1,2,24,2,Matches
Mads Bech Sørensen,dk DEN,"DF,MF",Brentford,23,1999,0.2,0,0,0,0,0,0,0,,0,0,0,0,1,1,1,0,Matches

Jan Bednarek,pl POL,DF,Southampton,26,1996,18.6,27,21,20,7,0,12,16,75.0,4,38,27,11,49,76,87,0,Matches
Jan Bednarek,pl POL,DF,Aston Villa,26,1996,1.1,3,3,0,3,0,1,1,100.0,0,3,1,2,2,5,5,0,Matches
Donny van de Beek,nl NED,MF,Manchester Utd,25,1997,1.9,0,0,0,0,0,0,1,0.0,1,2,1,1,1,1,1,0,Matches
Asmir Begović,ba BIH,GK,Everton,35,1987,1.0,0,0,0,0,0,0,0,,0,0,0,0,0,0,1,0,Matches
Armel Bella Kotchap,de GER,DF,Southampton,20,2001,20.9,37,17,28,9,0,15,20,75.0,5,29,12,17,44,81,110,0,Matches
Saïd Benrahma,dz ALG,"FW,MF",West Ham,26,1995,23.0,25,15,11,7,7,11,27,40.7,16,23,1,22,9,34,13,0,Matches
Rodrigo Bentancur,uy URU,MF,Tottenham,25,1997,16.7,45,28,15,21,9,16,28,57.1,12,28,15,13,20,65,22,0,Matches
Daniel Bentley,eng ENG,GK,Wolves,29,1993,2.0,1,1,1,0,0,1,1,100.0,0,0,0,0,0,1,0,1,Matches
Victor Bernth Kristiansen,dk DEN,DF,Leicester City,19,2002,9.9,38,23,18,16,4,22,30,73.3,8,16,4,12,3,41,26,1,Matches
Owen Bevan,wls WAL,DF,Bournemouth,18,2003,0.1,0,0,0,0,0,0,0,,0,0,0,0,0,0,0,0,Matches
Giulian Biancone,fr FRA,DF,Nott'ham Forest,22,2000,0.2,2,1,2,0,0,1,1,100.0,0,0,0,0,1,3,0,0,Matches
Philip Billing,dk DEN,"MF,FW",Bournemouth,26,1996,30.7,63,36,21,33,9,11,42,26.2,31,48,8,40,31,94,58,1,Matches
Yves Bissouma,ml MLI,MF,Tottenham,25,1996,11.2,16,13,6,6,4,2,7,28.6,5,15,6,9,12,28,10,0,Matches
Willy Boly,ci CIV,DF,Nott'ham Forest,31,1991,7.6,13,6,8,3,2,8,13,61.5,5,13,4,9,12,25,45,0,Matches
Sven Botman,nl NED,DF,Newcastle Utd,22,2000,34.7,38,24,31,7,0,22,28,78.6,6,44,24,20,34,72,126,2,Matches
Jarrod Bowen,eng ENG,"FW,MF",West Ham,25,1996,35.9,39,16,14,11,14,16,58,27.6,42,47,9,38,36,75,25,0,Matches
James Bree,eng ENG,DF,Southampton,24,1997,4.1,5,3,4,1,0,3,4,75.0,1,3,1,2,6,11,11,0,Matches
Armando Broja,al ALB,FW,Chelsea,20,2001,3.3,4,1,0,3,1,1,1,100.0,0,10,1,9,1,5,1,0,Matches
David Brooks,wls WAL,"FW,MF",Bournemouth,25,1997,1.9,1,0,1,0,0,0,1,0.0,1,2,0,2,2,3,5,0,Matches
Lewis Brunt,eng ENG,DF,Leicester City,21,2000,0.3,0,0,0,0,0,0,0,,0,0,0,0,0,0,2,0,Matches
Emi Buendía,ar ARG,"MF,FW",Aston Villa,25,1996,26.8,52,23,20,20,12,21,74,28.4,53,20,2,18,20,72,17,0,Matches
Hugo Bueno,es ESP,DF,Wolves,19,2002,14.6,33,16,23,6,4,17,33,51.5,16,14,1,13,10,43,36,0,Matches
Facundo Buonanotte,ar ARG,"FW,MF",Brighton,17,2004,6.3,2,1,1,1,0,1,22,4.5,21,5,2,3,4,6,3,0,Matches
Dan Burn,eng ENG,DF,Newcastle Utd,30,1992,34.6,60,38,29,23,8,34,67,50.7,33,42,16,26,32,92,120,2,Matches
Cafú,pt POR,MF,Nott'ham Forest,29,1993,0.1,0,0,0,0,0,0,0,,0,0,0,0,0,0,1,0,Matches

Moisés Caicedo,ec ECU,MF,Brighton,20,2001,34.9,100,50,41,47,12,40,68,58.8,28,43,7,36,56,156,31,3,Matches
Tom Cairney,sct SCO,MF,Fulham,31,1991,11.0,17,6,4,8,5,7,10,70.0,3,18,3,15,5,22,3,0,Matches
Duje Ćaleta-Car,hr CRO,DF,Southampton,25,1996,10.5,14,10,9,4,1,6,9,66.7,3,15,11,4,15,29,65,1,Matches
Dominic Calvert-Lewin,eng ENG,FW,Everton,25,1997,12.9,4,2,1,0,3,1,5,20.0,4,5,1,4,3,7,18,0,Matches
Chem Campbell,wls WAL,"FW,MF",Wolves,19,2002,0.8,2,1,1,1,0,0,1,0.0,1,2,0,2,1,3,0,0,Matches
João Cancelo,pt POR,DF,Manchester City,28,1994,14.2,29,21,16,9,4,17,24,70.8,7,7,1,6,19,48,9,1,Matches
Thomas Cannon,ie IRL,FW,Everton,19,2002,0.3,0,0,0,0,0,0,0,,0,0,0,0,0,0,0,0,Matches
Sergi Canós,es ESP,"FW,DF",Brentford,25,1997,0.9,0,0,0,0,0,0,2,0.0,2,3,1,2,0,0,1,0,Matches
Diego Carlos,br BRA,DF,Aston Villa,29,1993,2.3,1,0,0,1,0,0,1,0.0,1,2,2,0,1,2,2,0,Matches
Fabio Carvalho,pt POR,"MF,FW",Liverpool,19,2002,3.9,8,8,3,3,2,3,6,50.0,3,6,0,6,6,14,0,0,Matches
Casemiro,br BRA,MF,Manchester Utd,30,1992,23.6,88,46,43,35,10,47,92,51.1,45,49,11,38,34,122,64,0,Matches
Matty Cash,pl POL,DF,Aston Villa,24,1997,20.2,55,32,36,15,4,26,37,70.3,11,20,5,15,26,81,43,0,Matches
Timothy Castagne,be BEL,DF,Leicester City,26,1995,36.2,87,44,53,27,7,41,84,48.8,43,50,13,37,43,130,110,0,Matches
Jonny Castro,es ESP,DF,Wolves,28,1994,14.0,33,15,22,10,1,17,38,44.7,21,26,5,21,14,47,28,2,Matches
Nathaniel Chalobah,eng ENG,MF,Fulham,27,1994,0.1,1,1,1,0,0,1,1,100.0,0,0,0,0,0,1,2,0,Matches
Trevoh Chalobah,eng ENG,DF,Chelsea,23,1999,17.9,31,20,22,6,3,24,35,68.6,11,17,7,10,24,55,56,1,Matches
Calum Chambers,eng ENG,"DF,MF",Aston Villa,27,1995,3.9,9,6,7,2,0,6,8,75.0,2,5,4,1,7,16,10,1,Matches
Shea Charles,nir NIR,DF,Manchester City,18,2003,0.3,4,0,4,0,0,1,1,100.0,0,0,0,0,1,5,2,0,Matches
Ben Chilwell,eng ENG,"DF,MF",Chelsea,25,1996,15.6,21,17,12,8,1,13,25,52.0,12,21,2,19,18,39,26,0,Matches
Ryan Christie,sct SCO,"MF,FW",Bournemouth,27,1995,20.4,34,22,10,23,1,14,50,28.0,36,16,4,12,26,60,20,0,Matches
Carney Chukwuemeka,eng ENG,"MF,FW",Chelsea,18,2003,3.9,13,7,7,6,0,3,5,60.0,2,7,0,7,6,19,1,0,Matches
Bobby Clark,eng ENG,MF,Liverpool,17,2005,0.1,0,0,0,0,0,0,0,,0,2,0,2,0,0,0,0,Matches
Nathaniel Clyne,eng ENG,DF,Crystal Palace,31,1991,18.2,27,16,13,9,5,14,23,60.9,9,22,4,18,19,46,34,0,Matches
Conor Coady,eng ENG,DF,Everton,29,1993,23.3,14,9,8,6,0,7,15,46.7,8,21,17,4,14,28,88,3,Matches
Jack Colback,eng ENG,MF,Nott'ham Forest,32,1989,5.5,18,13,12,6,0,5,8,62.5,3,3,0,3,3,21,9,0,Matches

Séamus Coleman,ie IRL,DF,Everton,33,1988,18.4,35,26,21,10,4,19,29,65.5,10,14,7,7,22,57,58,2,Matches
Nathan Collins,ie IRL,DF,Wolves,21,2001,20.2,27,15,19,8,0,15,24,62.5,9,35,28,7,21,48,84,0,Matches
Levi Colwill,eng ENG,DF,Brighton,19,2003,13.6,8,7,4,4,0,4,9,44.4,5,5,3,2,15,23,37,1,Matches
Lewis Cook,eng ENG,MF,Bournemouth,25,1997,19.1,37,22,10,22,5,18,44,40.9,26,29,10,19,23,60,31,0,Matches
Steve Cook,eng ENG,DF,Nott'ham Forest,31,1991,10.6,8,4,4,4,0,5,7,71.4,2,16,11,5,12,20,51,0,Matches
Liam Cooper,sct SCO,DF,Leeds United,30,1991,15.8,38,23,27,9,2,23,36,63.9,13,16,8,8,34,72,57,3,Matches
Maxwel Cornet,ci CIV,FW,West Ham,25,1996,2.7,7,3,5,0,2,4,6,66.7,2,6,0,6,2,9,3,0,Matches
Diego Costa,es ESP,FW,Wolves,33,1988,13.8,3,1,3,0,0,2,9,22.2,7,6,1,5,2,5,17,0,Matches
Vladimír Coufal,cz CZE,DF,West Ham,29,1992,23.7,58,31,37,15,6,36,51,70.6,15,24,6,18,38,96,70,0,Matches
Philippe Coutinho,br BRA,"MF,FW",Aston Villa,30,1992,8.8,19,14,8,8,3,9,15,60.0,6,11,1,10,4,23,2,0,Matches
Conor Coventry,ie IRL,"MF,FW",West Ham,22,2000,0.0,0,0,0,0,0,0,0,,0,0,0,0,0,0,0,0,Matches
Matthew Craig,sct SCO,MF,Tottenham,19,2003,0.2,4,1,2,2,0,0,0,,0,0,0,0,0,4,0,0,Matches
Aaron Cresswell,eng ENG,DF,West Ham,32,1989,24.8,21,11,12,7,2,12,31,38.7,19,21,11,10,27,48,56,0,Matches
Marc Cucurella,es ESP,DF,Chelsea,24,1998,18.6,66,33,40,15,11,30,60,50.0,30,28,8,20,16,82,48,1,Matches
Matheus Cunha,br BRA,FW,Wolves,23,1999,10.7,7,4,0,5,2,2,10,20.0,8,15,3,12,9,16,11,0,Matches
Patson Daka,zm ZAM,FW,Leicester City,23,1998,13.2,14,8,6,8,0,3,13,23.1,10,14,2,12,7,21,7,0,Matches
Diogo Dalot,pt POR,DF,Manchester Utd,23,1999,23.9,54,41,40,13,1,33,45,73.3,12,25,7,18,37,91,55,2,Matches
Mikkel Damsgaard,dk DEN,"MF,FW",Brentford,22,2000,11.0,31,21,13,13,5,15,42,35.7,27,20,2,18,10,41,14,0,Matches
Danilo,br BRA,MF,Nott'ham Forest,21,2001,10.8,18,7,7,9,2,6,25,24.0,19,26,6,20,9,27,19,0,Matches
Arnaut Danjuma,nl NED,"FW,MF",Tottenham,25,1997,1.9,2,0,1,1,0,0,0,,0,1,0,1,0,2,0,0,Matches
Josh Dasilva,eng ENG,MF,Brentford,23,1998,15.4,18,9,6,6,6,6,16,37.5,10,22,6,16,5,23,7,1,Matches
David Datro Fofana,ci CIV,FW,Chelsea,19,2002,0.8,3,1,1,1,1,1,1,100.0,0,1,0,1,0,3,0,0,Matches
Ben Davies,wls WAL,DF,Tottenham,29,1993,25.4,28,11,13,13,2,14,26,53.8,12,17,8,9,18,46,72,0,Matches
Tom Davies,eng ENG,MF,Everton,24,1998,6.0,15,9,5,9,1,7,14,50.0,7,10,1,9,4,19,7,1,Matches
Craig Dawson,eng ENG,DF,West Ham,32,1990,8.0,11,7,9,2,0,5,7,71.4,2,9,6,3,6,17,26,0,Matches

Craig Dawson,eng ENG,DF,Wolves,32,1990,15.7,9,6,6,3,0,4,7,57.1,3,31,23,8,12,21,74,2,Matches
Kevin De Bruyne,be BEL,MF,Manchester City,31,1991,26.9,28,12,3,12,13,14,39,35.9,25,27,2,25,9,37,10,0,Matches
Siriki Dembélé,ci CIV,"FW,MF",Bournemouth,25,1996,1.2,3,1,2,1,0,0,1,0.0,1,1,0,1,1,4,1,0,Matches
Leander Dendoncker,be BEL,MF,Aston Villa,27,1995,7.7,19,9,11,6,2,11,22,50.0,11,19,4,15,10,29,12,0,Matches
Leander Dendoncker,be BEL,MF,Wolves,27,1995,2.4,4,2,0,3,1,2,3,66.7,1,2,0,2,9,13,4,0,Matches
Emmanuel Dennis,ng NGA,"FW,MF",Nott'ham Forest,24,1997,8.0,17,11,5,5,7,8,18,44.4,10,13,1,12,2,19,6,0,Matches
Halil Dervişoğlu,tr TUR,MF,Brentford,22,1999,0.1,0,0,0,0,0,0,1,0.0,1,0,0,0,0,0,0,0,Matches
Kiernan Dewsbury-Hall,eng ENG,MF,Leicester City,23,1998,25.6,53,29,14,34,5,19,47,40.4,28,55,13,42,28,81,21,0,Matches
Ibrahima Diallo,fr FRA,MF,Southampton,23,1999,9.1,25,15,14,10,1,8,14,57.1,6,11,1,10,6,31,11,0,Matches
Rúben Dias,pt POR,DF,Manchester City,25,1997,22.2,21,13,10,10,1,11,18,61.1,7,21,13,8,18,39,56,1,Matches
Luis Díaz,co COL,FW,Liverpool,25,1997,11.1,17,11,4,8,5,8,15,53.3,7,8,0,8,6,23,2,0,Matches
Eric Dier,eng ENG,DF,Tottenham,28,1994,31.3,30,19,16,12,2,9,19,47.4,10,41,24,17,35,65,112,2,Matches
Lucas Digne,fr FRA,DF,Aston Villa,29,1993,16.7,30,12,20,9,1,20,33,60.6,13,18,5,13,18,48,45,0,Matches
Issa Diop,fr FRA,DF,Fulham,25,1997,22.4,28,19,18,9,1,17,32,53.1,15,24,17,7,35,63,86,0,Matches
Moussa Djenepo,ml MLI,"DF,FW",Southampton,24,1998,7.9,19,11,13,5,1,11,27,40.7,16,19,2,17,11,30,7,0,Matches
Ben Doak,sct SCO,FW,Liverpool,16,2005,0.3,3,2,1,2,0,1,1,100.0,0,1,0,1,0,3,0,0,Matches
Matt Doherty,ie IRL,"DF,MF",Tottenham,30,1992,7.4,16,10,12,3,1,8,10,80.0,2,11,6,5,8,24,14,1,Matches
Abdoulaye Doucouré,ml MLI,MF,Everton,29,1993,17.0,31,20,9,15,7,12,37,32.4,25,26,3,23,13,44,11,0,Matches
Cheick Doucouré,ml MLI,MF,Crystal Palace,22,2000,30.8,77,46,40,33,4,29,52,55.8,23,47,13,34,56,133,48,0,Matches
Flynn Downes,eng ENG,MF,West Ham,23,1999,8.5,16,9,4,10,2,6,12,50.0,6,15,2,13,7,23,6,0,Matches
Kami Doyle,eng ENG,MF,Southampton,16,2005,0.1,0,0,0,0,0,0,0,,0,0,0,0,0,0,0,0,Matches
Cody Drameh,eng ENG,DF,Leeds United,20,2001,0.8,5,4,0,4,1,2,3,66.7,1,0,0,0,1,6,1,0,Matches
Martin Dúbravka,sk SVK,GK,Newcastle Utd,33,1989,1.7,0,0,0,0,0,0,1,0.0,1,0,0,0,0,0,1,0,Matches
Shane Duffy,ie IRL,"DF,FW",Fulham,30,1992,0.2,0,0,0,0,0,0,0,,0,0,0,0,0,0,0,1,Matches
Lewis Dunk,eng ENG,DF,Brighton,30,1991,36.0,30,19,19,9,2,18,41,43.9,23,37,27,10,34,64,81,1,Matches

Jhon Durán,co COL,"FW,MF",Aston Villa,18,2003,1.5,2,2,0,1,1,1,4,25.0,3,0,0,0,2,4,2,0,Matches
Malcolm Ebiowei,eng ENG,"MF,FW",Crystal Palace,18,2003,0.4,1,1,1,0,0,0,1,0.0,1,2,0,2,0,1,0,0,Matches
Ederson,br BRA,GK,Manchester City,28,1993,35.0,3,1,3,0,0,1,2,50.0,1,0,0,0,1,4,10,2,Matches
Odsonne Édouard,fr FRA,FW,Crystal Palace,24,1998,20.0,25,13,7,12,6,7,13,53.8,6,17,5,12,3,28,22,0,Matches
Samuel Edozie,eng ENG,"FW,MF",Southampton,19,2003,6.3,17,10,6,10,1,3,8,37.5,5,7,0,7,6,23,6,0,Matches
Anthony Elanga,se SWE,FW,Manchester Utd,20,2002,4.7,3,0,0,2,1,1,2,50.0,1,4,0,4,2,5,4,0,Matches
Harvey Elliott,eng ENG,"MF,FW",Liverpool,19,2003,17.9,27,18,6,12,9,9,37,24.3,28,26,1,25,15,42,8,0,Matches
Mohamed Elneny,eg EGY,MF,Arsenal,30,1992,1.3,1,1,1,0,0,1,1,100.0,0,0,0,0,0,1,0,0,Matches
Mohamed Elyounoussi,no NOR,"MF,FW",Southampton,27,1994,24.1,46,28,22,20,4,19,44,43.2,25,40,3,37,27,73,37,0,Matches
Emerson,br BRA,DF,Tottenham,23,1999,19.3,54,33,38,12,4,27,40,67.5,13,17,3,14,18,72,75,0,Matches
Julio Enciso,py PAR,"FW,MF",Brighton,18,2004,9.0,13,4,3,6,4,8,13,61.5,5,9,0,9,4,17,2,0,Matches
Christian Eriksen,dk DEN,MF,Manchester Utd,30,1992,22.8,22,18,10,7,5,10,33,30.3,23,23,9,14,11,33,20,1,Matches
Pervis Estupiñán,ec ECU,DF,Brighton,24,1998,29.7,61,31,36,19,6,35,60,58.3,25,30,8,22,37,98,37,1,Matches
Jonny Evans,nir NIR,DF,Leicester City,34,1988,11.7,13,5,12,1,0,7,11,63.6,4,15,11,4,18,31,51,0,Matches
Eberechi Eze,eng ENG,"MF,FW",Crystal Palace,24,1998,29.3,42,24,17,18,7,18,38,47.4,20,22,0,22,13,55,10,0,Matches
Łukasz Fabiański,pl POL,GK,West Ham,37,1985,34.6,2,0,2,0,0,1,2,50.0,1,1,0,1,0,2,10,1,Matches
Fabinho,br BRA,MF,Liverpool,28,1993,29.7,65,38,18,40,7,24,62,38.7,38,38,11,27,37,102,40,0,Matches
Wout Faes,be BEL,DF,Leicester City,24,1998,31.0,56,33,28,26,2,28,44,63.6,16,53,37,16,41,97,113,2,Matches
Felipe,br BRA,DF,Nott'ham Forest,33,1989,15.8,42,23,29,13,0,24,41,58.5,17,34,13,21,36,78,90,0,Matches
João Félix,pt POR,"FW,MF",Chelsea,22,1999,10.5,14,7,5,6,3,4,12,33.3,8,3,0,3,1,15,1,1,Matches
Evan Ferguson,ie IRL,FW,Brighton,17,2004,10.6,6,3,1,3,2,1,7,14.3,6,11,1,10,2,8,6,0,Matches
Bruno Fernandes,pt POR,"MF,FW",Manchester Utd,27,1994,36.8,68,42,24,25,19,30,71,42.3,41,37,5,32,25,93,40,1,Matches
Enzo Fernández,ar ARG,MF,Chelsea,21,2001,17.2,45,27,25,17,3,21,56,37.5,35,32,2,30,16,61,12,1,Matches
Roberto Firmino,br BRA,"FW,MF",Liverpool,30,1991,13.5,17,12,2,12,3,4,22,18.2,18,16,1,15,7,24,2,0,Matches
Junior Firpo,do DOM,DF,Leeds United,25,1996,15.2,47,25,27,15,5,24,46,52.2,22,23,7,16,24,71,40,0,Matches

Phil Foden,eng ENG,FW,Manchester City,22,2000,20.5,16,10,9,5,2,8,19,42.1,11,25,2,23,5,21,12,0,Matches
Wesley Fofana,fr FRA,DF,Leicester City,21,2000,2.0,4,2,1,2,1,1,3,33.3,2,1,1,0,9,13,5,0,Matches
Wesley Fofana,fr FRA,DF,Chelsea,21,2000,13.1,30,18,19,7,4,13,26,50.0,13,17,10,7,20,50,33,2,Matches
Pablo Fornals,es ESP,"FW,MF",West Ham,26,1996,16.7,30,15,9,12,9,13,34,38.2,21,16,2,14,14,44,9,0,Matches
Adam Forshaw,eng ENG,MF,Leeds United,30,1991,5.3,12,9,5,7,0,7,17,41.2,10,9,1,8,4,16,2,0,Matches
Fraser Forster,eng ENG,GK,Tottenham,34,1988,13.5,1,0,1,0,0,0,0,,0,1,0,1,0,1,3,1,Matches
Tyrese Francois,au AUS,FW,Fulham,22,2000,0.0,0,0,0,0,0,0,1,0.0,1,0,0,0,0,0,1,0,Matches
Ryan Fraser,sct SCO,FW,Newcastle Utd,28,1994,3.5,2,2,0,0,2,2,5,40.0,3,3,1,2,0,2,3,0,Matches
Fred,br BRA,MF,Manchester Utd,29,1993,13.9,47,30,24,20,3,15,38,39.5,23,38,2,36,19,66,19,0,Matches
Ryan Fredericks,eng ENG,DF,Bournemouth,29,1992,5.9,3,2,2,0,1,1,4,25.0,3,7,2,5,1,4,27,0,Matches
Remo Freuler,ch SUI,MF,Nott'ham Forest,30,1992,24.0,43,23,23,15,5,19,43,44.2,24,36,9,27,29,72,45,0,Matches
Cody Gakpo,nl NED,"FW,MF",Liverpool,23,1999,16.2,26,15,4,13,9,13,38,34.2,25,13,1,12,4,30,2,0,Matches
Conor Gallagher,eng ENG,MF,Chelsea,22,2000,18.0,46,33,17,19,10,10,37,27.0,27,41,10,31,23,69,18,1,Matches
Idrissa Gana Gueye,sn SEN,MF,Everton,32,1989,28.6,97,57,49,35,13,31,62,50.0,31,50,12,38,56,153,34,3,Matches
Alejandro Garnacho,ar ARG,"FW,MF",Manchester Utd,18,2004,6.3,5,2,2,0,3,1,11,9.1,10,5,0,5,5,10,3,0,Matches
James Garner,eng ENG,"MF,DF",Everton,21,2001,8.9,16,13,4,8,4,9,19,47.4,10,9,1,8,12,28,13,0,Matches
David de Gea,es ESP,GK,Manchester Utd,31,1990,38.0,0,0,0,0,0,0,1,0.0,1,0,0,0,1,1,15,3,Matches
Joe Gelhardt,eng ENG,FW,Leeds United,20,2002,2.4,6,2,1,3,2,3,5,60.0,2,5,0,5,0,6,4,0,Matches
Saman Ghoddos,ir IRN,"MF,FW",Brentford,28,1993,1.5,2,1,0,1,1,1,3,33.3,2,5,1,4,4,6,2,0,Matches
Morgan Gibbs-White,eng ENG,"FW,MF",Wolves,22,2000,2.0,3,1,3,0,0,2,4,50.0,2,2,0,2,1,4,3,0,Matches
Morgan Gibbs-White,eng ENG,"MF,FW",Nott'ham Forest,22,2000,33.0,26,14,7,7,12,11,33,33.3,22,23,4,19,14,40,15,0,Matches
Bryan Gil,es ESP,"MF,FW",Tottenham,21,2001,1.6,3,1,3,0,0,0,3,0.0,3,3,0,3,1,4,1,0,Matches
Billy Gilmour,sct SCO,MF,Brighton,21,2001,5.6,5,2,2,2,1,2,8,25.0,6,5,2,3,6,11,5,0,Matches
Wilfried Gnonto,it ITA,"FW,MF",Leeds United,18,2003,15.0,27,17,7,15,5,10,30,33.3,20,24,1,23,5,32,7,0,Matches
Ben Godfrey,eng ENG,DF,Everton,24,1998,8.9,20,11,13,5,2,11,29,37.9,18,12,6,6,8,28,33,1,Matches

João Gomes,br BRA,MF,Wolves,21,2001,7.3,29,13,14,14,1,13,23,56.5,10,12,3,9,4,33,11,0,Matches
Toti Gomes,pt POR,DF,Wolves,23,1999,10.9,15,9,11,4,0,9,13,69.2,4,16,8,8,11,26,51,0,Matches
Joe Gomez,eng ENG,DF,Liverpool,25,1997,16.3,28,21,15,11,2,11,19,57.9,8,17,11,6,24,52,51,2,Matches
Sergio Gómez,es ESP,"DF,MF",Manchester City,21,2000,3.9,9,4,6,1,2,5,8,62.5,3,5,3,2,2,11,9,1,Matches
Anthony Gordon,eng ENG,"FW,MF",Newcastle Utd,21,2001,5.4,14,12,5,7,2,9,20,45.0,11,9,1,8,2,16,1,1,Matches
Anthony Gordon,eng ENG,FW,Everton,21,2001,12.2,34,22,17,10,7,8,24,33.3,16,19,0,19,4,38,11,0,Matches
Demarai Gray,jm JAM,"FW,MF",Everton,26,1996,27.9,33,24,9,14,10,17,31,54.8,14,23,3,20,13,46,18,0,Matches
Jack Grealish,eng ENG,FW,Manchester City,26,1995,22.8,25,16,10,12,3,13,23,56.5,10,17,3,14,7,32,9,0,Matches
Sam Greenwood,eng ENG,"MF,FW",Leeds United,20,2002,4.7,15,7,7,8,0,8,21,38.1,13,10,2,8,1,16,1,0,Matches
Pascal Groß,de GER,"MF,DF",Brighton,31,1991,36.0,59,38,23,27,9,25,55,45.5,30,32,10,22,13,72,21,1,Matches
Vicente Guaita,es ESP,GK,Crystal Palace,35,1987,27.0,0,0,0,0,0,0,0,,0,0,0,0,0,0,9,1,Matches
Gonçalo Guedes,pt POR,"FW,MF",Wolves,25,1996,7.9,8,6,4,3,1,5,8,62.5,3,4,0,4,1,9,2,0,Matches
Marc Guéhi,eng ENG,DF,Crystal Palace,22,2000,37.0,52,27,39,11,2,26,42,61.9,16,45,24,21,45,97,134,3,Matches
Bruno Guimarães,br BRA,MF,Newcastle Utd,24,1997,30.3,78,40,27,46,5,38,65,58.5,27,28,4,24,36,114,22,1,Matches
İlkay Gündoğan,de GER,MF,Manchester City,31,1990,26.1,30,18,7,13,10,12,34,35.3,22,18,3,15,20,50,13,0,Matches
Darko Gyabi,eng ENG,FW,Leeds United,18,2004,0.1,2,2,1,1,0,0,0,,0,2,0,2,0,2,0,0,Matches
Erling Haaland,no NOR,FW,Manchester City,22,2000,30.8,3,2,0,2,1,1,5,20.0,4,12,4,8,3,6,14,0,Matches
Lewis Hall,eng ENG,DF,Chelsea,17,2004,7.3,23,12,19,4,0,15,22,68.2,7,8,0,8,11,34,11,1,Matches
Luke Harris,wls WAL,"MF,FW",Fulham,17,2005,0.1,0,0,0,0,0,0,0,,0,0,0,0,0,0,0,0,Matches
Jack Harrison,eng ENG,"FW,MF",Leeds United,25,1996,30.1,41,17,5,15,21,12,52,23.1,40,47,2,45,22,63,25,0,Matches
Kai Havertz,de GER,"FW,MF",Chelsea,23,1999,28.5,34,16,4,20,10,10,30,33.3,20,28,0,28,7,41,41,0,Matches
Jan Paul van Hecke,nl NED,DF,Brighton,22,2000,3.3,8,6,3,4,1,5,5,100.0,0,8,5,3,6,14,9,0,Matches
Hwang Hee-chan,kr KOR,"FW,MF",Wolves,26,1996,12.6,20,9,7,8,5,6,20,30.0,14,18,2,16,5,25,5,0,Matches
Dean Henderson,eng ENG,GK,Nott'ham Forest,25,1997,18.0,0,0,0,0,0,0,0,,0,0,0,0,0,0,12,1,Matches
Jordan Henderson,eng ENG,MF,Liverpool,32,1990,23.0,32,23,10,18,4,15,36,41.7,21,21,3,18,21,53,16,1,Matches

Wayne Hennessey,wls WAL,GK,Nott'ham Forest,35,1987,3.0,1,0,1,0,0,1,1,100.0,0,0,0,0,0,1,2,0,Matches
Rico Henry,eng ENG,DF,Brentford,25,1997,36.0,57,31,20,28,9,22,41,53.7,19,29,8,21,30,87,84,1,Matches
Son Heung-min,kr KOR,"MF,FW",Tottenham,30,1992,32.1,24,12,7,8,9,9,30,30.0,21,23,2,21,13,37,6,0,Matches
Aaron Hickey,sct SCO,DF,Brentford,20,2002,21.3,38,26,27,11,0,18,32,56.3,14,18,7,11,17,55,32,1,Matches
Jack Hinshelwood,eng ENG,FW,Brighton,17,2005,0.0,1,0,1,0,0,0,0,,0,0,0,0,0,1,0,0,Matches
Joseph Hodge,ie IRL,MF,Wolves,19,2002,1.9,5,2,1,3,1,3,4,75.0,1,5,0,5,0,5,2,1,Matches
Rob Holding,eng ENG,DF,Arsenal,26,1995,6.3,8,5,4,4,0,3,6,50.0,3,6,5,1,3,11,27,1,Matches
Mason Holgate,eng ENG,DF,Everton,25,1996,5.6,11,7,8,3,0,3,11,27.3,8,7,3,4,7,18,28,0,Matches
Will Hughes,eng ENG,MF,Crystal Palace,27,1995,9.4,29,16,11,16,2,11,20,55.0,9,16,7,9,16,45,9,0,Matches
Omari Hutchinson,eng ENG,FW,Chelsea,18,2003,0.3,0,0,0,0,0,0,0,,0,0,0,0,1,1,0,0,Matches
Pierre Højbjerg,dk DEN,MF,Tottenham,26,1995,34.8,56,30,28,22,6,26,67,38.8,41,46,17,29,49,105,64,1,Matches
Kelechi Iheanacho,ng NGA,"FW,MF",Leicester City,25,1996,12.5,7,2,0,3,4,3,10,30.0,7,9,1,8,0,7,8,0,Matches
Danny Ings,eng ENG,FW,West Ham,30,1992,8.6,9,8,0,4,5,5,14,35.7,9,8,2,6,3,12,5,0,Matches
Danny Ings,eng ENG,FW,Aston Villa,30,1992,9.2,10,5,1,6,3,1,6,16.7,5,12,1,11,1,11,11,0,Matches
Alexander Isak,se SWE,FW,Newcastle Utd,22,1999,16.9,18,8,4,7,7,10,28,35.7,18,21,2,19,4,22,8,0,Matches
Daniel Iversen,dk DEN,GK,Leicester City,25,1997,12.0,0,0,0,0,0,0,0,,0,0,0,0,0,0,6,1,Matches
Alex Iwobi,ng NGA,"MF,FW",Everton,26,1996,37.5,69,37,37,28,4,33,65,50.8,32,41,2,39,25,94,29,0,Matches
Daniel James,wls WAL,FW,Leeds United,24,1997,2.2,6,2,1,3,2,3,6,50.0,3,4,0,4,2,8,2,0,Matches
Daniel James,wls WAL,FW,Fulham,24,1997,6.9,10,6,4,5,1,4,9,44.4,5,5,1,4,1,11,5,0,Matches
Reece James,eng ENG,"DF,MF",Chelsea,22,1999,13.8,31,20,10,18,3,15,19,78.9,4,17,2,15,12,43,23,0,Matches
Vitaly Janelt,de GER,"MF,DF",Brentford,24,1998,24.5,54,27,20,24,10,21,49,42.9,28,29,9,20,29,83,26,0,Matches
Pontus Jansson,se SWE,DF,Brentford,31,1991,8.0,5,3,4,1,0,3,5,60.0,2,13,9,4,9,14,38,0,Matches
Mathias Jensen,dk DEN,MF,Brentford,26,1996,31.1,71,36,29,30,12,34,97,35.1,63,54,5,49,32,103,24,1,Matches
Gabriel Jesus,br BRA,FW,Arsenal,25,1997,22.9,33,25,16,8,9,15,31,48.4,16,27,3,24,11,44,15,1,Matches
Raúl Jiménez,mx MEX,FW,Wolves,31,1991,9.4,9,6,3,5,1,3,6,50.0,3,9,0,9,0,9,8,0,Matches

Joelinton,br BRA,"MF,FW",Newcastle Utd,25,1996,29.6,70,49,36,26,8,26,62,41.9,36,52,7,45,48,118,39,0,Matches
Ben Johnson,eng ENG,DF,West Ham,22,2000,9.6,20,14,12,4,4,12,18,66.7,6,12,4,8,9,29,28,1,Matches
Brennan Johnson,wls WAL,"FW,MF",Nott'ham Forest,21,2001,32.6,34,20,18,8,8,8,29,27.6,21,30,1,29,5,39,7,1,Matches
Sam Johnstone,eng ENG,GK,Crystal Palace,29,1993,9.0,0,0,0,0,0,0,0,,0,0,0,0,0,0,5,0,Matches
Curtis Jones,eng ENG,MF,Liverpool,21,2001,11.5,34,17,8,12,14,18,31,58.1,13,12,2,10,3,37,9,0,Matches
Jorginho,it ITA,MF,Arsenal,30,1991,9.5,18,13,6,10,2,5,24,20.8,19,7,2,5,9,27,8,0,Matches
Jorginho,it ITA,MF,Chelsea,30,1991,14.2,42,23,22,14,6,22,46,47.8,24,18,3,15,21,63,7,0,Matches
Mateo Joseph,es ESP,"FW,MF",Leeds United,18,2003,0.3,0,0,0,0,0,0,0,,0,1,0,1,0,0,1,0,Matches
Diogo Jota,pt POR,FW,Liverpool,25,1996,12.6,23,15,8,8,7,12,37,32.4,25,5,0,5,3,26,11,0,Matches
Hamed Junior Traorè,ci CIV,"FW,MF",Bournemouth,22,2000,4.7,17,11,5,9,3,6,18,33.3,12,9,0,9,2,19,1,0,Matches
James Justin,eng ENG,DF,Leicester City,24,1998,13.9,20,18,7,12,1,9,18,50.0,9,24,6,18,15,35,47,0,Matches
Mathias Jørgensen,dk DEN,DF,Brentford,32,1990,12.3,17,8,9,8,0,9,21,42.9,12,19,12,7,16,33,39,1,Matches
Sasa Kalajdzic,at AUT,FW,Wolves,25,1997,0.5,0,0,0,0,0,0,0,,0,0,0,0,1,1,0,0,Matches
Boubacar Kamara,fr FRA,MF,Aston Villa,22,1999,19.7,58,25,25,23,10,27,56,48.2,29,38,12,26,19,77,24,3,Matches
Harry Kane,eng ENG,FW,Tottenham,29,1993,37.8,15,12,1,6,8,7,21,33.3,14,27,7,20,2,17,18,0,Matches
N'Golo Kanté,fr FRA,MF,Chelsea,31,1991,5.8,16,10,4,10,2,4,8,50.0,4,11,0,11,6,22,2,0,Matches
Michael Keane,eng ENG,DF,Everton,29,1993,10.9,7,4,5,2,0,5,8,62.5,3,12,7,5,14,21,55,1,Matches
Neeskens Kebano,cd COD,FW,Fulham,30,1992,8.5,17,9,8,6,3,9,18,50.0,9,14,0,14,1,18,8,0,Matches
Thilo Kehrer,de GER,DF,West Ham,25,1996,24.8,43,24,25,14,4,21,45,46.7,24,16,6,10,34,77,76,1,Matches
Naby Keïta,gn GUI,MF,Liverpool,27,1995,3.3,5,4,2,3,0,1,4,25.0,3,1,0,1,2,7,3,0,Matches
Caoimhín Kelleher,ie IRL,GK,Liverpool,23,1998,1.0,0,0,0,0,0,0,0,,0,0,0,0,0,0,0,0,Matches
Lloyd Kelly,eng ENG,DF,Bournemouth,23,1998,22.7,33,18,23,9,1,13,19,68.4,6,26,15,11,26,59,101,1,Matches
Max Kilman,eng ENG,DF,Wolves,25,1997,36.7,36,20,26,9,1,16,30,53.3,14,70,42,28,19,55,164,1,Matches
Jakub Kiwior,pl POL,DF,Arsenal,22,2000,4.7,7,5,6,1,0,5,8,62.5,3,5,3,2,6,13,10,0,Matches
Mateusz Klich,pl POL,"MF,FW",Leeds United,32,1990,3.1,12,8,3,4,5,7,13,53.8,6,4,0,4,0,12,1,0,Matches

Robin Koch,de GER,DF,Leeds United,26,1996,35.3,53,30,32,16,5,24,56,42.9,32,44,21,23,43,96,152,1,Matches
Ibrahima Konaté,fr FRA,DF,Liverpool,23,1999,17.2,38,26,25,13,0,16,27,59.3,11,12,5,7,26,64,61,4,Matches
Ezri Konsa,eng ENG,DF,Aston Villa,24,1997,36.9,42,20,25,15,2,18,26,69.2,8,41,23,18,26,68,120,3,Matches
Kalidou Koulibaly,sn SEN,DF,Chelsea,31,1991,20.0,45,31,34,8,3,26,40,65.0,14,30,13,17,29,74,77,0,Matches
Cheikhou Kouyaté,sn SEN,MF,Nott'ham Forest,32,1989,9.8,29,21,18,8,3,9,13,69.2,4,14,2,12,10,39,24,0,Matches
Mateo Kovačić,hr CRO,MF,Chelsea,28,1994,19.0,36,24,16,14,6,14,36,38.9,22,10,1,9,19,55,16,0,Matches
Emil Krafth,se SWE,DF,Newcastle Utd,27,1994,0.0,0,0,0,0,0,0,0,,0,0,0,0,0,0,0,0,Matches
Rasmus Kristensen,dk DEN,DF,Leeds United,25,1997,21.8,62,35,35,21,6,42,76,55.3,34,32,14,18,35,97,61,0,Matches
Dejan Kulusevski,se SWE,"MF,FW",Tottenham,22,2000,23.0,38,15,23,7,8,16,44,36.4,28,19,0,19,13,51,7,0,Matches
Layvin Kurzawa,fr FRA,DF,Fulham,29,1992,1.5,3,2,1,1,1,3,3,100.0,0,1,1,0,2,5,4,0,Matches
Adam Lallana,eng ENG,"MF,FW",Brighton,34,1988,8.0,9,4,6,2,1,0,7,0.0,7,6,0,6,2,11,1,0,Matches
Tariq Lamptey,gh GHA,DF,Brighton,21,2000,5.0,11,6,6,4,1,5,7,71.4,2,7,3,4,7,18,2,0,Matches
Manuel Lanzini,ar ARG,"MF,FW",West Ham,29,1993,2.8,2,2,1,1,0,2,6,33.3,4,2,0,2,2,4,0,0,Matches
Aymeric Laporte,es ESP,DF,Manchester City,28,1994,11.0,11,8,6,4,1,7,11,63.6,4,10,4,6,3,14,30,1,Matches
Juan Larios,es ESP,DF,Southampton,18,2004,1.7,7,6,6,1,0,5,5,100.0,0,2,0,2,3,10,4,0,Matches
Jamaal Lascelles,eng ENG,DF,Newcastle Utd,28,1993,2.4,1,0,1,0,0,1,1,100.0,0,3,2,1,0,1,17,0,Matches
Roméo Lavia,be BEL,MF,Southampton,18,2004,24.7,60,35,27,29,4,21,53,39.6,32,47,11,36,33,93,23,1,Matches
Dexter Lembikisa,jm JAM,DF,Wolves,18,2003,0.3,0,0,0,0,0,0,0,,0,0,0,0,0,0,0,0,Matches
Mario Lemina,ga GAB,MF,Wolves,28,1993,14.4,38,24,22,13,3,20,38,52.6,18,26,8,18,14,52,24,1,Matches
Clément Lenglet,fr FRA,DF,Tottenham,27,1995,22.4,38,23,18,15,5,16,34,47.1,18,26,11,15,18,56,68,2,Matches
Bernd Leno,de GER,GK,Fulham,30,1992,36.0,0,0,0,0,0,0,3,0.0,3,0,0,0,0,0,18,1,Matches
Jefferson Lerma,co COL,MF,Bournemouth,27,1994,36.1,50,30,23,23,4,20,45,44.4,25,32,15,17,47,97,91,2,Matches
Jamal Lewis,nir NIR,"DF,FW",Newcastle Utd,24,1998,0.1,0,0,0,0,0,0,0,,0,0,0,0,0,0,0,0,Matches
Rico Lewis,eng ENG,"DF,MF",Manchester City,17,2004,10.0,16,9,9,5,2,6,11,54.5,5,8,4,4,6,22,13,1,Matches
Keane Lewis-Potter,eng ENG,"FW,MF",Brentford,21,2001,3.6,1,0,0,1,0,0,0,,0,5,1,4,0,1,2,0,Matches

Victor Lindelöf,se SWE,DF,Manchester Utd,28,1994,15.2,22,17,10,9,3,9,17,52.9,8,18,9,9,21,43,63,1,Matches
Jesse Lingard,eng ENG,"FW,MF",Nott'ham Forest,29,1992,10.3,4,4,2,2,0,1,7,14.3,6,11,0,11,5,9,4,0,Matches
Valentino Livramento,eng ENG,"DF,FW",Southampton,19,2002,0.3,2,1,2,0,0,0,0,,0,0,0,0,2,4,3,0,Matches
Diego Llorente,es ESP,DF,Leeds United,28,1993,7.2,13,10,8,5,0,4,8,50.0,4,6,2,4,15,28,24,2,Matches
Hugo Lloris,fr FRA,GK,Tottenham,35,1986,24.5,1,1,1,0,0,1,3,33.3,2,0,0,0,1,2,13,5,Matches
Renan Lodi,br BRA,DF,Nott'ham Forest,24,1998,24.6,52,39,38,8,6,33,66,50.0,33,25,6,19,33,85,74,0,Matches
Ruben Loftus-Cheek,eng ENG,"MF,DF",Chelsea,26,1996,17.1,25,14,8,14,3,12,22,54.5,10,15,2,13,12,37,23,0,Matches
Sean Longstaff,eng ENG,MF,Newcastle Utd,24,1997,28.0,42,21,16,20,6,20,52,38.5,32,35,8,27,16,58,23,0,Matches
Jamal Lowe,jm JAM,"MF,FW",Bournemouth,28,1994,0.1,0,0,0,0,0,0,0,,0,0,0,0,0,0,0,0,Matches
Douglas Luiz,br BRA,MF,Aston Villa,24,1998,32.5,72,42,31,32,9,29,63,46.0,34,36,7,29,40,112,27,2,Matches
Saša Lukić,rs SRB,MF,Fulham,25,1996,4.6,8,3,1,4,3,3,7,42.9,4,6,2,4,5,13,3,0,Matches
Lyanco,br BRA,DF,Southampton,25,1997,13.1,24,16,15,9,0,12,18,66.7,6,30,25,5,20,44,65,2,Matches
Alexis Mac Allister,ar ARG,MF,Brighton,23,1998,32.1,70,39,22,40,8,34,71,47.9,37,26,2,24,22,92,10,1,Matches
James Maddison,eng ENG,"MF,FW",Leicester City,25,1996,27.6,51,26,25,19,7,19,50,38.0,31,19,1,18,13,64,6,1,Matches
Noni Madueke,eng ENG,FW,Chelsea,20,2002,7.1,12,8,5,4,3,6,13,46.2,7,13,2,11,4,16,7,0,Matches
Gabriel Magalhães,br BRA,DF,Arsenal,24,1997,37.9,48,30,29,15,4,18,27,66.7,9,49,26,23,32,80,125,3,Matches
Harry Maguire,eng ENG,DF,Manchester Utd,29,1993,8.5,8,6,6,1,1,4,5,80.0,1,18,11,7,13,21,41,0,Matches
Riyad Mahrez,dz ALG,"FW,MF",Manchester City,31,1991,21.3,30,14,8,13,9,13,39,33.3,26,27,1,26,9,39,5,0,Matches
Kobbie Mainoo,eng ENG,MF,Manchester Utd,17,2005,0.1,0,0,0,0,0,0,0,,0,1,1,0,0,0,0,0,Matches
Ainsley Maitland-Niles,eng ENG,"DF,MF",Southampton,24,1997,15.6,45,24,23,18,4,28,44,63.6,16,28,7,21,22,67,45,1,Matches
Tyrell Malacia,nl NED,DF,Manchester Utd,22,1999,15.5,46,33,33,12,1,14,25,56.0,11,13,3,10,25,71,49,0,Matches
Orel Mangala,be BEL,MF,Nott'ham Forest,24,1998,17.2,28,20,16,10,2,12,29,41.4,17,21,7,14,23,51,15,0,Matches
Javier Manquillo,es ESP,DF,Newcastle Utd,28,1994,0.4,3,2,2,1,0,2,2,100.0,0,1,0,1,1,4,1,0,Matches
Sekou Mara,fr FRA,"FW,MF",Southampton,20,2002,6.2,14,10,5,8,1,3,9,33.3,6,11,0,11,1,15,5,0,Matches
Solly March,eng ENG,"FW,DF",Brighton,28,1994,30.2,53,31,16,17,20,8,28,28.6,20,34,3,31,24,77,32,0,Matches

Emiliano Marcondes,dk DEN,MF,Bournemouth,27,1995,0.1,0,0,0,0,0,0,0,,0,0,0,0,0,0,1,0,Matches
Marquinhos,br BRA,MF,Arsenal,19,2003,0.0,0,0,0,0,0,0,0,,0,0,0,0,0,0,0,0,Matches
Anthony Martial,fr FRA,FW,Manchester Utd,26,1995,10.9,5,3,0,2,3,1,4,25.0,3,11,2,9,1,6,4,0,Matches
Gabriel Martinelli,br BRA,FW,Arsenal,21,2001,31.0,31,18,13,12,6,9,22,40.9,13,24,1,23,9,40,14,0,Matches
Emiliano Martínez,ar ARG,GK,Aston Villa,29,1992,34.9,0,0,0,0,0,0,2,0.0,2,0,0,0,1,1,23,1,Matches
Lisandro Martínez,ar ARG,DF,Manchester Utd,24,1998,23.5,54,28,33,18,3,30,43,69.8,13,51,27,24,33,87,103,0,Matches
Pape Matar Sarr,sn SEN,"MF,FW",Tottenham,19,2002,2.4,7,6,4,2,1,4,8,50.0,4,3,2,1,6,13,6,0,Matches
Jean-Philippe Mateta,fr FRA,FW,Crystal Palace,25,1997,8.6,7,1,2,4,1,1,3,33.3,2,3,1,2,3,10,18,0,Matches
Joël Matip,cm CMR,DF,Liverpool,30,1991,12.1,14,8,12,2,0,11,23,47.8,12,8,3,5,21,35,45,3,Matches
Neal Maupay,fr FRA,FW,Everton,25,1996,12.4,11,5,3,4,4,2,4,50.0,2,8,0,8,5,16,0,0,Matches
Kevin Mbabu,ch SUI,"DF,FW",Fulham,27,1995,1.6,3,2,2,1,0,1,3,33.3,2,2,0,2,3,6,3,0,Matches
Bryan Mbeumo,cm CMR,FW,Brentford,22,1999,32.3,26,18,5,13,8,8,42,19.0,34,24,1,23,13,39,21,0,Matches
James McArthur,sct SCO,MF,Crystal Palace,34,1987,0.6,1,1,1,0,0,1,1,100.0,0,2,1,1,1,2,2,0,Matches
Alex McCarthy,eng ENG,GK,Southampton,32,1989,6.0,0,0,0,0,0,0,1,0.0,1,0,0,0,1,1,3,1,Matches
John McGinn,sct SCO,"MF,FW",Aston Villa,27,1994,29.9,66,36,27,29,10,34,71,47.9,37,43,4,39,24,90,19,0,Matches
Scott McKenna,sct SCO,DF,Nott'ham Forest,25,1996,17.5,12,7,7,3,2,6,10,60.0,4,20,14,6,12,24,85,1,Matches
Weston McKennie,us USA,MF,Leeds United,23,1998,16.0,30,13,5,18,7,10,29,34.5,19,22,3,19,22,52,26,0,Matches
Dwight McNeil,eng ENG,"FW,MF",Everton,22,1999,27.8,64,41,35,14,15,27,65,41.5,38,46,7,39,31,95,41,0,Matches
Scott McTominay,sct SCO,MF,Manchester Utd,25,1996,12.9,32,19,16,10,6,13,22,59.1,9,15,6,9,14,46,45,1,Matches
Ben Mee,eng ENG,DF,Brentford,32,1989,36.3,45,24,28,13,4,20,37,54.1,17,54,42,12,48,93,122,2,Matches
Edouard Mendy,sn SEN,GK,Chelsea,30,1992,9.5,0,0,0,0,0,0,0,,0,0,0,0,0,0,3,3,Matches
Nampalys Mendy,sn SEN,MF,Leicester City,30,1992,8.4,13,9,7,6,0,8,15,53.3,7,20,4,16,13,26,2,0,Matches
Chris Mepham,wls WAL,DF,Bournemouth,24,1997,24.4,45,22,37,8,0,19,30,63.3,11,40,27,13,30,75,152,0,Matches
Illan Meslier,fr FRA,GK,Leeds United,22,2000,34.0,2,1,2,0,0,2,4,50.0,2,0,0,0,1,3,30,3,Matches
Alex Mighten,eng ENG,FW,Nott'ham Forest,20,2002,0.1,0,0,0,0,0,0,1,0.0,1,0,0,0,0,0,0,0,Matches

Lewis Miley,eng ENG,MF,Newcastle Utd,16,2006,0.2,0,0,0,0,0,0,0,,0,1,0,1,0,0,0,0,Matches
Luka Milivojević,rs SRB,MF,Crystal Palace,31,1991,5.7,13,7,7,4,2,7,10,70.0,3,13,4,9,12,25,10,1,Matches
James Milner,eng ENG,"MF,DF",Liverpool,36,1986,10.1,26,16,11,11,4,15,34,44.1,19,14,2,12,12,38,15,0,Matches
Yerry Mina,co COL,DF,Everton,27,1994,6.6,15,8,9,6,0,9,11,81.8,2,7,4,3,6,21,28,0,Matches
Tyrone Mings,eng ENG,DF,Aston Villa,29,1993,35.0,15,7,10,5,0,9,20,45.0,11,40,21,19,54,69,163,2,Matches
Tyrick Mitchell,eng ENG,DF,Crystal Palace,22,1999,32.1,71,49,43,23,5,30,53,56.6,23,48,11,37,42,113,78,0,Matches
Kaoru Mitoma,jp JPN,"FW,MF",Brighton,25,1997,25.8,44,27,15,16,13,20,41,48.8,21,25,0,25,17,61,10,0,Matches
Aleksandar Mitrović,rs SRB,FW,Fulham,27,1994,22.3,14,7,8,4,2,5,12,41.7,7,22,5,17,3,17,20,1,Matches
Kieffer Moore,wls WAL,FW,Bournemouth,29,1992,14.2,14,11,2,9,3,5,16,31.3,11,12,5,7,1,15,26,0,Matches
Andrew Moran,ie IRL,FW,Brighton,18,2003,0.1,0,0,0,0,0,0,0,,0,1,0,1,0,0,0,0,Matches
Álex Moreno,es ESP,DF,Aston Villa,29,1993,14.8,23,14,15,5,3,13,36,36.1,23,18,3,15,7,30,37,2,Matches
Mason Mount,eng ENG,"MF,FW",Chelsea,23,1999,18.3,33,19,6,16,11,14,27,51.9,13,24,6,18,8,41,9,0,Matches
Lucas Moura,br BRA,"MF,DF",Tottenham,29,1992,1.7,8,5,1,3,4,1,4,25.0,3,0,0,0,2,10,1,1,Matches
João Moutinho,pt POR,MF,Wolves,35,1986,19.8,51,30,24,21,6,19,46,41.3,27,22,6,16,18,69,20,0,Matches
Divin Mubama,eng ENG,FW,West Ham,17,2004,0.4,1,1,1,0,0,0,0,,0,0,0,0,0,1,0,0,Matches
Mykhailo Mudryk,ua UKR,"FW,MF",Chelsea,21,2001,7.3,11,9,2,4,5,4,13,30.8,9,7,1,6,0,11,3,0,Matches
Jacob Murphy,eng ENG,FW,Newcastle Utd,27,1995,13.9,15,7,3,8,4,8,20,40.0,12,17,0,17,7,22,3,0,Matches
Enock Mwepu,zm ZAM,"FW,MF",Brighton,24,1998,2.4,10,5,1,6,3,3,4,75.0,1,3,1,2,1,11,1,0,Matches
Vitaliy Mykolenko,ua UKR,DF,Everton,23,1999,29.5,58,34,36,19,3,28,51,54.9,23,50,16,34,46,104,99,0,Matches
Keylor Navas,cr CRC,GK,Nott'ham Forest,35,1986,17.0,0,0,0,0,0,0,0,,0,0,0,0,1,1,11,2,Matches
Wilfred Ndidi,ng NGA,MF,Leicester City,25,1996,18.7,61,42,34,24,3,17,43,39.5,26,32,14,18,38,99,48,3,Matches
Reiss Nelson,eng ENG,FW,Arsenal,22,1999,2.4,4,1,2,1,1,2,4,50.0,2,3,0,3,0,4,4,0,Matches
Neto,br BRA,GK,Bournemouth,33,1989,26.5,3,1,3,0,0,3,3,100.0,0,0,0,0,0,3,10,3,Matches
Pedro Neto,pt POR,"FW,MF",Wolves,22,2000,10.7,11,6,4,2,5,7,17,41.2,10,5,1,4,4,15,4,0,Matches
Rúben Neves,pt POR,MF,Wolves,25,1997,33.5,79,43,31,33,15,32,76,42.1,44,59,22,37,50,129,85,1,Matches

Moussa Niakhate,sn SEN,DF,Nott'ham Forest,26,1996,12.9,18,9,15,3,0,11,22,50.0,11,18,8,10,19,37,60,0,Matches
Eddie Nketiah,eng ENG,FW,Arsenal,23,1999,12.1,13,9,6,2,5,2,10,20.0,8,7,1,6,1,14,7,0,Matches
Matheus Nunes,pt POR,MF,Wolves,23,1998,27.4,67,43,36,22,9,28,61,45.9,33,35,4,31,16,83,35,2,Matches
Darwin Núñez,uy URU,FW,Liverpool,23,1999,18.8,11,5,2,4,5,4,17,23.5,13,10,0,10,3,14,13,0,Matches
Ethan Nwaneri,eng ENG,FW,Arsenal,15,2007,0.0,0,0,0,0,0,0,0,,0,1,0,1,0,0,0,0,Matches
Christian Nørgaard,dk DEN,MF,Brentford,28,1994,19.6,52,30,21,29,2,18,48,37.5,30,32,9,23,34,86,41,2,Matches
Lewis O'Brien,eng ENG,MF,Nott'ham Forest,23,1998,6.5,16,9,4,11,1,6,12,50.0,6,13,2,11,5,21,9,0,Matches
Odeluga Offiah,eng ENG,DF,Brighton,19,2002,0.3,1,1,1,0,0,0,2,0.0,2,0,0,0,0,1,1,0,Matches
Angelo Ogbonna,it ITA,DF,West Ham,34,1988,13.7,11,4,7,4,0,5,10,50.0,5,11,7,4,17,28,74,1,Matches
Michael Olise,fr FRA,"FW,MF",Crystal Palace,20,2001,30.5,58,34,28,26,4,25,60,41.7,35,46,1,45,26,84,17,0,Matches
Robin Olsen,se SWE,GK,Aston Villa,32,1990,3.1,0,0,0,0,0,0,2,0.0,2,0,0,0,0,0,1,0,Matches
Amadou Onana,be BEL,MF,Everton,20,2001,27.6,72,43,24,42,6,30,42,71.4,12,25,6,19,37,109,39,0,Matches
Josh Onomah,eng ENG,MF,Fulham,25,1997,0.2,1,0,1,0,0,0,0,,0,1,0,1,0,1,0,0,Matches
Paul Onuachu,ng NGA,FW,Southampton,28,1994,4.5,3,2,1,1,1,1,3,33.3,2,4,1,3,0,3,4,0,Matches
Frank Onyeka,ng NGA,MF,Brentford,24,1998,9.4,19,14,11,7,1,10,25,40.0,15,16,3,13,10,29,16,0,Matches
Mislav Oršić,hr CRO,MF,Southampton,29,1992,0.1,1,1,1,0,0,0,0,,0,0,0,0,0,1,0,0,Matches
Stefan Ortega,de GER,GK,Manchester City,29,1992,3.0,0,0,0,0,0,0,0,,0,0,0,0,0,0,0,0,Matches
Dango Ouattara,bf BFA,"MF,FW",Bournemouth,20,2002,13.8,28,15,20,6,2,13,32,40.6,19,20,3,17,13,41,29,1,Matches
Alex Oxlade-Chamberlain,eng ENG,"FW,MF",Liverpool,28,1993,3.7,5,4,1,2,2,1,5,20.0,4,5,2,3,1,6,4,0,Matches
David Ozoh,eng ENG,FW,Crystal Palace,17,2005,0.0,0,0,0,0,0,0,0,,0,0,0,0,0,0,0,0,Matches
João Palhinha,pt POR,MF,Fulham,27,1995,34.5,148,83,59,65,24,71,135,52.6,64,48,5,43,46,194,61,2,Matches
Cole Palmer,eng ENG,"MF,FW",Manchester City,20,2002,4.1,5,1,0,3,2,3,5,60.0,2,2,1,1,1,6,2,0,Matches
Emerson Palmieri,it ITA,DF,West Ham,27,1994,14.7,26,14,9,15,2,12,24,50.0,12,17,4,13,15,41,36,0,Matches
Lucas Paquetá,br BRA,MF,West Ham,24,1997,23.9,71,53,23,36,12,27,68,39.7,41,41,4,37,16,87,31,0,Matches
Thomas Partey,gh GHA,MF,Arsenal,29,1993,27.6,70,40,20,35,15,25,52,48.1,27,26,5,21,28,98,41,1,Matches

Nathan Patterson,sct SCO,"DF,MF",Everton,20,2001,14.2,49,24,32,13,4,29,54,53.7,25,24,4,20,15,64,45,0,Matches
Ben Pearson,eng ENG,MF,Bournemouth,27,1995,3.2,7,3,3,3,1,1,3,33.3,2,4,0,4,2,9,6,0,Matches
Facundo Pellistri,uy URU,"FW,MF",Manchester Utd,20,2001,0.7,1,1,0,1,0,0,0,,0,0,0,0,0,1,3,0,Matches
Andreas Pereira,br BRA,MF,Fulham,26,1996,29.9,18,9,3,6,9,8,34,23.5,26,21,3,18,6,24,8,0,Matches
Ricardo Pereira,pt POR,"DF,MF",Leicester City,28,1993,5.0,11,7,8,3,0,7,17,41.2,10,8,2,6,4,15,20,0,Matches
Ayoze Pérez,es ESP,"MF,FW",Leicester City,29,1993,4.2,11,8,5,4,2,8,19,42.1,11,6,0,6,2,13,3,0,Matches
Ivan Perišić,hr CRO,"DF,MF",Tottenham,33,1989,23.4,42,24,25,10,7,27,47,57.4,20,29,7,22,22,64,49,1,Matches
Romain Perraud,fr FRA,DF,Southampton,24,1997,20.4,54,33,23,23,8,28,52,53.8,24,24,6,18,20,74,42,0,Matches
Máximo Perrone,ar ARG,MF,Manchester City,19,2003,0.2,0,0,0,0,0,0,0,,0,1,0,1,0,0,0,0,Matches
Cameron Peupion,au AUS,MF,Brighton,19,2002,0.1,0,0,0,0,0,0,0,,0,0,0,0,0,0,0,0,Matches
Kalvin Phillips,eng ENG,MF,Manchester City,26,1995,3.3,6,4,3,3,0,2,10,20.0,8,7,3,4,5,11,10,0,Matches
Nathaniel Phillips,eng ENG,DF,Liverpool,25,1997,0.7,2,1,0,2,0,2,2,100.0,0,0,0,0,2,4,1,0,Matches
Jordan Pickford,eng ENG,GK,Everton,28,1994,37.0,0,0,0,0,0,0,1,0.0,1,0,0,0,4,4,15,3,Matches
Ethan Pinnock,jm JAM,DF,Brentford,29,1993,30.0,52,28,33,12,7,18,24,75.0,6,41,31,10,35,87,215,2,Matches
Daniel Podence,pt POR,"FW,MF",Wolves,26,1995,19.7,27,17,13,9,5,6,32,18.8,26,19,0,19,7,34,6,0,Matches
Nick Pope,eng ENG,GK,Newcastle Utd,30,1992,36.2,1,0,1,0,0,1,3,33.3,2,0,0,0,0,1,27,2,Matches
Pedro Porro,es ESP,"DF,MF",Tottenham,22,1999,12.6,25,16,8,15,2,14,39,35.9,25,25,2,23,15,40,24,1,Matches
Dennis Praet,be BEL,"MF,FW",Leicester City,28,1994,7.2,12,9,5,6,1,6,11,54.5,5,12,2,10,5,17,6,0,Matches
Isaac Price,nir NIR,MF,Everton,18,2003,0.4,0,0,0,0,0,0,1,0.0,1,1,1,0,0,0,0,0,Matches
Christian Pulisic,us USA,"FW,DF",Chelsea,23,1998,9.1,11,6,3,6,2,3,5,60.0,2,8,1,7,4,15,4,0,Matches
Aaron Ramsdale,eng ENG,GK,Arsenal,24,1998,38.0,1,1,1,0,0,1,1,100.0,0,0,0,0,0,1,20,6,Matches
Jacob Ramsey,eng ENG,"MF,FW",Aston Villa,21,2001,29.3,69,39,23,35,11,32,69,46.4,37,48,8,40,23,92,34,0,Matches
Marcus Rashford,eng ENG,FW,Manchester Utd,24,1997,32.0,20,10,7,8,5,9,24,37.5,15,31,4,27,7,27,14,0,Matches
David Raya,es ESP,GK,Brentford,26,1995,38.0,0,0,0,0,0,0,2,0.0,2,1,0,1,1,1,10,3,Matches
Tim Ream,us USA,DF,Fulham,34,1987,32.2,30,16,15,12,3,13,26,50.0,13,45,24,21,41,71,116,3,Matches

Nathan Redmond,eng ENG,DF,Southampton,28,1994,0.0,0,0,0,0,0,0,0,,0,0,0,0,0,0,0,0,Matches
Harrison Reed,eng ENG,MF,Fulham,27,1995,31.8,44,27,17,21,6,16,51,31.4,35,54,12,42,19,63,36,0,Matches
Bobby Reid,jm JAM,"FW,DF",Fulham,29,1993,27.5,42,24,14,14,14,16,36,44.4,20,25,3,22,20,62,28,1,Matches
Declan Rice,eng ENG,MF,West Ham,23,1999,36.4,79,38,44,31,4,31,50,62.0,19,45,15,30,63,142,58,0,Matches
Chris Richards,us USA,DF,Crystal Palace,22,2000,5.0,9,6,8,1,0,5,7,71.4,2,10,1,9,8,17,31,0,Matches
Richarlison,br BRA,"MF,FW",Tottenham,25,1997,11.2,21,16,13,5,3,12,27,44.4,15,14,1,13,5,26,10,0,Matches
Jaïro Riedewald,nl NED,"DF,MF",Crystal Palace,25,1996,0.7,2,1,2,0,0,0,1,0.0,1,2,0,2,0,2,4,0,Matches
Matt Ritchie,sct SCO,"FW,MF",Newcastle Utd,32,1989,0.4,1,1,0,1,0,1,3,33.3,2,0,0,0,1,2,0,0,Matches
Andrew Robertson,sct SCO,DF,Liverpool,28,1994,28.7,38,21,12,16,10,21,41,51.2,20,32,5,27,18,56,50,3,Matches
Antonee Robinson,us USA,DF,Fulham,24,1997,34.3,62,38,43,15,4,44,65,67.7,21,49,13,36,53,115,83,3,Matches
Joel Robles,es ESP,GK,Leeds United,32,1990,4.0,0,0,0,0,0,0,1,0.0,1,0,0,0,0,0,2,1,Matches
Marc Roca,es ESP,MF,Leeds United,25,1996,25.7,66,40,27,34,5,20,65,30.8,45,34,10,24,23,89,24,2,Matches
Marek Rodák,sk SVK,GK,Fulham,25,1996,2.0,0,0,0,0,0,0,0,,0,0,0,0,0,0,1,1,Matches
Rodri,es ESP,MF,Manchester City,26,1996,32.3,67,41,28,28,11,26,53,49.1,27,40,14,26,33,100,43,1,Matches
Rodrigo,es ESP,"FW,MF",Leeds United,31,1991,21.5,24,10,2,15,7,8,19,42.1,11,16,4,12,6,30,21,1,Matches
Mads Roerslev,dk DEN,DF,Brentford,23,1999,12.3,22,12,19,3,0,16,33,48.5,17,14,5,9,9,31,38,0,Matches
Cristian Romero,ar ARG,DF,Tottenham,24,1998,26.3,68,36,42,24,2,29,46,63.0,17,40,18,22,44,112,102,3,Matches
Oriol Romeu,es ESP,MF,Southampton,30,1991,0.8,1,0,0,1,0,0,0,,0,1,0,1,1,2,1,0,Matches
Cristiano Ronaldo,pt POR,FW,Manchester Utd,37,1985,5.8,2,2,1,0,1,1,2,50.0,1,0,0,0,1,3,9,0,Matches
Connor Ronan,ie IRL,MF,Wolves,24,1998,0.0,0,0,0,0,0,0,0,,0,0,0,0,0,0,0,0,Matches
Salomón Rondón,ve VEN,FW,Everton,32,1989,1.2,0,0,0,0,0,0,0,,0,1,1,0,0,0,0,0,Matches
Joe Rothwell,eng ENG,MF,Bournemouth,27,1995,11.3,20,13,7,12,1,7,21,33.3,14,14,3,11,9,29,7,0,Matches
Georginio Rutter,fr FRA,"FW,MF",Leeds United,20,2002,3.0,10,9,5,3,2,5,8,62.5,3,5,0,5,3,13,3,0,Matches
José Sá,pt POR,GK,Wolves,29,1993,36.0,1,0,1,0,0,1,1,100.0,0,0,0,0,0,1,10,6,Matches
Marcel Sabitzer,at AUT,MF,Manchester Utd,28,1994,7.0,12,8,3,8,1,2,11,18.2,9,6,2,4,8,20,11,0,Matches

Allan Saint-Maximin,fr FRA,FW,Newcastle Utd,25,1997,12.4,10,3,3,6,1,2,11,18.2,9,4,0,4,5,15,2,0,Matches
Bukayo Saka,eng ENG,FW,Arsenal,20,2001,35.3,63,34,22,15,26,20,44,45.5,24,38,0,38,14,77,19,0,Matches
Mohamed Salah,eg EGY,FW,Liverpool,30,1992,36.6,21,12,4,5,12,10,26,38.5,16,21,0,21,6,27,4,0,Matches
William Saliba,fr FRA,DF,Arsenal,21,2001,26.8,34,20,23,9,2,15,18,83.3,3,13,10,3,19,53,85,4,Matches
Mohammed Salisu,gh GHA,DF,Southampton,23,1999,21.9,52,29,34,16,2,24,34,70.6,10,56,25,31,30,82,122,1,Matches
Albert Sambi Lokonga,be BEL,MF,Arsenal,22,1999,2.2,1,1,0,0,1,0,2,0.0,2,1,0,1,5,6,2,0,Matches
Albert Sambi Lokonga,be BEL,MF,Crystal Palace,22,1999,6.0,13,10,7,4,2,8,12,66.7,4,8,3,5,7,20,10,0,Matches
Davinson Sánchez,co COL,DF,Tottenham,26,1996,9.5,24,11,17,6,1,14,20,70.0,6,16,10,6,12,36,41,0,Matches
Robert Sánchez,es ESP,GK,Brighton,24,1997,23.0,1,0,1,0,0,0,0,,0,0,0,0,3,4,9,2,Matches
Jadon Sancho,eng ENG,"FW,MF",Manchester Utd,22,2000,18.7,16,10,7,5,4,8,28,28.6,20,25,2,23,7,23,6,0,Matches
Morgan Sanson,fr FRA,MF,Aston Villa,27,1994,0.1,2,1,1,1,0,1,1,100.0,0,0,0,0,0,2,0,0,Matches
Pablo Sarabia,es ESP,"FW,MF",Wolves,30,1992,8.5,12,6,4,5,3,6,15,40.0,9,7,0,7,2,14,4,0,Matches
Jeremy Sarmiento,ec ECU,MF,Brighton,20,2002,2.0,6,3,4,1,1,2,5,40.0,3,2,0,2,1,7,0,0,Matches
Gianluca Scamacca,it ITA,FW,West Ham,23,1999,10.3,10,5,1,3,6,2,2,100.0,0,3,0,3,4,14,5,0,Matches
Gustavo Scarpa,br BRA,"MF,FW",Nott'ham Forest,28,1994,2.0,5,2,3,1,1,2,5,40.0,3,4,0,4,0,5,3,0,Matches
Kevin Schade,de GER,FW,Brentford,20,2001,8.1,12,8,7,2,3,5,10,50.0,5,7,0,7,4,16,6,0,Matches
Fabian Schär,ch SUI,DF,Newcastle Utd,30,1991,35.6,47,22,31,13,3,24,39,61.5,15,34,19,15,52,99,139,0,Matches
Jeffrey Schlupp,gh GHA,"MF,FW",Crystal Palace,29,1992,28.1,66,46,28,29,9,22,43,51.2,21,39,8,31,23,89,38,0,Matches
Nélson Semedo,pt POR,DF,Wolves,28,1993,29.2,71,42,48,19,4,33,64,51.6,31,42,15,27,29,100,83,2,Matches
Antoine Semenyo,gh GHA,"FW,MF",Bournemouth,22,2000,2.9,1,0,0,0,1,1,6,16.7,5,10,1,9,2,3,4,0,Matches
Marcos Senesi,ar ARG,DF,Bournemouth,25,1997,27.7,50,35,28,22,0,23,44,52.3,21,38,20,18,43,93,146,2,Matches
Ryan Sessegnon,eng ENG,DF,Tottenham,22,2000,9.0,16,11,9,7,0,6,12,50.0,6,8,1,7,6,22,17,1,Matches
Luke Shaw,eng ENG,DF,Manchester Utd,27,1995,28.4,55,36,31,22,2,32,46,69.6,14,51,17,34,36,91,55,2,Matches
Jonjo Shelvey,eng ENG,MF,Newcastle Utd,30,1992,0.4,1,0,1,0,0,0,1,0.0,1,1,0,1,0,1,0,0,Matches
Jonjo Shelvey,eng ENG,MF,Nott'ham Forest,30,1992,6.0,2,1,0,1,1,1,9,11.1,8,7,2,5,5,7,10,1,Matches

Bernardo Silva,pt POR,"MF,FW",Manchester City,27,1994,24.5,44,23,11,25,8,18,45,40.0,27,23,6,17,16,60,6,0,Matches
Thiago Silva,br BRA,DF,Chelsea,37,1984,26.1,41,27,24,17,0,21,31,67.7,10,38,29,9,34,75,111,3,Matches
Ellis Simms,eng ENG,FW,Everton,21,2001,2.5,0,0,0,0,0,0,0,,0,0,0,0,0,0,1,0,Matches
Luis Sinisterra,co COL,FW,Leeds United,23,1999,9.6,21,14,8,9,4,11,18,61.1,7,11,1,10,8,29,2,0,Matches
Oliver Skipp,eng ENG,MF,Tottenham,21,2000,16.6,34,17,18,15,1,16,33,48.5,17,17,8,9,17,51,19,1,Matches
Adam Smith,eng ENG,DF,Bournemouth,31,1991,32.7,49,29,27,19,3,29,60,48.3,31,30,13,17,25,74,81,1,Matches
Emile Smith Rowe,eng ENG,"MF,FW",Arsenal,22,2000,1.9,1,1,1,0,0,1,3,33.3,2,1,0,1,0,1,2,0,Matches
Cédric Soares,pt POR,DF,Arsenal,30,1991,0.3,0,0,0,0,0,0,1,0.0,1,1,0,1,0,0,1,0,Matches
Cédric Soares,pt POR,DF,Fulham,30,1991,2.2,8,5,4,3,1,3,3,100.0,0,3,1,2,1,9,5,0,Matches
Dominic Solanke,eng ENG,"FW,MF",Bournemouth,24,1997,31.8,15,9,8,3,4,5,22,22.7,17,26,7,19,6,21,46,0,Matches
Manor Solomon,il ISR,FW,Fulham,23,1999,6.4,20,12,12,6,2,9,16,56.3,7,8,0,8,5,25,3,0,Matches
Tomáš Souček,cz CZE,MF,West Ham,27,1995,31.3,77,37,41,29,7,28,58,48.3,30,42,17,25,53,130,71,3,Matches
Boubakary Soumaré,fr FRA,MF,Leicester City,23,1999,18.1,57,34,29,26,2,23,44,52.3,21,15,4,11,33,90,27,1,Matches
Harry Souttar,au AUS,DF,Leicester City,23,1998,11.0,15,9,10,5,0,7,18,38.9,11,16,12,4,12,27,45,0,Matches
Çağlar Söyüncü,tr TUR,DF,Leicester City,26,1996,5.9,14,9,10,4,0,7,10,70.0,3,9,8,1,7,21,30,0,Matches
Djed Spence,eng ENG,"FW,DF",Tottenham,21,2000,0.1,0,0,0,0,0,0,0,,0,0,0,0,0,0,0,0,Matches
Jack Stacey,eng ENG,DF,Bournemouth,26,1996,3.3,5,4,3,1,1,2,5,40.0,3,3,1,2,5,10,15,0,Matches
Junior Stanislas,eng ENG,MF,Bournemouth,32,1989,0.7,0,0,0,0,0,0,0,,0,2,1,1,0,0,0,0,Matches
Jay Stansfield,eng ENG,FW,Fulham,19,2002,1.0,0,0,0,0,0,0,2,0.0,2,4,1,3,1,1,1,0,Matches
Jason Steele,eng ENG,GK,Brighton,31,1990,15.0,0,0,0,0,0,0,1,0.0,1,0,0,0,0,0,6,1,Matches
Jack Stephens,eng ENG,DF,Southampton,28,1994,0.5,2,2,2,0,0,1,1,100.0,0,1,1,0,1,3,2,0,Matches
Jack Stephens,eng ENG,DF,Bournemouth,28,1994,13.0,15,11,10,4,1,6,10,60.0,4,23,16,7,16,31,53,0,Matches
Raheem Sterling,eng ENG,"FW,MF",Chelsea,27,1994,21.0,18,10,5,4,9,8,14,57.1,6,17,0,17,2,20,5,0,Matches
John Stones,eng ENG,"DF,MF",Manchester City,28,1994,20.5,23,13,11,8,4,7,10,70.0,3,17,10,7,9,32,40,0,Matches
Pascal Struijk,nl NED,DF,Leeds United,22,1999,24.4,84,57,43,31,10,49,75,65.3,26,32,12,20,32,116,70,1,Matches

Kamaldeen Sulemana,gh GHA,"FW,MF",Southampton,20,2002,10.7,15,9,4,7,4,4,14,28.6,10,16,0,16,6,21,6,0,Matches
Crysencio Summerville,nl NED,FW,Leeds United,20,2001,15.8,30,20,14,14,2,11,23,47.8,12,20,2,18,13,43,11,0,Matches
Sam Surridge,eng ENG,FW,Nott'ham Forest,24,1998,3.6,5,0,1,3,1,1,4,25.0,3,5,2,3,0,5,7,0,Matches
Japhet Tanganga,eng ENG,DF,Tottenham,23,1999,1.6,3,2,3,0,0,1,5,20.0,4,1,0,1,2,5,8,0,Matches
Matt Targett,eng ENG,DF,Newcastle Utd,26,1995,6.8,13,10,8,3,2,9,24,37.5,15,8,3,5,9,22,16,0,Matches
James Tarkowski,eng ENG,DF,Everton,29,1992,38.0,51,26,36,13,2,20,39,51.3,19,99,78,21,51,102,201,3,Matches
Marcus Tavernier,eng ENG,"MF,FW",Bournemouth,23,1999,19.4,33,22,19,11,3,11,33,33.3,22,25,4,21,9,42,23,0,Matches
Tetê,br BRA,FW,Leicester City,22,2000,8.2,14,8,5,7,2,6,21,28.6,15,9,0,9,2,16,3,0,Matches
Kenny Tete,nl NED,DF,Fulham,26,1995,28.5,83,46,41,29,13,38,51,74.5,13,48,17,31,52,135,81,1,Matches
Luke Thomas,eng ENG,DF,Leicester City,21,2001,11.9,23,19,15,5,3,15,32,46.9,17,20,4,16,27,50,35,0,Matches
Youri Tielemans,be BEL,MF,Leicester City,25,1997,26.0,66,39,27,30,9,23,62,37.1,39,35,8,27,28,94,24,1,Matches
Kieran Tierney,sct SCO,DF,Arsenal,25,1997,8.8,20,11,9,9,2,12,16,75.0,4,8,2,6,11,31,25,0,Matches
Harry Toffolo,eng ENG,DF,Nott'ham Forest,26,1995,10.4,17,8,10,4,3,10,14,71.4,4,16,8,8,10,27,33,0,Matches
Takehiro Tomiyasu,jp JPN,DF,Arsenal,23,1998,7.4,27,18,12,10,5,13,18,72.2,5,7,0,7,14,41,15,1,Matches
James Tomkins,eng ENG,DF,Crystal Palace,33,1989,3.8,4,2,2,1,1,1,3,33.3,2,3,2,1,5,9,19,0,Matches
Ivan Toney,eng ENG,FW,Brentford,26,1996,32.8,23,13,4,9,10,7,23,30.4,16,24,9,15,14,37,36,0,Matches
Adama Traoré,es ESP,"FW,MF",Wolves,26,1996,16.6,14,7,7,4,3,4,9,44.4,5,8,1,7,3,17,17,0,Matches
Bertrand Traoré,bf BFA,"FW,MF",Aston Villa,26,1995,2.6,1,1,1,0,0,1,4,25.0,3,5,0,5,2,3,0,0,Matches
Boubacar Traoré,ml MLI,MF,Wolves,20,2001,4.6,12,5,4,5,3,3,7,42.9,4,4,2,2,7,19,1,0,Matches
Mark Travers,ie IRL,GK,Bournemouth,23,1999,11.5,0,0,0,0,0,0,0,,0,1,0,1,0,0,6,0,Matches
Kieran Trippier,eng ENG,DF,Newcastle Utd,31,1990,37.1,71,49,36,27,8,46,90,51.1,44,45,15,30,43,114,84,2,Matches
Leandro Trossard,be BEL,FW,Arsenal,27,1994,10.3,12,7,4,2,6,6,18,33.3,12,18,0,18,6,18,3,1,Matches
Leandro Trossard,be BEL,"FW,MF",Brighton,27,1994,14.6,10,6,7,1,2,1,8,12.5,7,17,0,17,6,16,1,0,Matches
Kostas Tsimikas,gr GRE,DF,Liverpool,26,1996,8.6,14,9,10,2,2,10,16,62.5,6,8,1,7,12,26,15,0,Matches
Deniz Undav,de GER,"FW,MF",Brighton,26,1996,7.0,7,4,2,2,3,2,8,25.0,6,4,1,3,0,7,1,0,Matches

Yan Valery,tn TUN,DF,Southampton,23,1999,0.5,0,0,0,0,0,0,0,,0,1,0,1,0,0,3,0,Matches
Virgil van Dijk,nl NED,DF,Liverpool,31,1991,31.5,27,14,13,11,3,8,19,42.1,11,24,16,8,31,58,138,3,Matches
Raphaël Varane,fr FRA,DF,Manchester Utd,29,1993,21.2,24,9,18,6,0,7,17,41.2,10,24,17,7,11,35,91,0,Matches
Jamie Vardy,eng ENG,FW,Leicester City,35,1987,20.6,9,5,4,2,3,1,8,12.5,7,17,3,14,2,11,30,0,Matches
Joël Veltman,nl NED,DF,Brighton,30,1992,24.3,62,32,44,14,4,37,57,64.9,20,27,8,19,19,81,51,0,Matches
Fabio Vieira,pt POR,"MF,FW",Arsenal,22,2000,5.7,6,4,3,0,3,3,5,60.0,2,5,0,5,4,10,2,0,Matches
Matías Viña,uy URU,DF,Bournemouth,24,1997,5.1,19,11,9,8,2,14,30,46.7,16,13,1,12,4,23,22,0,Matches
Rúben Vinagre,pt POR,"DF,MF",Everton,23,1999,0.3,2,2,1,1,0,1,2,50.0,1,0,0,0,0,2,1,0,Matches
Carlos Vinícius,br BRA,FW,Fulham,27,1995,12.3,4,1,0,2,2,0,4,0.0,4,7,0,7,0,4,10,0,Matches
Theo Walcott,eng ENG,"FW,MF",Southampton,33,1989,12.5,13,6,8,4,1,8,27,29.6,19,8,1,7,9,22,7,0,Matches
Kyle Walker,eng ENG,DF,Manchester City,32,1990,21.8,13,9,8,5,0,4,24,16.7,20,12,2,10,18,31,22,0,Matches
Kyle Walker-Peters,eng ENG,DF,Southampton,25,1997,29.4,61,32,34,24,3,22,43,51.2,21,47,8,39,27,88,52,0,Matches
Aaron Wan-Bissaka,eng ENG,DF,Manchester Utd,24,1997,15.9,40,25,20,17,3,23,25,92.0,2,24,8,16,22,62,41,0,Matches
Danny Ward,wls WAL,GK,Leicester City,29,1993,26.0,1,1,1,0,0,1,3,33.3,2,0,0,0,0,1,14,2,Matches
Joel Ward,eng ENG,DF,Crystal Palace,32,1989,25.1,50,36,30,11,9,30,41,73.2,11,32,16,16,25,75,80,1,Matches
James Ward-Prowse,eng ENG,MF,Southampton,27,1994,37.5,65,37,31,27,7,21,61,34.4,40,30,10,20,55,120,48,0,Matches
Ollie Watkins,eng ENG,FW,Aston Villa,26,1995,34.7,19,13,3,13,3,10,27,37.0,17,21,4,17,10,29,39,0,Matches
Adam Webster,eng ENG,DF,Brighton,27,1995,22.1,22,12,10,9,3,11,19,57.9,8,30,19,11,19,41,55,4,Matches
Wout Weghorst,nl NED,"FW,MF",Manchester Utd,29,1992,8.9,11,5,6,1,4,2,9,22.2,7,7,2,5,7,18,9,0,Matches
Danny Welbeck,eng ENG,FW,Brighton,31,1990,20.6,15,7,0,7,8,4,11,36.4,7,24,2,22,5,20,20,0,Matches
Ben White,eng ENG,DF,Arsenal,24,1997,33.9,60,31,23,30,7,42,70,60.0,28,47,11,36,22,82,79,1,Matches
Harvey White,eng ENG,MF,Tottenham,20,2001,0.1,0,0,0,0,0,0,1,0.0,1,0,0,0,0,0,0,0,Matches
Joseph Whitworth,eng ENG,GK,Crystal Palace,18,2004,2.0,0,0,0,0,0,0,0,,0,0,0,0,0,0,1,0,Matches
Neco Williams,wls WAL,DF,Nott'ham Forest,21,2001,20.9,72,47,49,17,6,38,71,53.5,33,33,8,25,33,105,48,0,Matches
Willian,br BRA,FW,Fulham,33,1988,23.6,13,8,8,3,2,7,25,28.0,18,13,0,13,9,22,9,0,Matches

Joe Willock,eng ENG,MF,Newcastle Utd,22,1999,28.4,51,30,13,26,12,25,58,43.1,33,54,8,46,25,76,17,0,Matches
Callum Wilson,eng ENG,FW,Newcastle Utd,30,1992,20.9,9,3,0,8,1,0,3,0.0,3,8,0,8,1,10,5,0,Matches
Harry Wilson,wls WAL,FW,Fulham,25,1997,12.2,21,13,9,9,3,8,18,44.4,10,17,2,15,6,27,14,0,Matches
Yoane Wissa,cd COD,FW,Brentford,25,1996,17.8,17,12,4,7,6,6,13,46.2,7,10,0,10,6,23,15,0,Matches
Maximilian Wöber,at AUT,DF,Leeds United,24,1998,14.1,25,18,9,15,1,16,24,66.7,8,32,14,18,27,52,67,1,Matches
Chris Wood,nz NZL,FW,Newcastle Utd,30,1991,5.0,5,4,0,3,2,3,5,60.0,2,2,2,0,1,6,7,0,Matches
Chris Wood,nz NZL,FW,Nott'ham Forest,30,1991,4.1,0,0,0,0,0,0,1,0.0,1,2,1,1,1,1,2,0,Matches
Joe Worrall,eng ENG,DF,Nott'ham Forest,25,1997,24.7,53,25,39,12,2,25,35,71.4,10,33,23,10,26,79,111,1,Matches
Granit Xhaka,ch SUI,MF,Arsenal,29,1992,33.3,34,27,11,18,5,16,41,39.0,25,28,10,18,15,49,45,1,Matches
Ryan Yates,eng ENG,MF,Nott'ham Forest,24,1997,20.4,38,19,19,16,3,14,22,63.6,8,26,8,18,10,48,44,0,Matches
Ashley Young,eng ENG,DF,Aston Villa,37,1985,22.6,50,27,34,15,1,37,50,74.0,13,25,11,14,21,71,65,0,Matches
Illia Zabarnyi,ua UKR,DF,Bournemouth,19,2002,3.3,4,2,4,0,0,3,7,42.9,4,7,2,5,3,7,14,0,Matches
Wilfried Zaha,ci CIV,"FW,MF",Crystal Palace,29,1992,25.4,32,20,12,12,8,8,21,38.1,13,21,1,20,16,48,9,0,Matches
Denis Zakaria,ch SUI,MF,Chelsea,25,1996,4.6,9,5,5,2,2,2,8,25.0,6,4,1,3,3,12,10,0,Matches
Jordan Zemura,zw ZIM,DF,Bournemouth,22,1999,16.2,39,24,24,14,1,23,44,52.3,21,31,9,22,16,55,32,0,Matches
Oleksandr Zinchenko,ua UKR,DF,Arsenal,25,1996,23.5,40,18,14,17,9,21,40,52.5,19,20,2,18,22,62,38,2,Matches
Hakim Ziyech,ma MAR,"FW,MF",Chelsea,29,1993,7.3,20,12,12,5,3,4,9,44.4,5,8,0,8,5,25,5,1,Matches
Kurt Zouma,fr FRA,DF,West Ham,27,1994,22.1,9,4,4,5,0,5,8,62.5,3,17,14,3,30,39,120,1,Matches
Martin Ødegaard,no NOR,MF,Arsenal,23,1998,34.7,36,23,12,14,10,14,47,29.8,33,20,5,15,6,42,12,1,Matches
