Player,Nation,Position,Squad,Age,Year of birth,90s Played,Tackles,Tackles Won,Tackles (Def 3rd),Tackles (Mid 3rd),Tackles (Att 3rd),Dribblers Tackled,Dribbles Challenged,% of Dribblers Tackled,Challenges Lost,Blocks,Shots Blocked,Passes Blocked,Interceptions,Tkl+Int,Clearances,Errors,Matches


Rodrigo Abascal,uy URU,DF,Boavista,28,1994,25.5,46,28,28,18,0,30,52,57.7,22,29,10,19,36,82,98,1,Matches
Giorgi Aburjania,ge GEO,MF,Gil Vicente FC,27,1995,17.9,38,17,12,19,7,18,43,41.9,25,19,7,12,12,50,9,0,Matches
Elias Achouri,tn TUN,MF,Estoril,23,1999,0.1,0,0,0,0,0,0,0,,0,1,0,1,0,0,0,0,Matches
Antonio Adán,es ESP,GK,Sporting CP,35,1987,31.0,1,0,1,0,0,1,3,33.3,2,0,0,0,0,1,11,0,Matches
Adriano,br BRA,"MF,DF",Santa Clara,22,1999,24.5,50,31,19,30,1,31,50,62.0,19,34,13,21,26,76,52,0,Matches
João Afonso Crispim,br BRA,MF,Marítimo,27,1995,16.3,43,24,16,24,3,20,47,42.6,27,16,10,6,36,79,37,3,Matches
Lucas Áfrico,br BRA,DF,Estoril,27,1995,3.9,2,1,2,0,0,1,1,100.0,0,3,2,1,3,5,9,0,Matches
Martin Agirregabiria,es ESP,"DF,FW",Famalicão,26,1996,4.5,4,4,2,2,0,3,4,75.0,1,3,1,2,10,14,9,0,Matches
Salvador Agra,pt POR,"FW,MF",Boavista,30,1991,18.3,27,20,10,13,4,12,23,52.2,11,5,1,4,6,33,6,0,Matches
Mohamed Aidara,ci CIV,"DF,FW",Vizela,25,1996,2.7,3,1,3,0,0,3,3,100.0,0,2,2,0,2,5,8,0,Matches
Alemão,br BRA,DF,Portimonense,19,2002,4.0,11,9,7,4,0,5,10,50.0,5,6,4,2,6,17,24,0,Matches
Sotiris Alexandropoulos,gr GRE,MF,Sporting CP,20,2001,1.2,6,5,2,3,1,3,6,50.0,3,1,0,1,2,8,1,0,Matches
Ali Alipour,ir IRN,"FW,MF",Gil Vicente FC,26,1995,5.9,6,3,1,4,1,5,9,55.6,4,7,0,7,1,7,2,1,Matches
Allano,br BRA,"FW,MF",Santa Clara,27,1995,12.6,16,13,11,5,0,8,29,27.6,21,22,4,18,7,23,12,0,Matches
Domingos André Ribeiro Almeida,pt POR,MF,Vitória,22,2000,2.6,4,2,3,0,1,2,3,66.7,1,6,0,6,4,8,4,0,Matches
Jordi Almeida,br BRA,GK,Paços,28,1993,6.0,1,0,1,0,0,1,1,100.0,0,0,0,0,0,1,4,2,Matches
Alejandro Alvarado Jr.,us USA,"FW,MF",Vizela,19,2003,0.8,2,0,1,1,0,0,2,0.0,2,3,1,2,0,2,1,0,Matches
Pedro Álvaro,pt POR,DF,Estoril,22,2000,28.6,23,12,15,7,1,14,19,73.7,5,31,23,8,34,57,119,1,Matches
Pedro Amaral,pt POR,DF,Rio Ave,24,1997,11.0,17,9,12,5,0,12,21,57.1,9,10,3,7,10,27,18,0,Matches
André Amaro,pt POR,DF,Vitória,19,2002,26.2,47,30,36,10,1,30,46,65.2,16,32,13,19,48,95,103,0,Matches
Anderson,br BRA,FW,Vitória,24,1997,15.0,5,2,1,2,2,1,2,50.0,1,10,1,9,2,7,16,0,Matches
Anderson,br BRA,"FW,MF",Portimonense,24,1998,4.2,2,0,0,1,1,1,6,16.7,5,5,0,5,0,2,1,0,Matches
Anderson,br BRA,"MF,FW",Casa Pia,23,1998,0.3,1,1,0,1,0,0,1,0.0,1,1,0,1,1,2,0,0,Matches
Léo Andrade,br BRA,DF,Marítimo,24,1998,11.8,14,8,12,1,1,11,14,78.6,3,20,8,12,26,40,36,1,Matches
André André,pt POR,MF,Vitória,32,1989,15.0,28,16,12,15,1,10,29,34.5,19,13,4,9,10,38,12,0,Matches

Andrew,br BRA,GK,Gil Vicente FC,21,2001,23.7,1,1,1,0,0,1,4,25.0,3,0,0,0,0,1,14,3,Matches
Andrezinho,pt POR,"FW,MF",Santa Clara,25,1996,6.0,8,3,4,3,1,5,13,38.5,8,10,0,10,3,11,3,0,Matches
Paulo Vítor Fagundes dos Anjos,br BRA,GK,Chaves,33,1988,30.0,1,1,1,0,0,1,2,50.0,1,1,0,1,0,1,33,4,Matches
Carnejy Antoine,ht HAI,"FW,MF",Casa Pia,31,1991,1.4,2,1,0,2,0,1,2,50.0,1,1,0,1,1,3,4,0,Matches
Antony,br BRA,"FW,MF",Arouca,20,2001,26.4,51,35,25,21,5,18,46,39.1,28,26,0,26,25,76,18,0,Matches
Vitorino Antunes,pt POR,DF,Paços,35,1987,29.6,48,34,26,18,4,28,44,63.6,16,32,11,21,67,115,60,1,Matches
Bilel Aouacheria,fr FRA,"FW,MF",Gil Vicente FC,28,1994,8.3,15,10,3,6,6,8,12,66.7,4,11,0,11,6,21,1,0,Matches
Wilinton Aponzá,co COL,MF,Portimonense,22,2000,0.0,0,0,0,0,0,0,0,,0,0,0,0,0,0,0,0,Matches
Mizuki Arai,jp JPN,"FW,MF",Gil Vicente FC,25,1997,3.3,6,5,4,2,0,2,6,33.3,4,9,1,8,1,7,2,0,Matches
Henrique Araújo,pt POR,"MF,FW",Benfica,20,2002,0.8,0,0,0,0,0,0,0,,0,0,0,0,0,0,1,0,Matches
Tiago Araújo,pt POR,"DF,FW",Estoril,21,2001,9.8,13,8,9,2,2,8,22,36.4,14,12,1,11,13,26,20,0,Matches
Tomás Araújo,pt POR,DF,Gil Vicente FC,20,2002,20.8,43,26,31,9,3,26,41,63.4,15,24,12,12,29,72,86,0,Matches
Arthur,br BRA,"FW,MF",Estoril,24,1998,3.1,5,3,3,2,0,2,6,33.3,4,1,0,1,1,6,1,0,Matches
Arthur,br BRA,"MF,DF",Sporting CP,24,1998,8.9,17,10,5,7,5,14,19,73.7,5,21,0,21,2,19,9,0,Matches
Gustavo Assuncao,pt POR,MF,Famalicão,22,2000,10.6,22,15,13,7,2,12,27,44.4,15,21,4,17,13,35,17,0,Matches
Otavio Ataide,br BRA,DF,Famalicão,20,2002,7.9,17,13,10,7,0,11,21,52.4,10,11,7,4,6,23,29,0,Matches
Leo Augusto Pereira,br BRA,"MF,FW",Marítimo,22,2000,5.9,11,9,3,6,2,3,6,50.0,3,4,0,4,5,16,1,0,Matches
Fredrik Aursnes,no NOR,"FW,MF",Benfica,26,1995,23.9,41,29,14,20,7,27,52,51.9,25,18,1,17,32,73,14,0,Matches
Matheus Babi,br BRA,FW,Santa Clara,25,1997,15.1,17,11,1,11,5,9,26,34.6,17,18,3,15,2,19,20,0,Matches
Miguel Baeza,es ESP,"MF,FW",Rio Ave,22,2000,12.0,10,7,2,6,2,3,10,30.0,7,11,2,9,7,17,11,0,Matches
Alexander Bah,dk DEN,DF,Benfica,24,1997,20.9,59,34,25,28,6,28,47,59.6,19,33,5,28,36,95,29,1,Matches
Jason Bahamboula,cg CGO,MF,Vitória,21,2001,0.1,0,0,0,0,0,0,0,,0,0,0,0,0,0,1,0,Matches
Ibrahima Bamba,ci CIV,"DF,MF",Vitória,20,2002,25.8,63,38,41,21,1,36,46,78.3,10,45,23,22,36,99,126,0,Matches
Daniel Bandeira,pt POR,MF,Vitória,22,2000,18.3,44,27,21,17,6,20,39,51.3,19,18,4,14,24,68,25,0,Matches
Simon Banza,cd COD,FW,Braga,25,1996,16.1,17,10,4,6,7,6,15,40.0,9,7,0,7,2,19,14,0,Matches

Romário Baró,pt POR,"MF,FW",Casa Pia,22,2000,10.4,20,10,8,10,2,11,20,55.0,9,11,1,10,10,30,5,0,Matches
Luís Bastos,pt POR,DF,Paços,20,2001,4.1,10,2,8,2,0,8,16,50.0,8,4,0,4,3,13,11,0,Matches
Gabriel Batista,br BRA,GK,Santa Clara,24,1998,26.0,0,0,0,0,0,0,2,0.0,2,0,0,0,0,0,13,0,Matches
Ricardo Batista,pt POR,GK,Casa Pia,35,1986,31.0,0,0,0,0,0,0,1,0.0,1,0,0,0,1,1,18,1,Matches
Dylan Batubinsika,cd COD,DF,Famalicão,26,1996,2.0,6,2,5,1,0,2,2,100.0,0,3,3,0,4,10,8,0,Matches
Batxi,ao ANG,"FW,MF",Chaves,24,1998,3.6,5,3,1,3,1,3,4,75.0,1,1,1,0,1,6,1,0,Matches
Clésio Baúque,mz MOZ,"MF,DF",Marítimo,27,1994,0.7,0,0,0,0,0,0,0,,0,1,0,1,0,0,0,0,Matches
Héctor Bellerín,es ESP,"DF,MF",Sporting CP,27,1995,4.9,9,6,5,3,1,5,9,55.6,4,4,0,4,3,12,7,0,Matches
Stefano Beltrame,it ITA,MF,Marítimo,29,1993,11.7,11,6,4,7,0,5,13,38.5,8,14,3,11,7,18,4,1,Matches
Gilson Benchimol,cv CPV,FW,Estoril,20,2001,3.4,6,3,2,2,2,2,3,66.7,1,1,0,1,0,6,6,0,Matches
Beni,ao ANG,MF,Casa Pia,20,2002,10.4,31,19,12,17,2,17,35,48.6,18,7,2,5,15,46,8,0,Matches
Benny,pt POR,"FW,MF",Chaves,22,2000,13.6,14,8,6,5,3,6,16,37.5,10,16,0,16,4,18,11,0,Matches
Berna,ao ANG,MF,Boavista,18,2003,0.1,0,0,0,0,0,0,0,,0,0,0,0,0,0,0,0,Matches
Paulo Bernardo,pt POR,MF,Paços,20,2002,8.4,28,12,9,14,5,14,26,53.8,12,7,0,7,6,34,7,1,Matches
Celton Biai,pt POR,GK,Vitória,21,2000,5.0,0,0,0,0,0,0,0,,0,0,0,0,0,0,4,0,Matches
Pedro Bicalho,br BRA,"MF,FW",Santa Clara,21,2001,2.1,4,3,1,3,0,3,6,50.0,3,2,0,2,5,9,1,0,Matches
Emmanuel Boateng,gh GHA,"FW,MF",Rio Ave,26,1996,20.7,12,6,5,4,3,4,9,44.4,5,10,1,9,4,16,11,0,Matches
Kennedy Boateng,tg TOG,DF,Santa Clara,25,1996,25.7,41,30,27,11,3,16,29,55.2,13,25,16,9,34,75,136,1,Matches
Victor Bobsin,br BRA,MF,Santa Clara,22,2000,17.9,27,19,12,14,1,16,39,41.0,23,18,7,11,24,51,27,0,Matches
Bolgado,br BRA,DF,Casa Pia,23,1998,5.4,12,6,6,5,1,6,8,75.0,2,9,5,4,9,21,36,0,Matches
Kiko Bondoso,pt POR,"FW,MF",Vizela,26,1995,31.6,35,21,11,15,9,19,44,43.2,25,20,1,19,12,47,7,1,Matches
Gonçalo Borges,pt POR,"FW,MF",Porto,21,2001,1.3,3,3,2,1,0,2,2,100.0,0,1,0,1,0,3,1,0,Matches
Cristian Borja,co COL,DF,Braga,29,1993,7.6,20,14,13,4,3,10,15,66.7,5,10,4,6,11,31,25,0,Matches
Róbert Boženík,sk SVK,FW,Boavista,22,1999,10.8,9,3,1,6,2,3,10,30.0,7,3,0,3,0,9,2,0,Matches
Rafael Bracalli,br BRA,GK,Boavista,41,1981,28.0,2,1,2,0,0,1,2,50.0,1,0,0,0,2,4,10,0,Matches

Pedro Brazão,pt POR,"MF,FW",Famalicão,19,2002,3.4,5,2,1,4,0,2,5,40.0,3,9,0,9,1,6,3,0,Matches
Yan Brice Eteki,cm CMR,MF,Casa Pia,24,1997,6.6,22,11,10,11,1,11,23,47.8,12,8,1,7,6,28,9,0,Matches
Rafael Brito,pt POR,"MF,DF",Marítimo,20,2002,7.1,22,11,7,13,2,13,23,56.5,10,12,3,9,10,32,8,0,Matches
John Brooks,us USA,"MF,DF",Benfica,29,1993,0.0,0,0,0,0,0,0,0,,0,0,0,0,0,0,0,0,Matches
Bruma,pt POR,"MF,FW",Braga,27,1994,11.3,23,15,9,8,6,11,21,52.4,10,10,0,10,8,31,6,0,Matches
Bruninho,br BRA,FW,Arouca,23,1999,2.5,6,2,1,5,0,3,7,42.9,4,6,0,6,4,10,1,0,Matches
Matheus Bueno,br BRA,MF,Gil Vicente FC,24,1998,6.2,9,5,5,4,0,7,13,53.8,6,5,3,2,6,15,2,0,Matches
André Bukia,cd COD,"FW,MF",Arouca,27,1995,11.4,11,6,4,6,1,6,16,37.5,10,8,0,8,4,15,1,0,Matches
Fabijan Buntić,hr CRO,GK,Vizela,25,1997,33.0,0,0,0,0,0,0,0,,0,1,0,1,0,0,19,2,Matches
Oriol Busquets,es ESP,MF,Arouca,23,1999,12.9,21,14,12,9,0,8,27,29.6,19,17,4,13,16,37,28,1,Matches
Adrián Butzke,es ESP,FW,Paços,23,1999,14.8,9,6,2,2,5,1,7,14.3,6,7,2,5,3,12,14,0,Matches
Jovane Cabral,cv CPV,MF,Sporting CP,24,1998,0.6,4,1,3,1,0,0,0,,0,1,0,1,0,4,0,0,Matches
Paulo Henrique Rodrigues Cabral,pt POR,DF,Santa Clara,25,1996,15.9,28,18,18,7,3,18,26,69.2,8,17,4,13,18,46,38,0,Matches
Jhonder Cádiz,ve VEN,FW,Famalicão,27,1995,14.7,6,5,2,2,2,2,9,22.2,7,4,2,2,3,9,22,0,Matches
Diogo Calila,pt POR,"DF,MF",Santa Clara,23,1998,7.2,15,10,6,8,1,8,11,72.7,3,4,0,4,9,24,11,1,Matches
Ibrahima Camará,gn GUI,MF,Boavista,23,1999,11.5,20,13,9,9,2,10,20,50.0,10,8,3,5,8,28,14,0,Matches
Francis Cann,gh GHA,FW,Vizela,24,1998,0.4,0,0,0,0,0,0,1,0.0,1,2,0,2,1,1,0,0,Matches
Reggie Cannon,us USA,DF,Boavista,24,1998,25.7,46,29,36,9,1,25,40,62.5,15,27,14,13,59,105,93,0,Matches
Fábio Cardoso,pt POR,DF,Porto,28,1994,13.7,7,3,4,2,1,3,7,42.9,4,8,5,3,12,19,47,0,Matches
Felippe Cardoso,br BRA,FW,Casa Pia,23,1998,5.6,2,1,0,1,1,2,6,33.3,4,1,0,1,2,4,7,0,Matches
Yago Cariello,br BRA,FW,Portimonense,23,1999,15.2,11,6,2,4,5,5,14,35.7,9,14,1,13,2,13,18,0,Matches
Carlinhos,br BRA,MF,Portimonense,28,1994,7.6,11,9,3,5,3,7,11,63.6,4,8,2,6,1,12,5,0,Matches
João Carlos,br BRA,FW,Estoril,27,1995,7.9,2,2,0,1,1,1,5,20.0,4,8,1,7,2,4,9,0,Matches
Luíz Carlos,br BRA,MF,Paços,37,1985,12.6,26,15,14,10,2,15,24,62.5,9,21,3,18,7,33,13,1,Matches
José Carlos Marafona,pt POR,GK,Paços,35,1987,15.8,0,0,0,0,0,0,1,0.0,1,0,0,0,1,1,4,2,Matches

Zé Carlos,pt POR,"MF,DF",Vitória,20,2001,9.5,27,12,19,5,3,15,29,51.7,14,17,1,16,20,47,15,0,Matches
Zé Carlos,pt POR,DF,Gil Vicente FC,24,1998,4.4,5,5,2,3,0,5,14,35.7,9,1,0,1,10,15,10,0,Matches
David Carmo,ao ANG,DF,Porto,23,1999,7.1,5,3,2,3,0,3,4,75.0,1,8,4,4,10,15,25,0,Matches
Marcelo Carné,br BRA,GK,Marítimo,32,1990,14.0,0,0,0,0,0,0,1,0.0,1,0,0,0,0,0,6,0,Matches
Carraça,pt POR,DF,Gil Vicente FC,29,1993,20.6,32,22,21,9,2,23,38,60.5,15,15,7,8,17,49,39,0,Matches
Anderson Carvalho,br BRA,MF,Santa Clara,32,1990,5.5,19,8,5,12,2,8,19,42.1,11,3,0,3,6,25,13,0,Matches
João Carvalho,pt POR,MF,Estoril,25,1997,25.6,53,33,24,26,3,25,53,47.2,28,34,10,24,16,69,12,2,Matches
Vitor Carvalho,br BRA,MF,Gil Vicente FC,25,1997,30.0,83,45,40,38,5,40,64,62.5,24,26,8,18,43,126,48,0,Matches
Cassiano,br BRA,FW,Estoril,33,1989,10.0,16,10,4,6,6,6,13,46.2,7,9,1,8,1,17,6,0,Matches
Moises Castillo,co COL,DF,Marítimo,21,2001,17.5,49,36,41,8,0,29,34,85.3,5,16,4,12,47,96,72,1,Matches
André Castro,pt POR,MF,Braga,34,1988,6.9,18,12,8,8,2,6,15,40.0,9,6,2,4,7,25,6,0,Matches
Geny Catamo,mz MOZ,"FW,MF",Marítimo,21,2001,3.8,6,2,0,3,3,2,4,50.0,2,4,0,4,2,8,1,0,Matches
César,br BRA,GK,Boavista,30,1992,5.0,0,0,0,0,0,0,0,,0,0,0,0,0,0,3,0,Matches
Kayky Chagas,br BRA,"MF,FW",Paços,19,2003,3.0,6,3,2,2,2,3,5,60.0,2,4,0,4,3,9,3,0,Matches
Youssef Chermiti,pt POR,FW,Sporting CP,18,2004,9.4,3,2,0,2,1,1,9,11.1,8,7,2,5,1,4,3,0,Matches
Fábio China,pt POR,"DF,MF",Marítimo,30,1992,4.4,16,12,8,7,1,7,8,87.5,1,6,3,3,7,23,6,0,Matches
Chiquinho,pt POR,MF,Benfica,27,1995,15.2,46,26,13,28,5,22,35,62.9,13,15,1,14,16,62,5,0,Matches
Clayton,br BRA,FW,Casa Pia,23,1999,13.2,11,5,1,8,2,5,15,33.3,10,3,0,3,4,15,10,0,Matches
Sebastián Coates,uy URU,DF,Sporting CP,31,1990,28.4,25,14,17,6,2,18,30,60.0,12,23,17,6,21,46,66,0,Matches
Dylan Collard,mu MRI,DF,Marítimo,22,2000,0.0,0,0,0,0,0,0,0,,0,0,0,0,0,0,1,0,Matches
Santiago Colombatto,ar ARG,MF,Famalicão,25,1997,29.0,59,42,22,31,6,31,68,45.6,37,29,4,25,32,91,32,0,Matches
Fábio Conceição,pt POR,"DF,MF",Rio Ave,21,2001,22.0,32,19,17,11,4,20,43,46.5,23,18,6,12,22,54,14,0,Matches
Rodrigo Conceição,pt POR,DF,Porto,22,2000,6.1,15,12,11,4,0,11,18,61.1,7,10,0,10,8,23,12,0,Matches
Sérgio Conceição,pt POR,"DF,FW",Portimonense,25,1996,1.3,2,2,2,0,0,1,3,33.3,2,3,1,2,0,2,2,0,Matches
Félix Correia,pt POR,FW,Marítimo,21,2001,8.4,15,9,2,8,5,8,15,53.3,7,4,0,4,3,18,1,0,Matches

João Pedro Araújo Correia,cv CPV,"DF,FW",Chaves,25,1996,19.9,24,13,18,5,1,10,22,45.5,12,23,10,13,19,43,53,0,Matches
Antonio Cortés,es ESP,FW,Vitória,22,2000,0.6,0,0,0,0,0,0,0,,0,0,0,0,0,0,0,0,Matches
Bruno Xavier Almeida Costa,pt POR,MF,Porto,25,1997,2.9,7,4,0,7,0,6,11,54.5,5,0,0,0,2,9,1,0,Matches
Diogo Costa,pt POR,GK,Porto,22,1999,33.0,0,0,0,0,0,0,1,0.0,1,1,0,1,0,0,17,4,Matches
Edgar Costa,pt POR,"FW,MF",Marítimo,35,1987,5.3,10,8,7,2,1,6,11,54.5,5,7,0,7,2,12,3,0,Matches
Gonçalo Costa,pt POR,"DF,FW",Portimonense,22,2000,2.6,7,4,4,2,1,2,7,28.6,5,3,0,3,7,14,3,0,Matches
Matheus Costa,br BRA,DF,Marítimo,27,1995,12.0,22,16,15,5,2,10,15,66.7,5,11,7,4,15,37,50,1,Matches
Murilo Costa,br BRA,FW,Gil Vicente FC,27,1994,24.2,18,7,7,8,3,6,26,23.1,20,22,0,22,16,34,16,1,Matches
Rui Costa,pt POR,MF,Santa Clara,26,1996,0.5,0,0,0,0,0,0,1,0.0,1,0,0,0,0,0,0,0,Matches
Tomás Costa Silva,pt POR,DF,Vizela,22,1999,13.1,45,28,32,10,3,29,44,65.9,15,19,5,14,22,67,46,0,Matches
Vitor Costa,br BRA,"DF,MF",Marítimo,28,1994,26.7,58,29,29,23,6,30,61,49.2,31,31,4,27,30,88,62,2,Matches
Costinha,pt POR,"DF,MF",Rio Ave,22,2000,31.1,106,63,49,49,8,60,102,58.8,42,76,16,60,40,146,81,0,Matches
Costinha,pt POR,"MF,FW",Santa Clara,29,1992,7.5,8,6,1,5,2,3,9,33.3,6,7,1,6,4,12,1,0,Matches
Sandro Cruz,ao ANG,"DF,FW",Chaves,21,2001,5.9,16,15,8,5,3,10,14,71.4,4,9,3,6,7,23,16,0,Matches
Cuca,cv CPV,MF,Casa Pia,31,1991,4.3,9,8,3,4,2,6,12,50.0,6,6,0,6,7,16,7,0,Matches
Lucas Cunha,br BRA,DF,Gil Vicente FC,25,1997,15.0,9,7,7,2,0,6,9,66.7,3,19,14,5,17,26,70,0,Matches
Oday Dabbagh,ps PLE,FW,Arouca,23,1998,10.2,3,1,0,2,1,1,3,33.3,2,5,0,5,6,9,8,0,Matches
Augusto Dabo,pt POR,"DF,FW",Boavista,18,2004,0.1,0,0,0,0,0,0,0,,0,0,0,0,0,0,0,0,Matches
Ignacio De Arruabarrena,uy URU,GK,Arouca,25,1997,30.0,3,1,3,0,0,2,2,100.0,0,2,0,2,0,3,15,2,Matches
Hernán De La Fuente,ar ARG,DF,Famalicão,25,1997,6.0,22,13,14,7,1,10,16,62.5,6,10,6,4,9,31,16,0,Matches
Dele,ng NGA,"FW,MF",Estoril,21,2001,0.9,1,0,1,0,0,0,2,0.0,2,1,0,1,0,1,0,0,Matches
Juan Delgado,cl CHI,DF,Paços,29,1993,29.9,58,35,27,21,10,37,73,50.7,36,23,4,19,24,82,54,2,Matches
Shaquil Delos,fr FRA,DF,Estoril,23,1999,4.6,11,8,7,2,2,6,8,75.0,2,6,2,4,4,15,6,0,Matches
Denílson,br BRA,FW,Famalicão,27,1995,4.0,4,2,4,0,0,1,2,50.0,1,2,2,0,1,5,14,0,Matches
Depú,ao ANG,"FW,MF",Gil Vicente FC,22,2000,0.9,2,0,0,1,1,0,1,0.0,1,0,0,0,1,3,3,0,Matches

Derick,br BRA,"MF,DF",Casa Pia,28,1993,16.0,28,18,17,10,1,20,42,47.6,22,26,6,20,16,44,44,0,Matches
Lamine Diaby,fr FRA,MF,Portimonense,25,1996,15.7,33,17,16,14,3,11,23,47.8,12,16,6,10,21,54,46,2,Matches
Ousmane Diomande,ci CIV,DF,Sporting CP,18,2003,9.8,22,13,12,10,0,10,19,52.6,9,6,4,2,11,33,24,3,Matches
Álvaro djaló,es ESP,"FW,MF",Braga,22,1999,7.1,15,7,7,4,4,5,26,19.2,21,11,0,11,5,20,10,0,Matches
Matchoi Djaló,pt POR,"MF,FW",Paços,19,2003,14.5,19,13,8,8,3,8,17,47.1,9,19,3,16,7,26,7,1,Matches
Mihai Dobre,ro ROU,"FW,DF",Famalicão,23,1998,10.4,23,16,17,4,2,15,30,50.0,15,10,1,9,3,26,9,0,Matches
Julian Draxler,de GER,"MF,FW",Benfica,28,1993,4.5,5,2,0,3,2,2,4,50.0,2,5,1,4,1,6,1,0,Matches
Edu,pt POR,MF,Chaves,20,2002,0.4,0,0,0,0,0,0,0,,0,0,0,0,2,2,1,1,Matches
Carlos Eduardo,br BRA,"FW,MF",Estoril,25,1996,8.0,18,7,10,6,2,12,35,34.3,23,7,3,4,8,26,9,0,Matches
Paulo Eduardo,br BRA,DF,Santa Clara,20,2002,5.3,7,5,5,2,0,5,8,62.5,3,4,3,1,6,13,28,0,Matches
Marcus Edwards,eng ENG,"FW,MF",Sporting CP,23,1998,25.0,14,10,5,5,4,5,29,17.2,24,7,0,7,5,19,2,0,Matches
Erison,br BRA,FW,Estoril,23,1999,7.6,3,0,1,1,1,1,3,33.3,2,4,0,4,0,3,6,0,Matches
Ricardo Esgaio,pt POR,"DF,MF",Sporting CP,29,1993,14.6,40,32,10,25,5,25,43,58.1,18,10,0,10,9,49,27,0,Matches
Tiago Esgaio,pt POR,DF,Arouca,26,1995,25.4,45,24,28,14,3,39,63,61.9,24,26,6,20,22,67,93,0,Matches
Dario Essugo,pt POR,MF,Sporting CP,17,2005,2.2,10,5,3,6,1,6,9,66.7,3,2,1,1,4,14,0,0,Matches
Gonçalo Esteves,pt POR,DF,Estoril,18,2004,2.0,4,1,3,1,0,3,3,100.0,0,3,0,3,2,6,3,0,Matches
Paulo Estrela Moreira,pt POR,MF,Portimonense,23,1999,16.8,39,19,10,28,1,15,39,38.5,24,25,5,20,35,74,28,0,Matches
Friday Etim,ng NGA,FW,Vizela,20,2002,4.9,6,3,1,3,2,4,4,100.0,0,3,0,3,4,10,2,0,Matches
Euller,br BRA,"FW,MF",Chaves,27,1995,11.8,21,13,8,10,3,13,31,41.9,18,12,2,10,10,31,8,0,Matches
Stephen Eustáquio,ca CAN,MF,Porto,25,1996,18.6,57,29,21,27,9,32,61,52.5,29,25,6,19,19,76,22,0,Matches
Evanilson,br BRA,FW,Porto,22,1999,15.0,15,12,2,6,7,6,13,46.2,7,14,1,13,5,20,5,0,Matches
Ewerton,br BRA,MF,Portimonense,29,1992,6.5,18,12,5,8,5,8,16,50.0,8,6,1,5,3,21,4,0,Matches
Fabiano,br BRA,DF,Braga,22,2000,10.7,37,32,13,17,7,15,21,71.4,6,16,3,13,17,54,17,0,Matches
Fábio,br BRA,"FW,MF",Paços,25,1997,3.0,0,0,0,0,0,0,2,0.0,2,1,1,0,0,0,7,0,Matches
Abdul Fatawu Issahaku,gh GHA,"DF,MF",Sporting CP,18,2004,1.3,1,0,0,1,0,0,4,0.0,4,1,0,1,2,3,1,0,Matches

Luiz Felipe,br BRA,GK,Vizela,25,1997,1.0,0,0,0,0,0,0,0,,0,0,0,0,0,0,3,0,Matches
Volnei Feltes,br BRA,DF,Estoril,22,2000,0.1,0,0,0,0,0,0,0,,0,0,0,0,2,2,1,0,Matches
Eduardo Fereira,ve VEN,"FW,MF",Casa Pia,21,2000,0.6,1,0,1,0,0,1,1,100.0,0,0,0,0,2,3,0,0,Matches
Erick Ferigra,ec ECU,DF,Paços,23,1999,12.9,9,4,9,0,0,3,9,33.3,6,16,9,7,13,22,50,0,Matches
Ivanildo Fernandes,cv CPV,DF,Vizela,26,1996,16.5,14,6,10,4,0,6,13,46.2,7,19,12,7,16,30,96,0,Matches
Jorge Filipe Oliveira Fernandes,pt POR,DF,Vitória,25,1997,2.3,2,1,2,0,0,0,0,,0,2,1,1,1,3,13,0,Matches
Mateus Fernandes,pt POR,MF,Sporting CP,18,2004,1.0,3,0,0,3,0,0,1,0.0,1,1,0,1,0,3,0,0,Matches
Patrick Fernandes,cv CPV,"FW,MF",Chaves,28,1993,0.6,0,0,0,0,0,0,0,,0,0,0,0,0,0,0,0,Matches
Rafael Fernandes,pt POR,"DF,FW",Arouca,20,2002,1.5,2,2,1,1,0,1,1,100.0,0,2,2,0,3,5,6,0,Matches
Rúben Fernandes,pt POR,DF,Gil Vicente FC,36,1986,24.2,15,8,9,5,1,9,26,34.6,17,35,19,16,37,52,89,0,Matches
Vasco Fernandes,pt POR,DF,Casa Pia,35,1986,27.5,23,12,16,7,0,10,19,52.6,9,49,35,14,33,56,114,2,Matches
Enzo Fernández,ar ARG,MF,Benfica,21,2001,15.4,40,17,15,19,6,23,44,52.3,21,16,3,13,15,55,3,2,Matches
Diogo Ferreira,pt POR,MF,Vitória,20,2001,0.0,0,0,0,0,0,0,0,,0,0,0,0,0,0,1,0,Matches
Filipe Ferreira,pt POR,"DF,MF",Boavista,31,1990,3.4,6,3,2,3,1,4,5,80.0,1,2,2,0,2,8,14,0,Matches
Fernando Ferreira Fonseca,pt POR,"DF,FW",Paços,25,1997,1.8,2,2,1,1,0,0,2,0.0,2,2,0,2,3,5,4,0,Matches
João Ferreira,pt POR,"DF,MF",Rio Ave,21,2001,1.8,6,6,2,3,1,1,3,33.3,2,3,1,2,1,7,2,1,Matches
Vitó Ferreira,pt POR,"MF,FW",Casa Pia,24,1997,0.8,1,1,0,0,1,0,1,0.0,1,0,0,0,0,1,2,0,Matches
Daniel Figueira,pt POR,GK,Estoril,24,1998,31.7,0,0,0,0,0,0,1,0.0,1,0,0,0,0,0,14,1,Matches
Bernardo Folha,pt POR,"MF,FW",Porto,20,2002,0.6,3,1,2,1,0,3,5,60.0,2,1,0,1,0,3,0,0,Matches
Tiago Fonseca Morais,pt POR,FW,Boavista,18,2003,0.3,3,2,1,1,1,3,3,100.0,0,0,0,0,1,4,0,0,Matches
Théo Fonseca,fr FRA,"MF,FW",Famalicão,22,2000,1.2,0,0,0,0,0,0,1,0.0,1,3,1,2,2,2,3,0,Matches
Rui Fonte,pt POR,"FW,MF",Famalicão,32,1990,5.1,6,4,1,4,1,2,2,100.0,0,6,0,6,1,7,3,0,Matches
Hernâni Fortes,pt POR,"FW,MF",Rio Ave,30,1991,7.5,4,2,3,1,0,1,5,20.0,4,5,1,4,1,5,4,0,Matches
André Franco,pt POR,"MF,FW",Porto,24,1998,7.7,11,7,2,6,3,4,14,28.6,10,3,1,2,5,16,4,0,Matches
Afonso freitas,pt POR,"DF,MF",Vitória,22,2000,21.4,28,19,15,11,2,17,28,60.7,11,16,8,8,18,46,49,0,Matches

Kanya Fujimoto,jp JPN,MF,Gil Vicente FC,23,1999,29.1,38,25,7,21,10,13,24,54.2,11,18,2,16,19,57,1,0,Matches
Nicolás Gaitán,ar ARG,"FW,MF",Paços,34,1988,19.9,20,12,9,6,5,9,36,25.0,27,17,2,15,12,32,21,0,Matches
Galeno,br BRA,"MF,FW",Porto,24,1997,22.2,28,16,9,7,12,14,28,50.0,14,21,3,18,21,49,25,0,Matches
Nino Galović,hr CRO,DF,Arouca,30,1992,14.5,13,10,11,2,0,7,8,87.5,1,14,13,1,16,29,66,0,Matches
João Gamboa,pt POR,MF,Estoril,25,1996,11.6,16,9,5,9,2,7,21,33.3,14,19,10,9,14,30,21,1,Matches
Pedro Ganchas,pt POR,DF,Paços,22,2000,3.0,4,3,2,2,0,3,7,42.9,4,5,4,1,1,5,9,0,Matches
Bruno Gaspar,ao ANG,"DF,MF",Vitória,29,1993,2.4,9,6,6,2,1,2,3,66.7,1,1,1,0,4,13,5,0,Matches
Francisco Geraldes,pt POR,MF,Estoril,27,1995,20.3,29,19,10,16,3,11,29,37.9,18,13,2,11,21,50,7,1,Matches
Gilberto,br BRA,DF,Benfica,29,1993,8.9,23,14,10,10,3,15,26,57.7,11,12,2,10,11,34,13,0,Matches
Saviour Godwin,ng NGA,"FW,MF",Casa Pia,25,1996,26.7,29,15,10,13,6,13,36,36.1,23,19,1,18,13,42,7,0,Matches
Eulânio Ângelo Chipela Gomes,gw GNB,DF,Santa Clara,28,1994,6.4,11,8,5,1,5,5,6,83.3,1,8,1,7,4,15,9,0,Matches
Henrique Gomes,pt POR,DF,Gil Vicente FC,26,1995,5.3,9,4,8,0,1,4,9,44.4,5,8,2,6,4,13,18,0,Matches
Nito Gomes,gw GNB,MF,Marítimo,20,2002,0.8,1,1,0,1,0,1,1,100.0,0,0,0,0,1,2,4,0,Matches
Rodrigo Gomes,pt POR,"FW,MF",Braga,19,2003,3.8,10,9,4,3,3,3,9,33.3,6,3,0,3,3,13,3,0,Matches
Rui Gomes,pt POR,"MF,FW",Portimonense,24,1997,11.9,17,9,6,8,3,10,24,41.7,14,14,1,13,10,27,9,0,Matches
Vítor Gomes,pt POR,MF,Rio Ave,34,1987,8.4,11,6,4,6,1,3,6,50.0,3,4,0,4,6,17,17,1,Matches
Victor Gomez,es ESP,DF,Braga,22,2000,22.9,32,16,18,11,3,21,40,52.5,19,21,5,16,16,48,39,0,Matches
Nuno Gonçalo Moreira,pt POR,"FW,MF",Vizela,23,1999,20.4,24,16,12,7,5,13,32,40.6,19,20,4,16,24,48,28,0,Matches
Diogo Gonçalves,pt POR,FW,Benfica,25,1997,3.4,6,6,1,3,2,2,4,50.0,2,4,0,4,1,7,1,0,Matches
João Gonçalves,pt POR,GK,Boavista,21,2000,1.0,0,0,0,0,0,0,0,,0,0,0,0,0,0,1,1,Matches
Pedro Gonçalves,pt POR,"MF,FW",Sporting CP,24,1998,31.2,59,36,13,38,8,23,53,43.4,30,22,4,18,21,80,6,0,Matches
Cristian González,uy URU,DF,Santa Clara,26,1996,11.7,22,16,15,5,2,8,10,80.0,2,19,11,8,20,42,57,1,Matches
Walter González,py PAR,FW,Santa Clara,27,1995,4.4,0,0,0,0,0,0,1,0.0,1,1,0,1,1,1,7,0,Matches
Yony González,co COL,"FW,MF",Portimonense,28,1994,10.8,12,10,6,5,1,3,9,33.3,6,9,2,7,4,16,12,0,Matches
Jean Gorby,fr FRA,MF,Braga,20,2002,1.3,3,2,1,0,2,3,8,37.5,5,3,0,3,2,5,1,0,Matches

Kenji Gorré,cw CUW,"FW,MF",Boavista,27,1994,16.4,15,6,7,6,2,6,16,37.5,10,18,0,18,11,26,4,0,Matches
Tiago Gouveia,pt POR,"FW,MF",Estoril,21,2001,26.5,45,25,17,17,11,25,49,51.0,24,18,1,17,15,60,20,0,Matches
João Graça,pt POR,"MF,FW",Rio Ave,27,1995,12.8,22,17,7,10,5,9,32,28.1,23,19,4,15,8,30,5,1,Matches
Álex Grimaldo,es ESP,DF,Benfica,26,1995,32.7,74,46,26,31,17,50,89,56.2,39,27,1,26,40,114,26,0,Matches
Marko Grujić,rs SRB,MF,Porto,26,1996,12.5,42,21,16,23,3,22,32,68.8,10,17,4,13,23,65,28,0,Matches
Alexandre Guedes,pt POR,FW,Paços,28,1994,8.8,7,5,3,2,2,2,7,28.6,5,2,2,0,2,9,6,0,Matches
Gonçalo Guedes,pt POR,"FW,MF",Benfica,25,1996,4.5,7,2,1,5,1,2,2,100.0,0,7,0,7,1,8,1,0,Matches
Ricardo Guimarães,mz MOZ,MF,Chaves,26,1995,21.8,49,29,21,25,3,27,79,34.2,52,40,10,30,31,80,34,1,Matches
Rafik Guitane,fr FRA,"MF,FW",Estoril,23,1999,8.7,7,6,2,4,1,4,12,33.3,8,10,1,9,3,10,2,0,Matches
Raphael Guzzo,pt POR,MF,Vizela,27,1995,26.2,63,32,22,34,7,32,59,54.2,27,33,10,23,34,97,26,0,Matches
Emmanuel Hackman,tg TOG,DF,Gil Vicente FC,27,1995,1.5,1,1,0,1,0,0,2,0.0,2,3,2,1,1,2,3,0,Matches
Yanis Hamache,dz ALG,MF,Boavista,23,1999,2.0,2,1,1,1,0,0,2,0.0,2,2,0,2,1,3,8,0,Matches
Tomás Händel,pt POR,MF,Vitória,21,2000,4.8,12,9,9,3,0,7,15,46.7,8,3,0,3,6,18,3,0,Matches
Boubacar Hanne,pt POR,"FW,DF",Gil Vicente FC,23,1999,0.4,0,0,0,0,0,0,0,,0,0,0,0,0,0,0,0,Matches
Héctor,es ESP,FW,Chaves,26,1995,16.4,4,2,0,4,0,0,12,0.0,12,9,4,5,2,6,17,0,Matches
Jordan Holsgrove,sct SCO,MF,Paços,22,1999,19.8,37,20,14,20,3,19,51,37.3,32,24,3,21,25,62,13,0,Matches
Lukáš Horníček,cz CZE,GK,Braga,20,2002,0.2,0,0,0,0,0,0,0,,0,0,0,0,0,0,0,0,Matches
André Horta,pt POR,MF,Braga,25,1996,23.1,37,23,14,17,6,22,54,40.7,32,24,7,17,13,50,12,1,Matches
Ricardo Horta,pt POR,"MF,FW",Braga,27,1994,29.0,35,16,7,17,11,19,49,38.8,30,25,2,23,12,47,14,0,Matches
Abbas Ibrahim,ng NGA,"MF,DF",Paços,24,1998,3.6,6,4,3,3,0,4,7,57.1,3,7,2,5,4,10,3,2,Matches
Tiago Ilori,pt POR,DF,Paços,29,1993,2.3,0,0,0,0,0,0,1,0.0,1,1,0,1,1,1,9,0,Matches
Gonçalo Inácio,pt POR,DF,Sporting CP,20,2001,26.3,39,23,24,15,0,23,41,56.1,18,25,11,14,45,84,66,3,Matches
Índio,br BRA,MF,Vitória,22,1999,0.8,1,0,1,0,0,1,2,50.0,1,0,0,0,1,2,3,0,Matches
Hernani Infande,pt POR,"MF,FW",Braga,21,2001,0.9,2,2,2,0,0,1,2,50.0,1,1,0,1,0,2,2,0,Matches
Hernani Infande,pt POR,"FW,MF",Paços,21,2001,3.9,7,5,5,1,1,2,6,33.3,4,3,0,3,1,8,1,0,Matches

Carlos Isaac,es ESP,DF,Vizela,24,1998,3.9,12,7,3,7,2,11,11,100.0,0,3,2,1,5,17,14,0,Matches
Franco Israel,uy URU,GK,Sporting CP,22,2000,3.0,0,0,0,0,0,0,0,,0,0,0,0,0,0,0,0,Matches
Abass Issah,gh GHA,"FW,MF",Chaves,23,1998,15.2,16,7,7,5,4,8,24,33.3,16,9,0,9,8,24,7,0,Matches
Ítalo,br BRA,DF,Santa Clara,20,2002,11.9,15,7,10,5,0,11,13,84.6,2,17,9,8,10,25,66,0,Matches
Ivan Jaime Pajuelo,es ESP,"FW,MF",Famalicão,21,2000,20.8,20,8,8,9,3,9,26,34.6,17,16,0,16,11,31,6,0,Matches
Nicolas Janvier,fr FRA,MF,Vitória,23,1998,7.0,16,11,8,8,0,6,13,46.2,7,9,1,8,6,22,2,0,Matches
Anderson Jesus,br BRA,DF,Vizela,27,1995,29.6,31,20,22,9,0,9,17,52.9,8,28,20,8,37,68,168,1,Matches
Jhonatan,br BRA,GK,Rio Ave,31,1991,32.0,1,0,1,0,0,1,3,33.3,2,0,0,0,0,1,9,6,Matches
Park Ji-soo,kr KOR,DF,Portimonense,28,1994,13.3,26,20,14,11,1,14,19,73.7,5,15,10,5,6,32,54,1,Matches
Jo,br BRA,"FW,MF",Chaves,27,1995,3.3,4,3,1,2,1,3,6,50.0,3,5,1,4,2,6,9,0,Matches
João,br BRA,GK,Casa Pia,24,1998,1.0,0,0,0,0,0,0,0,,0,0,0,0,0,0,1,0,Matches
Joãozinho,pt POR,DF,Estoril,33,1989,28.6,36,27,16,16,4,19,31,61.3,12,29,14,15,16,52,63,0,Matches
Joca,pt POR,"MF,FW",Rio Ave,26,1996,4.6,3,1,2,1,0,2,4,50.0,2,3,0,3,3,6,0,0,Matches
Henrique Jocú,pt POR,"MF,FW",Portimonense,20,2001,5.1,13,5,5,8,0,4,15,26.7,11,6,3,3,7,20,5,0,Matches
Diederrick Joel,cm CMR,FW,Marítimo,28,1993,10.5,6,1,2,4,0,1,3,33.3,2,7,0,7,2,8,4,0,Matches
Michael Johnston,ie IRL,"FW,MF",Vitória,23,1999,15.2,11,8,2,4,5,3,19,15.8,16,11,2,9,5,16,5,0,Matches
Bruno Jordão,pt POR,MF,Santa Clara,23,1998,9.4,13,11,6,6,1,6,22,27.3,16,10,1,9,12,25,7,0,Matches
Igor Julião,br BRA,DF,Vizela,27,1994,17.9,29,21,20,6,3,17,23,73.9,6,7,2,5,22,51,40,0,Matches
Juninho,br BRA,FW,Chaves,25,1996,20.1,20,15,4,14,2,9,23,39.1,14,12,3,9,12,32,12,0,Matches
Luiz Lúcio Reis Júnior,br BRA,GK,Famalicão,21,2001,33.0,0,0,0,0,0,0,4,0.0,4,0,0,0,0,0,20,2,Matches
Welinton Júnior,br BRA,FW,Portimonense,29,1993,22.9,18,7,2,11,5,5,27,18.5,22,10,0,10,6,24,7,1,Matches
Zainadine Júnior,mz MOZ,DF,Marítimo,34,1988,23.1,23,13,13,8,2,13,18,72.2,5,22,18,4,33,56,73,1,Matches
Junior Kadile,fr FRA,"FW,MF",Famalicão,19,2002,7.4,18,10,9,7,2,4,15,26.7,11,5,0,5,3,21,5,0,Matches
Stanley Kanu,ng NGA,"FW,DF",Marítimo,23,1999,0.8,1,1,0,1,0,0,1,0.0,1,1,0,1,0,1,0,0,Matches
Jorge Karse,pt POR,"MF,DF",Rio Ave,17,2005,0.2,0,0,0,0,0,0,1,0.0,1,0,0,0,0,0,0,0,Matches

Francisco Kiki,pt POR,MF,Casa Pia,24,1998,0.1,0,0,0,0,0,0,0,,0,2,0,2,0,0,0,0,Matches
Gustavo Klismahn,br BRA,MF,Portimonense,22,1999,7.8,15,8,3,9,3,2,8,25.0,6,11,1,10,3,18,8,1,Matches
Philippe Koffi,ci CIV,FW,Paços,20,2002,7.4,9,3,6,1,2,7,9,77.8,2,0,0,0,2,11,3,0,Matches
Stanislav Kritsyuk,ru RUS,GK,Gil Vicente FC,31,1990,10.3,1,1,1,0,0,1,1,100.0,0,0,0,0,0,1,6,0,Matches
Takahiro Kunimoto,jp JPN,"FW,MF",Casa Pia,24,1997,14.1,14,8,5,8,1,9,31,29.0,22,22,0,22,9,23,7,0,Matches
Matías Lacava,ve VEN,"FW,MF",Vizela,19,2002,3.9,7,4,2,4,1,1,7,14.3,6,5,0,5,1,8,1,0,Matches
Diego Lainez,mx MEX,MF,Braga,22,2000,1.7,3,2,0,3,0,1,2,50.0,1,0,0,0,1,4,0,0,Matches
Chico Lamba,pt POR,DF,Sporting CP,19,2003,0.5,0,0,0,0,0,0,0,,0,0,0,0,0,0,0,0,Matches
Rúben Lameiras,pt POR,"FW,MF",Vitória,27,1994,12.6,15,9,6,5,4,7,17,41.2,10,5,0,5,3,18,4,0,Matches
Bruno Langa,mz MOZ,DF,Chaves,24,1997,27.5,35,25,22,6,7,16,29,55.2,13,35,10,25,31,66,74,0,Matches
Yusuf Lawal,ng NGA,"MF,FW",Arouca,24,1998,0.9,5,4,2,2,1,1,3,33.3,2,1,1,0,0,5,2,0,Matches
James Lea Siliki,cm CMR,"MF,FW",Estoril,26,1996,8.9,15,12,7,7,1,7,11,63.6,4,9,2,7,9,24,4,0,Matches
Leonardo Lelo,pt POR,"MF,DF",Casa Pia,22,2000,25.4,40,17,23,16,1,24,53,45.3,29,29,3,26,37,77,46,0,Matches
Nuno Lima,pt POR,DF,Paços,21,2001,27.2,26,17,20,5,1,12,23,52.2,11,38,24,14,40,66,112,0,Matches
Rúben Lima,pt POR,DF,Famalicão,32,1989,13.2,17,10,11,6,0,4,9,44.4,5,21,8,13,32,49,48,0,Matches
Percy Liza,pe PER,"FW,MF",Marítimo,22,2000,4.7,5,4,1,3,1,2,3,66.7,1,2,1,1,0,5,4,0,Matches
Danny Loader,eng ENG,"FW,MF",Porto,21,2000,5.0,8,6,4,2,2,2,6,33.3,4,4,0,4,2,10,4,0,Matches
Julien Lomboto,,MF,Rio Ave,20,2002,0.1,2,0,2,0,0,0,0,,0,0,0,0,0,2,0,0,Matches
Né lopes,pt POR,DF,Gil Vicente FC,22,2000,5.0,2,2,1,1,0,1,2,50.0,1,13,12,1,6,8,11,0,Matches
Bruno Lourenço,pt POR,"MF,FW",Boavista,24,1998,20.9,33,19,15,13,5,16,41,39.0,25,21,1,20,14,47,8,0,Matches
Lucão,br BRA,DF,Portimonense,30,1992,5.9,6,4,5,0,1,4,5,80.0,1,4,4,0,3,9,22,0,Matches
Florentino Luís,pt POR,MF,Benfica,22,1999,23.6,82,45,29,37,16,46,66,69.7,20,26,1,25,63,145,27,0,Matches
José Luis Rodríguez,pa PAN,"FW,MF",Famalicão,24,1998,5.6,4,1,2,0,2,2,4,50.0,2,3,1,2,1,5,2,0,Matches
Luquinha,br BRA,"MF,FW",Portimonense,21,2000,13.0,17,12,9,2,6,8,18,44.4,10,21,2,19,1,18,3,0,Matches
Tiago Machado,pt POR,"MF,FW",Boavista,18,2004,0.1,0,0,0,0,0,0,0,,0,1,0,1,0,0,0,0,Matches

Miguel Maga,pt POR,"DF,MF",Vitória,19,2002,2.2,65,38,45,11,9,45,72,62.5,27,36,8,28,40,105,52,0,Matches
Magrão,br BRA,GK,Rio Ave,22,2000,2.0,0,0,0,0,0,0,0,,0,0,0,0,0,0,3,0,Matches
Giorgi Makaridze,ge GEO,GK,Marítimo,32,1990,6.0,1,0,1,0,0,1,1,100.0,0,0,0,0,0,1,3,0,Matches
Gaius Makouta,cg CGO,MF,Boavista,25,1997,30.4,37,19,13,22,2,15,36,41.7,21,19,5,14,40,77,45,0,Matches
Pedro Malheiro,pt POR,"DF,MF",Boavista,21,2001,31.0,94,55,60,30,4,47,78,60.3,31,42,4,38,37,131,66,0,Matches
Wilson Manafá,pt POR,DF,Porto,28,1994,3.4,3,3,2,1,0,2,3,66.7,1,7,1,6,3,6,6,0,Matches
Ricardo Mangas,pt POR,"MF,FW",Boavista,24,1998,20.6,15,6,8,5,2,7,19,36.8,12,5,1,4,14,29,25,0,Matches
Manuel Manu,pt POR,DF,Vitória,21,2001,0.8,2,1,2,0,0,0,0,,0,0,0,0,0,2,0,0,Matches
Juan Manuel Boselli,uy URU,FW,Gil Vicente FC,22,1999,13.8,27,19,12,11,4,14,39,35.9,25,27,0,27,9,36,14,0,Matches
José Manuel Velázquez,ve VEN,"DF,MF",Arouca,31,1990,0.1,0,0,0,0,0,0,0,,0,0,0,0,0,0,4,0,Matches
Zé Manuel,pt POR,FW,Rio Ave,31,1990,0.3,2,1,2,0,0,0,0,,0,0,0,0,0,2,0,0,Matches
Maracás,br BRA,DF,Paços,28,1994,15.8,20,13,17,3,0,10,18,55.6,8,19,12,7,21,41,69,0,Matches
Iván Marcano,es ESP,DF,Porto,35,1987,24.4,18,11,14,4,0,8,18,44.4,10,24,16,8,27,45,66,1,Matches
Joao Marcos,br BRA,"FW,MF",Santa Clara,22,2000,1.8,2,1,0,1,1,0,1,0.0,1,0,0,0,0,2,0,0,Matches
Abraham Marcus,ng NGA,FW,Porto,22,2000,0.0,0,0,0,0,0,0,0,,0,0,0,0,0,0,0,0,Matches
Adrián Marín,es ESP,DF,Gil Vicente FC,25,1997,28.6,63,38,37,20,6,35,54,64.8,19,30,5,25,31,94,78,0,Matches
João Mário,pt POR,FW,Benfica,29,1993,29.4,45,28,9,26,10,17,49,34.7,32,40,1,39,11,56,12,0,Matches
João Mário Lopes,pt POR,DF,Porto,22,2000,13.2,26,11,13,6,7,15,33,45.5,18,8,0,8,10,36,14,0,Matches
Marlon,br BRA,FW,Gil Vicente FC,24,1997,4.2,7,4,5,0,2,6,13,46.2,7,11,0,11,2,9,1,0,Matches
Alejandro Marqués,ve VEN,FW,Estoril,21,2000,7.3,5,4,0,4,1,1,5,20.0,4,6,3,3,3,8,6,0,Matches
João Marques,pt POR,MF,Estoril,20,2002,4.3,7,2,5,2,0,2,6,33.3,4,6,0,6,0,7,2,0,Matches
Rúben Marques,pt POR,FW,Marítimo,19,2002,0.7,0,0,0,0,0,0,1,0.0,1,0,0,0,0,0,0,0,Matches
José Marsà,es ESP,DF,Sporting CP,20,2002,1.3,0,0,0,0,0,0,0,,0,2,1,1,3,3,1,0,Matches
Toni Martínez,es ESP,FW,Porto,25,1997,12.8,21,12,3,5,13,8,12,66.7,4,10,0,10,2,23,3,0,Matches
Rafael Martins,br BRA,FW,Casa Pia,33,1989,15.9,8,4,1,5,2,0,4,0.0,4,13,0,13,0,8,15,0,Matches

Rodrigo Martins,pt POR,"FW,MF",Estoril,23,1998,15.4,16,8,5,8,3,8,22,36.4,14,8,1,7,4,20,10,0,Matches
Matheus,br BRA,GK,Braga,30,1992,31.9,2,0,2,0,0,2,4,50.0,2,0,0,0,1,3,19,1,Matches
Ricardo Matos,pt POR,"FW,MF",Portimonense,22,2000,3.3,2,2,1,0,1,1,2,50.0,1,0,0,0,0,2,1,0,Matches
Maurício,br BRA,MF,Portimonense,33,1988,11.0,22,16,6,14,2,10,27,37.0,17,16,4,12,15,37,11,0,Matches
Iuri Medeiros,pt POR,"MF,FW",Braga,28,1994,22.9,24,11,7,14,3,12,32,37.5,20,21,1,20,6,30,8,0,Matches
Kevin Medina,es ESP,"FW,MF",Gil Vicente FC,21,2001,8.2,26,17,9,10,7,15,30,50.0,15,9,2,7,4,30,5,1,Matches
Mauro Meireles Couto,pt POR,"MF,FW",Paços,16,2005,1.4,1,1,1,0,0,0,1,0.0,1,2,0,2,0,1,2,0,Matches
Diogo Mendes,cv CPV,MF,Marítimo,24,1998,13.7,33,16,12,19,2,20,32,62.5,12,19,1,18,8,41,14,0,Matches
João Mendes,pt POR,MF,Chaves,27,1994,25.9,34,18,10,16,8,18,47,38.3,29,24,0,24,17,51,6,0,Matches
Joe Mendes,se SWE,"DF,MF",Braga,19,2002,2.1,1,0,0,1,0,0,1,0.0,1,3,0,3,6,7,4,0,Matches
Alex Mendez,us USA,"MF,FW",Vizela,21,2000,15.8,40,18,14,19,7,14,29,48.3,15,13,1,12,16,56,15,0,Matches
Bruno Messi,pt POR,"MF,FW",Santa Clara,25,1996,14.0,18,6,8,9,1,6,27,22.2,21,27,3,24,8,26,10,1,Matches
Mexer,mz MOZ,DF,Estoril,33,1988,10.8,11,5,9,2,0,7,9,77.8,2,9,7,2,12,23,32,0,Matches
Benji Michel,us USA,FW,Arouca,24,1997,3.1,1,1,0,1,0,0,1,0.0,1,2,0,2,1,2,10,0,Matches
Enea Mihaj,al ALB,DF,Famalicão,24,1998,24.7,23,11,18,4,1,12,25,48.0,13,29,22,7,32,55,91,0,Matches
Álex Millán,es ESP,FW,Famalicão,22,1999,8.6,6,2,1,1,4,4,9,44.4,5,6,1,5,0,6,6,0,Matches
Bogdan Milovanov,ua UKR,DF,Arouca,24,1998,11.0,38,22,22,11,5,22,35,62.9,13,12,2,10,18,56,54,0,Matches
Kento Misao,jp JPN,MF,Santa Clara,26,1996,11.7,30,17,12,16,2,12,27,44.4,15,19,9,10,16,46,13,0,Matches
Zié Mohamed Ouattara,ci CIV,"FW,MF",Portimonense,22,2000,12.9,28,16,15,12,1,11,18,61.1,7,18,3,15,14,42,22,0,Matches
Jonathan Monroy,es ESP,"FW,MF",Chaves,20,2001,7.4,16,10,9,6,1,11,23,47.8,12,8,2,6,7,23,5,0,Matches
Nélson Monte,pt POR,DF,Chaves,27,1995,28.7,34,23,25,8,1,23,43,53.5,20,41,24,17,55,89,150,0,Matches
Miguel Monteiro,pt POR,FW,Gil Vicente FC,19,2003,0.1,0,0,0,0,0,0,0,,0,0,0,0,0,0,0,0,Matches
Morato,br BRA,DF,Benfica,21,2001,7.2,9,7,6,2,1,3,5,60.0,2,5,3,2,7,16,19,0,Matches
Pablo Moreno,es ESP,"FW,MF",Marítimo,20,2002,9.9,16,9,6,5,5,7,18,38.9,11,7,0,7,2,18,1,0,Matches
Hélder Morim,pt POR,"MF,FW",Chaves,21,2001,1.0,4,2,3,1,0,3,5,60.0,2,5,0,5,1,5,1,0,Matches

Hidemasa Morita,jp JPN,MF,Sporting CP,27,1995,21.8,50,33,13,29,8,21,32,65.6,11,27,5,22,26,76,18,0,Matches
Mosquito,br BRA,GK,Arouca,26,1996,1.0,0,0,0,0,0,0,0,,0,0,0,0,0,0,1,0,Matches
Fahd Moufi,ma MAR,DF,Portimonense,26,1996,29.3,29,19,16,11,2,17,28,60.7,11,46,17,29,45,74,69,0,Matches
Moura,pt POR,DF,Famalicão,22,1999,23.6,31,16,11,16,4,15,28,53.6,13,35,9,26,27,58,71,0,Matches
Rodrigo Moura,br BRA,GK,Chaves,26,1996,4.0,0,0,0,0,0,0,0,,0,1,0,1,0,0,2,0,Matches
MT,br BRA,"DF,MF",Santa Clara,21,2001,12.6,29,15,15,10,4,21,37,56.8,16,13,3,10,13,42,37,1,Matches
Rafa Mújica,es ESP,FW,Arouca,23,1998,18.1,23,19,3,12,8,2,10,20.0,8,19,1,18,2,25,28,0,Matches
Petar Musa,hr CRO,FW,Benfica,24,1998,7.4,12,9,1,4,7,4,11,36.4,7,5,3,2,7,19,3,0,Matches
Almoatasem Al Musrati,ly LBY,MF,Braga,26,1996,25.7,66,34,23,35,8,29,63,46.0,34,44,13,31,57,123,26,0,Matches
Kosuke Nakamura,jp JPN,GK,Portimonense,27,1995,30.0,1,1,1,0,0,1,3,33.3,2,0,0,0,0,1,24,2,Matches
Léo Natel,br BRA,FW,Casa Pia,25,1997,0.6,0,0,0,0,0,0,0,,0,0,0,0,0,0,1,0,Matches
Fran Navarro,es ESP,FW,Gil Vicente FC,24,1998,33.7,23,12,1,16,6,8,31,25.8,23,24,3,21,3,26,7,0,Matches
Flávio Nazinho,pt POR,DF,Sporting CP,19,2003,1.1,3,2,2,1,0,2,3,66.7,1,1,1,0,0,3,2,0,Matches
Mor Ndiaye,sn SEN,MF,Estoril,21,2000,15.6,32,21,14,16,2,21,29,72.4,8,19,10,9,13,45,63,2,Matches
Cher Ndour,it ITA,MF,Benfica,18,2004,0.0,0,0,0,0,0,0,0,,0,0,0,0,0,0,0,0,Matches
Christian Neiva Afonso,pt POR,DF,Vizela,27,1994,24.7,46,34,27,15,4,24,38,63.2,14,23,13,10,46,92,79,0,Matches
Nelson,ao ANG,"FW,MF",Vitória,24,1998,12.9,29,20,11,12,6,6,12,50.0,6,12,0,12,15,44,17,0,Matches
David Neres,br BRA,"FW,MF",Benfica,25,1997,21.8,21,8,5,10,6,10,27,37.0,17,11,0,11,3,24,1,0,Matches
Neto,br BRA,MF,Casa Pia,30,1991,17.0,33,18,17,14,2,15,52,28.8,37,20,4,16,28,61,20,1,Matches
Luís Neto,pt POR,DF,Sporting CP,34,1988,3.0,6,3,4,2,0,4,5,80.0,1,2,1,1,1,7,6,0,Matches
João Neves,pt POR,"MF,FW",Benfica,17,2004,6.8,26,19,14,9,3,13,26,50.0,13,15,3,12,9,35,5,0,Matches
Sikou Niakaté,ml MLI,DF,Braga,23,1999,23.6,22,10,11,10,1,13,25,52.0,12,24,11,13,49,71,93,0,Matches
Yusupha Njie,gm GAM,FW,Boavista,28,1994,23.6,25,16,3,14,8,4,18,22.2,14,22,5,17,8,33,17,0,Matches
Miguel Nóbrega,pt POR,DF,Rio Ave,22,2000,6.2,8,5,4,3,1,5,8,62.5,3,10,6,4,4,12,28,0,Matches
Gonçalo Nogueira,pt POR,MF,Vitória,18,2003,0.2,0,0,0,0,0,0,0,,0,0,0,0,0,0,1,0,Matches

Ygor Nogueira,br BRA,DF,Santa Clara,27,1995,11.3,18,10,13,4,1,10,15,66.7,5,17,11,6,18,36,49,1,Matches
Nonoca,br BRA,MF,Portimonense,24,1998,6.3,13,11,6,6,1,5,12,41.7,7,13,3,10,2,15,2,1,Matches
Arsénio Martins Lafuente Nunes,pt POR,"FW,MF",Arouca,32,1989,10.8,7,4,5,1,1,4,13,30.8,9,13,2,11,2,9,10,0,Matches
João Nunes,pt POR,DF,Casa Pia,26,1995,18.3,37,21,29,8,0,26,38,68.4,12,31,18,13,24,61,79,0,Matches
Matheus Nunes,pt POR,MF,Sporting CP,23,1998,2.0,2,2,0,2,0,1,1,100.0,0,3,0,3,3,5,0,0,Matches
Nwankwo Obiora,ng NGA,MF,Chaves,31,1991,6.9,12,8,6,6,0,8,14,57.1,6,8,2,6,8,20,11,0,Matches
Ryoya Ogawa,jp JPN,"DF,MF",Vitória,25,1996,2.3,2,0,2,0,0,0,2,0.0,2,2,0,2,3,5,5,0,Matches
Hugo Oliveira,pt POR,DF,Vizela,20,2002,0.1,0,0,0,0,0,0,0,,0,0,0,0,0,0,0,0,Matches
Paulo Oliveira,pt POR,DF,Braga,30,1992,16.4,22,14,15,7,0,11,13,84.6,2,18,12,6,50,72,75,0,Matches
Rúben Alexandre Gomes Oliveira,pt POR,MF,Santa Clara,27,1994,0.2,1,1,0,0,1,0,1,0.0,1,1,0,1,1,2,0,0,Matches
Bruno Onyemaechi,ng NGA,DF,Boavista,23,1999,28.1,55,39,39,13,3,37,56,66.1,19,22,5,17,37,92,67,1,Matches
Monsuru Opeyemi,ng NGA,FW,Vizela,18,2003,0.5,0,0,0,0,0,0,0,,0,2,0,2,0,0,0,0,Matches
Jerome Opoku,gh GHA,DF,Arouca,23,1998,21.3,23,12,16,6,1,8,11,72.7,3,28,15,13,26,49,82,1,Matches
Pedro Ortiz,es ESP,MF,Vizela,21,2000,5.3,19,11,5,12,2,11,20,55.0,9,6,3,3,6,25,9,0,Matches
Milutin Osmajić,me MNE,FW,Vizela,23,1999,22.7,4,4,0,2,2,2,6,33.3,4,12,2,10,1,5,15,0,Matches
Nicolás Otamendi,ar ARG,DF,Benfica,34,1988,30.8,67,48,32,31,4,48,67,71.6,19,32,11,21,66,133,92,1,Matches
Otávio,pt POR,MF,Porto,27,1995,25.2,70,43,23,26,21,35,84,41.7,49,32,3,29,18,88,17,0,Matches
João Othavio Basso,br BRA,DF,Arouca,25,1997,31.6,55,31,39,15,1,22,44,50.0,22,43,27,16,51,106,159,1,Matches
Amine Oudrhiri,ma MAR,MF,Rio Ave,29,1992,8.7,9,7,3,5,1,6,11,54.5,5,7,2,5,9,18,10,0,Matches
Pablo,br BRA,FW,Famalicão,18,2004,7.9,16,9,3,12,1,4,15,26.7,11,9,0,9,5,21,6,0,Matches
Lucas Paes,br BRA,GK,Casa Pia,24,1997,2.0,0,0,0,0,0,0,2,0.0,2,0,0,0,0,0,0,1,Matches
Renato Pantalon,hr CRO,DF,Rio Ave,24,1997,19.9,30,18,15,15,0,16,26,61.5,10,29,18,11,26,56,80,0,Matches
David Pastor,br BRA,MF,Portimonense,22,2000,0.0,0,0,0,0,0,0,0,,0,0,0,0,0,0,0,0,Matches
Patrick,br BRA,DF,Rio Ave,25,1997,21.1,38,26,21,12,5,24,38,63.2,14,20,10,10,24,62,76,0,Matches
Paulinho,pt POR,FW,Sporting CP,29,1992,15.1,26,13,2,15,9,6,9,66.7,3,9,1,8,7,33,9,0,Matches

Pedrão,br BRA,DF,Portimonense,25,1997,28.7,40,25,31,6,3,21,39,53.8,18,39,16,23,39,79,117,2,Matches
João Pedro,pt POR,MF,Chaves,29,1993,6.6,13,6,10,3,0,5,13,38.5,8,5,0,5,9,22,7,0,Matches
Zé Pedro,pt POR,GK,Paços,20,2002,3.0,0,0,0,0,0,0,0,,0,0,0,0,0,0,0,1,Matches
Pelé,gw GNB,MF,Famalicão,30,1991,6.8,14,6,9,4,1,6,9,66.7,3,5,3,2,4,18,5,2,Matches
Alexandre Penetra,pt POR,DF,Famalicão,20,2001,27.9,50,36,34,14,2,28,49,57.1,21,28,13,15,32,82,59,0,Matches
Pepe,pt POR,DF,Porto,39,1983,21.8,41,28,22,18,1,26,38,68.4,12,18,12,6,25,66,58,0,Matches
Pepê,br BRA,"MF,DF",Porto,25,1997,29.4,41,28,21,15,5,21,50,42.0,29,26,2,24,44,85,21,0,Matches
André Pereira,pt POR,FW,Rio Ave,27,1995,11.1,13,9,5,5,3,4,14,28.6,10,10,2,8,4,17,9,1,Matches
Gabriel Pereira,br BRA,DF,Gil Vicente FC,22,2000,4.6,10,6,9,1,0,6,13,46.2,7,9,7,2,6,16,17,0,Matches
Marco André Rocha Pereira,pt POR,GK,Santa Clara,35,1987,8.0,0,0,0,0,0,0,1,0.0,1,0,0,0,0,0,3,0,Matches
Matheus Pereira,br BRA,DF,Vizela,21,2000,9.0,20,8,11,8,1,16,25,64.0,9,12,3,9,10,30,17,0,Matches
Sebastián Pérez Cardona,co COL,MF,Boavista,29,1993,27.3,71,38,26,40,5,35,82,42.7,47,24,4,20,40,111,25,0,Matches
Kevin Pina,cv CPV,MF,Chaves,24,1997,4.1,11,4,6,4,1,4,8,50.0,4,6,2,4,10,21,8,0,Matches
Rodrigo Pinho,br BRA,FW,Benfica,31,1991,0.5,0,0,0,0,0,0,0,,0,1,0,1,0,0,0,0,Matches
Dinis Pinto,pt POR,DF,Braga,21,2000,0.1,0,0,0,0,0,0,0,,0,0,0,0,0,0,1,0,Matches
Diogo Pinto,pt POR,"FW,MF",Casa Pia,23,1999,5.1,8,6,6,2,0,5,9,55.6,4,1,0,1,2,10,2,0,Matches
Gonçalo Pinto,pt POR,GK,Chaves,22,2000,0.0,0,0,0,0,0,0,0,,0,0,0,0,0,0,1,0,Matches
Rui Pires,pt POR,MF,Paços,24,1998,26.8,59,42,29,25,5,30,51,58.8,21,38,16,22,37,96,60,1,Matches
Pizzi,pt POR,"MF,FW",Braga,32,1989,5.4,11,7,6,2,3,4,14,28.6,10,4,0,4,2,13,7,0,Matches
Carlos Ponck,cv CPV,DF,Chaves,27,1995,20.0,21,19,9,9,3,7,11,63.6,4,38,25,13,28,49,85,1,Matches
Pedro Porro,es ESP,"DF,MF",Sporting CP,22,1999,11.9,19,15,10,7,2,13,25,52.0,12,10,1,9,8,27,13,0,Matches
Samuel Portugal,br BRA,GK,Portimonense,28,1994,4.0,0,0,0,0,0,0,1,0.0,1,0,0,0,0,0,0,0,Matches
Quaresma,br BRA,DF,Arouca,25,1996,30.4,74,44,49,20,5,42,80,52.5,38,36,11,25,45,119,79,0,Matches
Diogo Queirós,pt POR,FW,Famalicão,23,1999,0.1,0,0,0,0,0,0,0,,0,1,0,1,0,0,1,0,Matches
João Queirós,pt POR,DF,Chaves,24,1998,2.9,7,6,7,0,0,5,8,62.5,3,7,4,3,1,8,20,1,Matches

Xavi Quintillà,es ESP,DF,Santa Clara,25,1996,8.0,15,13,7,6,2,8,16,50.0,8,7,2,5,3,18,22,0,Matches
Uroš Račić,rs SRB,MF,Braga,24,1998,12.4,20,13,7,11,2,9,20,45.0,11,20,6,14,20,40,27,0,Matches
Rafa,pt POR,GK,Vitória,18,2003,2.0,1,1,1,0,0,1,2,50.0,1,0,0,0,0,1,1,1,Matches
Jesús Ramírez,ve VEN,"FW,MF",Marítimo,24,1998,6.5,6,4,0,2,4,3,7,42.9,4,3,1,2,1,7,6,0,Matches
Cláudio Ramos,pt POR,GK,Porto,30,1991,1.0,0,0,0,0,0,0,0,,0,0,0,0,0,0,0,1,Matches
Flávio Ramos,br BRA,DF,Paços,28,1994,8.3,9,2,7,2,0,5,8,62.5,3,15,10,5,13,22,41,0,Matches
Gonçalo Ramos,pt POR,FW,Benfica,21,2001,25.4,20,12,3,10,7,7,22,31.8,15,10,3,7,3,23,35,0,Matches
Osama Rashid,iq IRQ,"MF,FW",Vizela,30,1992,4.2,2,0,1,1,0,1,6,16.7,5,7,1,6,4,6,8,0,Matches
Bruno Reis,pt POR,"MF,DF",Portimonense,23,1999,0.8,1,1,0,1,0,0,1,0.0,1,2,0,2,1,2,0,0,Matches
Matheus Reis,br BRA,DF,Sporting CP,27,1995,25.4,32,18,12,15,5,20,27,74.1,7,23,6,17,11,43,35,0,Matches
Miguel Reisinho,pt POR,"DF,MF",Boavista,23,1999,0.2,0,0,0,0,0,0,0,,0,0,0,0,0,0,1,0,Matches
Filipe Relvas,pt POR,DF,Portimonense,22,1999,31.9,50,30,27,19,4,21,30,70.0,9,46,24,22,57,107,137,0,Matches
Brayan Riascos,co COL,"FW,MF",Marítimo,27,1994,9.7,12,8,3,5,4,4,10,40.0,6,6,0,6,3,15,16,0,Matches
Rodrigo Ribeiro,pt POR,FW,Sporting CP,17,2005,0.3,2,0,0,1,1,0,1,0.0,1,0,0,0,1,3,0,0,Matches
Tiago Ribeiro,pt POR,MF,Paços,20,2002,2.0,4,3,2,2,0,1,7,14.3,6,2,2,0,2,6,2,0,Matches
Ricardinho,pt POR,"FW,MF",Santa Clara,23,1998,20.0,24,17,8,12,4,13,36,36.1,23,20,3,17,7,31,14,0,Matches
Riccieli,br BRA,DF,Famalicão,23,1998,28.7,40,26,30,10,0,23,44,52.3,21,54,29,25,29,69,161,0,Matches
Rildo,br BRA,"FW,MF",Santa Clara,22,2000,9.1,19,9,7,7,5,7,17,41.2,10,11,1,10,3,22,6,0,Matches
Mihailo Ristić,rs SRB,DF,Benfica,26,1995,1.3,2,2,1,0,1,1,1,100.0,0,3,0,3,2,4,1,0,Matches
Robson,br BRA,DF,Boavista,22,2000,1.4,2,0,1,1,0,0,2,0.0,2,3,1,2,2,4,12,0,Matches
Bryan Róchez,hn HON,"FW,MF",Portimonense,27,1995,9.9,10,8,2,6,2,2,9,22.2,7,5,2,3,1,11,8,0,Matches
Rochinha,pt POR,"FW,MF",Sporting CP,27,1995,4.8,4,1,0,4,0,1,4,25.0,3,3,1,2,5,9,0,0,Matches
Bruno Rodrigues,pt POR,DF,Braga,21,2001,1.0,1,1,0,1,0,1,2,50.0,1,1,1,0,1,2,3,0,Matches
Gonçalo Rodrigues,pt POR,MF,Rio Ave,25,1997,32.2,64,37,18,40,6,29,72,40.3,43,25,5,20,25,89,22,1,Matches
Ivo Rodrigues,pt POR,"MF,FW",Famalicão,27,1995,26.3,61,36,24,26,11,30,65,46.2,35,30,6,24,20,81,23,0,Matches

Diego Rosa,br BRA,"MF,FW",Vizela,19,2002,2.9,10,5,5,4,1,6,12,50.0,6,6,2,4,5,15,7,0,Matches
Loreintz Rosier,fr FRA,MF,Estoril,23,1998,11.5,34,23,16,18,0,15,28,53.6,13,11,2,9,22,56,25,3,Matches
Mabrouk Rouai,fr FRA,"FW,MF",Estoril,21,2000,0.4,1,0,0,0,1,1,1,100.0,0,1,1,0,0,1,0,0,Matches
Abel Ruiz,es ESP,FW,Braga,22,2000,23.0,13,7,4,7,2,5,19,26.3,14,18,2,16,7,20,9,0,Matches
Alan Ruiz,ar ARG,MF,Arouca,28,1993,27.7,39,24,13,25,1,21,45,46.7,24,18,4,14,9,48,23,1,Matches
Leonardo Ruíz,co COL,FW,Rio Ave,26,1996,10.3,5,4,2,2,1,3,15,20.0,12,7,4,3,2,7,4,0,Matches
Gustavo sá,pt POR,"MF,FW",Famalicão,17,2004,4.3,11,7,3,6,2,3,10,30.0,7,3,1,2,2,13,6,0,Matches
Helder Sá,pt POR,"DF,MF",Vitória,19,2002,8.9,21,12,14,5,2,11,20,55.0,9,15,3,12,5,26,21,0,Matches
Josué Sá,pt POR,DF,Rio Ave,30,1992,15.0,21,15,15,5,1,6,14,42.9,8,14,8,6,16,37,57,0,Matches
Pedro Sá,pt POR,MF,Portimonense,28,1993,8.2,11,3,2,7,2,7,27,25.9,20,7,3,4,6,17,20,0,Matches
Tiago Sá,pt POR,GK,Braga,27,1995,1.9,0,0,0,0,0,0,0,,0,0,0,0,0,0,0,0,Matches
Serdar Saatçı,tr TUR,DF,Braga,19,2003,2.4,2,2,1,1,0,1,3,33.3,2,1,0,1,8,10,3,0,Matches
Safira,br BRA,FW,Vitória,27,1995,9.1,8,5,1,5,2,1,8,12.5,7,7,2,5,1,9,8,0,Matches
Pierre Sagna,sn SEN,DF,Santa Clara,31,1990,19.5,37,19,22,13,2,17,25,68.0,8,16,4,12,33,70,60,1,Matches
Arthur Sales,br BRA,"FW,MF",Paços,20,2002,4.0,5,2,0,3,2,1,5,20.0,4,3,0,3,3,8,2,0,Matches
Andreas Samaris,gr GRE,MF,Rio Ave,33,1989,15.6,34,15,13,19,2,15,29,51.7,14,26,7,19,9,43,23,0,Matches
Samu,pt POR,MF,Vizela,26,1996,29.8,76,44,30,34,12,33,77,42.9,44,46,7,39,45,121,41,0,Matches
Leandro Sanca,gw GNB,"FW,MF",Famalicão,22,2000,4.9,12,7,7,3,2,7,20,35.0,13,9,0,9,4,16,5,0,Matches
Elder Santana,br BRA,"MF,FW",Gil Vicente FC,29,1993,0.5,2,1,0,0,2,0,2,0.0,2,0,0,0,0,2,1,0,Matches
Aderlan Santos,br BRA,DF,Rio Ave,33,1989,31.3,55,35,35,20,0,22,34,64.7,12,41,27,14,53,108,167,1,Matches
Luís Santos,pt POR,"FW,MF",Boavista,22,2000,3.2,5,3,1,4,0,0,5,0.0,5,3,0,3,3,8,3,0,Matches
Nuno Santos,pt POR,"DF,MF",Sporting CP,27,1995,25.2,22,12,7,10,5,17,32,53.1,15,14,2,12,23,45,12,0,Matches
Pedro Santos,pt POR,"FW,MF",Braga,21,2000,0.1,0,0,0,0,0,0,0,,0,0,0,0,0,0,0,0,Matches
Rene Santos,br BRA,"DF,MF",Marítimo,30,1992,12.1,25,17,13,8,4,14,19,73.7,5,19,8,11,10,35,44,0,Matches
Tiago Santos,pt POR,DF,Estoril,20,2002,26.9,75,50,43,28,4,45,61,73.8,16,26,5,21,16,91,45,0,Matches

Zaidu Sanusi,ng NGA,DF,Porto,25,1997,11.7,15,7,8,5,2,11,21,52.4,10,13,4,9,11,26,20,0,Matches
Adewele Sapara,ng NGA,"FW,MF",Portimonense,27,1995,1.3,5,4,4,1,0,2,2,100.0,0,0,0,0,3,8,2,0,Matches
Andrés Sarmiento,co COL,"FW,MF",Vizela,24,1998,0.4,2,1,0,2,0,2,3,66.7,1,1,0,1,1,3,0,0,Matches
Sidy Sarr,sn SEN,MF,Chaves,26,1996,1.3,7,5,6,1,0,1,3,33.3,2,5,0,5,2,9,3,0,Matches
Vincent Sasso,fr FRA,DF,Boavista,31,1991,21.9,32,22,24,7,1,14,21,66.7,7,16,10,6,27,59,93,0,Matches
Savio,br BRA,DF,Rio Ave,27,1995,3.6,6,3,5,0,1,6,7,85.7,1,7,2,5,3,9,7,0,Matches
Andreas Schjelderup,no NOR,FW,Benfica,18,2004,0.0,0,0,0,0,0,0,0,,0,0,0,0,0,0,0,0,Matches
Alexander Schmidt,at AUT,FW,Vizela,24,1998,3.6,2,2,0,2,0,2,2,100.0,0,4,0,4,2,4,5,0,Matches
Moustapha Seck,sn SEN,"DF,FW",Portimonense,26,1996,24.9,52,35,24,19,9,31,51,60.8,20,26,8,18,31,83,40,2,Matches
Alfa Semedo,gw GNB,MF,Vitória,24,1997,0.3,1,1,1,0,0,1,2,50.0,1,0,0,0,0,1,1,0,Matches
Nuno Sequeira,pt POR,DF,Braga,31,1990,22.9,48,28,25,15,8,32,68,47.1,36,23,3,20,35,83,37,0,Matches
Serginho,,"FW,MF",Estoril,21,2001,1.5,5,3,2,3,0,1,3,33.3,2,2,0,2,0,5,1,0,Matches
Paulo Sérgio Mota,pt POR,"DF,MF",Marítimo,31,1991,8.0,8,6,6,0,2,5,8,62.5,3,5,2,3,8,16,16,0,Matches
André Silva,br BRA,"FW,MF",Vitória,25,1997,19.4,14,9,4,8,2,3,11,27.3,8,16,2,14,13,27,20,0,Matches
António Silva,pt POR,DF,Benfica,18,2003,29.9,57,30,36,20,1,38,55,69.1,17,23,13,10,38,95,89,2,Matches
Guilherme Silva,br BRA,"DF,MF",Chaves,21,2000,0.2,0,0,0,0,0,0,0,,0,0,0,0,0,0,1,0,Matches
João Miguel Macedo Silva,pt POR,GK,Marítimo,27,1995,8.0,0,0,0,0,0,0,0,,0,1,0,1,1,1,6,0,Matches
Joel silva,pt POR,MF,Boavista,19,2003,1.1,1,0,1,0,0,0,1,0.0,1,0,0,0,1,2,2,0,Matches
Jorge Fernando Santos Silva,pt POR,"DF,MF",Paços,26,1996,5.2,14,10,11,0,3,9,18,50.0,9,4,2,2,4,18,18,0,Matches
Jota Silva,pt POR,"FW,MF",Vitória,22,1999,17.8,40,23,14,17,9,16,42,38.1,26,29,2,27,9,49,13,0,Matches
Lucas Silva,br BRA,FW,Paços,24,1998,0.2,0,0,0,0,0,0,1,0.0,1,1,1,0,0,0,0,0,Matches
Pedro Manuel da Silva Moreira,pt POR,MF,Arouca,33,1989,0.8,1,1,0,1,0,1,2,50.0,1,0,0,0,1,2,1,0,Matches
Pedro José Moreira Silva,pt POR,GK,Estoril,25,1997,2.3,0,0,0,0,0,0,0,,0,0,0,0,0,0,1,0,Matches
Rafa Silva,pt POR,"MF,FW",Benfica,29,1993,24.2,16,9,1,8,7,7,21,33.3,14,17,0,17,2,18,1,0,Matches
Tiago Silva,pt POR,MF,Vitória,29,1993,23.3,47,30,21,18,8,23,47,48.9,24,20,5,15,27,74,12,0,Matches

David Simão,pt POR,MF,Arouca,32,1990,28.7,55,31,28,21,6,29,64,45.3,35,35,15,20,29,84,26,0,Matches
André Simões,pt POR,MF,Famalicão,32,1989,1.9,8,5,2,4,2,4,6,66.7,2,1,0,1,5,13,3,0,Matches
André Simões,pt POR,"MF,FW",Gil Vicente FC,18,2003,0.2,0,0,0,0,0,0,1,0.0,1,0,0,0,0,0,0,0,Matches
Luther Singh,za RSA,"FW,MF",Chaves,24,1997,7.0,14,11,6,7,1,7,9,77.8,2,5,0,5,8,22,7,0,Matches
Lucas Soares,br BRA,"MF,DF",Casa Pia,24,1998,24.2,40,24,20,17,3,21,48,43.8,27,19,0,19,21,61,40,1,Matches
Samuel Soares,pt POR,GK,Benfica,20,2002,0.0,0,0,0,0,0,0,0,,0,0,0,0,0,0,0,0,Matches
Val Soares,br BRA,MF,Marítimo,25,1997,13.5,38,23,18,18,2,23,52,44.2,29,9,2,7,13,51,8,0,Matches
Yuki Soma,jp JPN,"FW,MF",Casa Pia,25,1997,13.5,21,16,6,13,2,13,27,48.1,14,15,2,13,6,27,4,0,Matches
Joel Soñora,us USA,MF,Marítimo,25,1996,2.0,1,0,0,1,0,0,1,0.0,1,2,0,2,2,3,1,0,Matches
Ismaila Soro,ci CIV,MF,Arouca,24,1998,16.9,39,21,25,10,4,17,46,37.0,29,19,6,13,37,76,27,0,Matches
Miguel Sousa,pt POR,MF,Marítimo,23,1998,2.0,1,1,0,1,0,0,1,0.0,1,1,0,1,2,3,0,1,Matches
Vasco Sousa,pt POR,MF,Porto,19,2003,0.0,0,0,0,0,0,0,1,0.0,1,0,0,0,0,0,0,0,Matches
Claudemir de Souza,br BRA,MF,Vizela,34,1988,15.1,27,15,12,12,3,22,38,57.9,16,25,11,14,18,45,30,0,Matches
Jerry St. Juste,nl NED,DF,Sporting CP,25,1996,10.1,15,8,6,7,2,7,11,63.6,4,8,3,5,14,29,22,1,Matches
Filip Stevanovic,rs SRB,"FW,MF",Santa Clara,19,2002,1.7,4,3,0,3,1,3,5,60.0,2,1,0,1,0,4,0,0,Matches
Habib sylla,ci CIV,DF,Chaves,23,1999,6.9,7,6,3,3,1,4,9,44.4,5,13,6,7,6,13,19,0,Matches
Morlaye Sylla,gn GUI,"FW,MF",Arouca,24,1998,25.3,44,28,15,22,7,24,53,45.3,29,31,4,27,27,71,18,1,Matches
Kyosuke Tagawa,jp JPN,FW,Santa Clara,23,1999,13.2,10,6,3,6,1,2,11,18.2,9,2,0,2,4,14,8,0,Matches
Afonso Taira,pt POR,MF,Casa Pia,30,1992,23.3,94,55,40,51,3,39,80,48.8,41,44,5,39,35,129,29,0,Matches
Mateo Tanlongo,ar ARG,MF,Sporting CP,18,2003,1.6,4,1,3,0,1,1,5,20.0,4,1,0,1,0,4,1,0,Matches
Mehdi Taremi,ir IRN,FW,Porto,30,1992,29.0,22,14,6,8,8,9,30,30.0,21,19,1,18,8,30,20,0,Matches
David Tavares,cv CPV,"MF,FW",Famalicão,23,1999,0.5,0,0,0,0,0,0,1,0.0,1,2,0,2,1,1,1,0,Matches
Heriberto Tavares,pt POR,"MF,FW",Famalicão,25,1997,2.4,3,2,0,1,2,1,5,20.0,4,2,0,2,4,7,4,0,Matches
Martim Tavares,pt POR,"FW,MF",Boavista,18,2003,4.0,2,2,1,0,1,0,3,0.0,3,1,0,1,5,7,5,0,Matches
Duplexe Tchamba,cm CMR,DF,Casa Pia,24,1998,4.3,7,3,5,1,1,4,8,50.0,4,5,3,2,5,12,19,0,Matches

João Teixeira,pt POR,MF,Chaves,28,1994,30.4,68,41,28,30,10,31,87,35.6,56,37,6,31,24,92,21,1,Matches
André Teles,pt POR,MF,Marítimo,25,1997,0.7,2,2,1,1,0,2,3,66.7,1,0,0,0,0,2,0,0,Matches
Casper Tengstedt,dk DEN,"FW,MF",Benfica,22,2000,0.3,0,0,0,0,0,0,0,,0,0,0,0,0,0,1,0,Matches
Nigel Thomas,nl NED,"FW,MF",Paços,21,2001,22.5,16,8,7,6,3,6,25,24.0,19,18,1,17,17,33,16,0,Matches
Pedro Tiba,pt POR,MF,Gil Vicente FC,33,1988,13.9,19,9,4,7,8,11,25,44.0,14,16,7,9,10,29,20,0,Matches
Bastien Toma,ch SUI,MF,Paços,23,1999,4.8,6,3,0,3,3,2,8,25.0,6,4,0,4,2,8,0,0,Matches
Vítor Tormena,br BRA,DF,Braga,26,1996,26.1,24,18,14,8,2,17,27,63.0,10,42,21,21,31,55,109,1,Matches
Mamadou Tounkara,ml MLI,DF,Vitória,20,2001,11.6,11,8,7,3,1,8,10,80.0,2,11,4,7,5,16,50,0,Matches
Francisco Trincão,pt POR,"MF,FW",Sporting CP,22,1999,24.5,36,18,7,19,10,19,44,43.2,25,18,2,16,8,44,4,0,Matches
Matouš Trmal,cz CZE,GK,Marítimo,23,1998,6.0,0,0,0,0,0,0,1,0.0,1,0,0,0,0,0,2,0,Matches
Manuel Ugarte Ribeiro,uy URU,MF,Sporting CP,21,2001,26.1,121,69,37,61,23,66,123,53.7,57,43,7,36,57,178,17,0,Matches
Zé Uilton,br BRA,"FW,MF",Paços,30,1992,15.3,21,13,11,8,2,8,13,61.5,5,6,0,6,6,27,22,1,Matches
Ukra,pt POR,"FW,MF",Rio Ave,34,1988,4.1,4,4,1,2,1,4,12,33.3,8,8,1,7,3,7,4,0,Matches
Mateus Uribe,co COL,MF,Porto,31,1991,27.3,73,46,35,33,5,35,71,49.3,36,34,4,30,51,124,42,1,Matches
Rodrigo Valente,pt POR,"MF,FW",Santa Clara,21,2001,1.1,1,0,0,0,1,1,1,100.0,0,4,1,3,1,2,1,0,Matches
João Valido,pt POR,GK,Arouca,22,2000,0.0,0,0,0,0,0,0,0,,0,0,0,0,0,0,0,0,Matches
Bruno Varela,cv CPV,GK,Vitória,27,1994,27.0,0,0,0,0,0,0,0,,0,0,0,0,0,0,14,2,Matches
Fernando Varela,cv CPV,DF,Casa Pia,34,1987,22.6,26,17,16,10,0,16,24,66.7,8,33,24,9,26,52,85,1,Matches
Luciano Vega,ar ARG,"MF,FW",Marítimo,23,1999,2.1,7,5,3,3,1,3,9,33.3,6,3,1,2,1,8,5,0,Matches
Danilo Veiga,pt POR,DF,Gil Vicente FC,19,2002,7.6,24,14,12,10,2,11,13,84.6,2,5,1,4,14,38,20,0,Matches
Igor Vekič,si SVN,GK,Paços,24,1998,9.1,0,0,0,0,0,0,1,0.0,1,0,0,0,0,0,8,1,Matches
Bruno Ventura,pt POR,FW,Rio Ave,21,2001,1.1,1,1,0,1,0,0,1,0.0,1,1,0,1,0,1,0,0,Matches
Lucas Veríssimo,br BRA,DF,Benfica,27,1995,0.1,0,0,0,0,0,0,0,,0,0,0,0,0,0,0,0,Matches
Gabriel Veron,br BRA,"MF,FW",Porto,19,2002,4.5,14,10,5,5,4,4,7,57.1,3,5,0,5,2,16,4,0,Matches
Jan Vertonghen,be BEL,DF,Benfica,35,1987,0.0,0,0,0,0,0,0,0,,0,0,0,0,0,0,0,0,Matches

André Vidigal,pt POR,"FW,MF",Marítimo,23,1998,28.6,36,22,13,10,13,16,27,59.3,11,19,1,18,13,49,6,0,Matches
Gabriel Vieira,br BRA,"FW,MF",Santa Clara,20,2002,24.4,37,26,21,13,3,14,38,36.8,24,9,2,7,16,53,11,0,Matches
João Vigário,pt POR,DF,Paços,26,1995,0.2,0,0,0,0,0,0,0,,0,2,1,1,0,0,1,0,Matches
Mikel Villanueva,ve VEN,DF,Vitória,29,1993,28.2,26,15,20,5,1,15,22,68.2,7,23,12,11,44,70,97,2,Matches
Bernardo Vital,pt POR,DF,Estoril,21,2000,25.1,22,14,19,3,0,15,21,71.4,6,26,18,8,16,38,124,1,Matches
Vitinha,pt POR,FW,Braga,22,2000,12.2,22,9,7,12,3,6,14,42.9,8,17,2,15,4,26,17,0,Matches
Vitinho,br BRA,"MF,FW",Arouca,22,2000,2.7,3,1,1,0,2,0,2,0.0,2,3,0,3,4,7,4,0,Matches
Paulo Vitor,br BRA,"MF,DF",Rio Ave,23,1999,12.3,22,15,18,4,0,14,25,56.0,11,20,2,18,14,36,21,0,Matches
Steven Vitória,ca CAN,DF,Chaves,35,1987,29.4,20,10,15,4,1,14,19,73.7,5,53,43,10,31,51,116,1,Matches
Odisseas Vlachodimos,gr GRE,GK,Benfica,28,1994,34.0,0,0,0,0,0,0,1,0.0,1,0,0,0,0,0,10,1,Matches
Ilija Vukotić,me MNE,MF,Boavista,23,1999,4.5,8,5,3,4,1,0,4,0.0,4,6,3,3,6,14,12,0,Matches
Wagner,br BRA,DF,Portimonense,23,1999,1.0,3,3,1,2,0,2,3,66.7,1,1,0,1,2,5,2,0,Matches
Masaki Watai,jp JPN,"MF,FW",Boavista,23,1999,5.8,6,3,1,3,2,2,11,18.2,9,3,0,3,2,8,2,1,Matches
Julian Weigl,de GER,MF,Benfica,26,1995,0.6,2,2,1,1,0,0,0,,0,2,0,2,0,2,0,0,Matches
Wendell,br BRA,DF,Porto,29,1993,21.8,48,28,24,19,5,23,47,48.9,24,15,0,15,25,73,25,0,Matches
Weverson,br BRA,"DF,FW",Arouca,22,2000,0.8,0,0,0,0,0,0,0,,0,0,0,0,0,0,1,0,Matches
Willyan,br BRA,"DF,MF",Portimonense,27,1995,4.0,7,4,6,1,0,5,8,62.5,3,4,3,1,8,15,16,0,Matches
Bruno Wilson,pt POR,DF,Vizela,25,1996,22.8,21,11,12,8,1,11,15,73.3,4,37,30,7,42,63,124,1,Matches
Roan Wilson,cr CRC,MF,Gil Vicente FC,20,2002,1.3,5,2,4,1,0,4,7,57.1,3,3,0,3,1,6,0,0,Matches
Cláudio Winck,br BRA,"DF,MF",Marítimo,28,1994,26.9,62,39,34,20,8,36,61,59.0,25,34,8,26,28,90,36,0,Matches
Xadas,pt POR,"MF,FW",Marítimo,24,1997,26.3,28,16,10,15,3,14,46,30.4,32,37,8,29,13,41,17,0,Matches
Abdul-Aziz Yakubu,gh GHA,FW,Rio Ave,23,1998,14.2,4,3,1,2,1,1,3,33.3,2,6,1,5,4,8,17,0,Matches
Roman Yaremchuk,ua UKR,FW,Benfica,26,1995,0.6,0,0,0,0,0,0,0,,0,0,0,0,0,0,0,0,Matches
Moses Yaw,gh GHA,MF,Arouca,23,1999,3.5,6,4,2,4,0,4,12,33.3,8,3,1,2,7,13,9,0,Matches
Zaydou Youssouf,fr FRA,MF,Famalicão,23,1999,23.8,79,50,37,35,7,33,65,50.8,32,26,3,23,33,112,29,1,Matches

Antonio Zarzana,es ESP,"MF,FW",Marítimo,20,2002,3.2,5,4,2,2,1,4,7,57.1,3,1,0,1,3,8,0,0,Matches
Ivan Zlobin,ru RUS,GK,Famalicão,25,1997,1.0,0,0,0,0,0,0,0,,0,0,0,0,0,0,0,0,Matches
Kévin Zohi,ml MLI,"FW,MF",Vizela,25,1996,10.0,18,7,6,8,4,8,15,53.3,7,11,0,11,5,23,8,0,Matches
Nermin Zolotić,ba BIH,DF,Casa Pia,29,1993,24.3,31,21,17,14,0,22,43,51.2,21,39,18,21,37,68,90,2,Matches
Emilijus Zubas,lt LTU,GK,Arouca,32,1990,3.0,0,0,0,0,0,0,0,,0,0,0,0,0,0,3,0,Matches
