Player,Nation,Position,Squad,Age,Year of birth,90s Played,Tackles,Tackles Won,Tackles (Def 3rd),Tackles (Mid 3rd),Tackles (Att 3rd),Dribblers Tackled,Dribbles Challenged,% of Dribblers Tackled,Challenges Lost,Blocks,Shots Blocked,Passes Blocked,Interceptions,Tkl+Int,Clearances,Errors,Matches


Yunis Abdelhamid,ma MAR,DF,Reims,34,1987,37.0,82,50,47,33,2,39,52,75.0,13,65,27,38,64,146,116,1,Matches
Himad Abdelli,dz ALG,"MF,FW",Angers,22,1999,23.7,64,38,22,32,10,31,67,46.3,36,30,1,29,28,92,15,0,Matches
Salis Abdul Samed,gh GHA,MF,Lens,22,2000,32.2,46,26,18,23,5,29,52,55.8,23,38,9,29,36,82,26,0,Matches
Laurent Abergel,fr FRA,MF,Lorient,29,1993,26.0,92,52,59,30,3,39,92,42.4,53,47,8,39,34,126,39,0,Matches
Matthis Abline,fr FRA,"FW,MF",Auxerre,19,2003,9.0,4,2,0,3,1,0,5,0.0,5,6,1,5,1,5,1,0,Matches
Matthis Abline,fr FRA,"FW,MF",Rennes,19,2003,1.2,1,1,0,0,1,1,1,100.0,0,1,0,1,2,3,1,0,Matches
Zakaria Aboukhlal,ma MAR,"FW,MF",Toulouse,22,2000,27.5,33,23,13,9,11,14,45,31.1,31,18,1,17,22,55,23,0,Matches
Mohamed Achi,fr FRA,FW,Nantes,20,2002,0.4,1,1,1,0,0,1,1,100.0,0,0,0,0,0,1,0,0,Matches
Martin Adeline,fr FRA,"MF,FW",Reims,18,2003,1.2,3,3,2,1,0,3,4,75.0,1,3,1,2,3,6,3,0,Matches
Emmanuel Agbadou,ci CIV,DF,Reims,25,1997,26.5,71,49,53,16,2,42,65,64.6,23,30,14,16,32,103,107,3,Matches
Lucien Agoume,fr FRA,MF,Troyes,20,2002,12.2,42,25,18,15,9,17,33,51.5,16,14,5,9,27,69,24,0,Matches
Ruben Aguilar,fr FRA,DF,Monaco,29,1993,13.0,19,9,7,7,5,8,22,36.4,14,13,1,12,18,37,28,1,Matches
Amar Ahmed,se SWE,FW,Troyes,18,2004,0.2,1,1,0,1,0,0,1,0.0,1,0,0,0,1,2,0,0,Matches
Jean-Eudes Aholou,ci CIV,MF,Strasbourg,28,1994,14.4,34,20,10,20,4,12,31,38.7,19,25,0,25,24,58,15,0,Matches
Ludovic Ajorque,fr FRA,FW,Strasbourg,28,1994,8.6,5,4,1,4,0,3,9,33.3,6,3,1,2,2,7,7,0,Matches
Maghnes Akliouche,fr FRA,"MF,FW",Monaco,20,2002,4.5,7,4,4,3,0,2,8,25.0,6,2,0,2,3,10,2,0,Matches
Doğan Alemdar,tr TUR,GK,Rennes,19,2002,4.5,0,0,0,0,0,0,0,,0,0,0,0,0,0,1,1,Matches
Jim Allevinah,ga GAB,"DF,FW",Clermont Foot,27,1995,24.9,39,24,24,11,4,19,62,30.6,43,24,2,22,24,63,26,1,Matches
Mickaël Alphonse,gp GLP,DF,Ajaccio,33,1989,15.1,35,23,20,11,4,20,33,60.6,13,17,5,12,35,70,44,1,Matches
Ibrahim Amadou,fr FRA,"DF,MF",Angers,29,1993,4.7,10,7,6,3,1,7,11,63.6,4,7,3,4,10,20,20,0,Matches
Ayoub Amraoui,ma MAR,"DF,FW",Nice,18,2004,3.3,6,5,3,3,0,2,5,40.0,3,1,0,1,4,10,4,0,Matches
Benjamin André,fr FRA,MF,Lille,31,1990,32.4,128,74,51,60,17,65,121,53.7,56,50,8,42,47,175,60,0,Matches
Komnen Andrić,rs SRB,FW,Clermont Foot,27,1995,16.1,13,5,2,7,4,2,15,13.3,13,8,1,7,8,21,13,0,Matches
Houssem Aouar,dz ALG,MF,Lyon,24,1998,5.8,12,5,5,5,2,3,9,33.3,6,12,2,10,8,20,3,0,Matches
Adil Aouchiche,fr FRA,MF,Lorient,20,2002,2.8,5,2,3,1,1,1,9,11.1,8,1,0,1,4,9,1,0,Matches

Dennis Appiah,fr FRA,"DF,MF",Nantes,30,1992,8.8,21,11,14,7,0,10,27,37.0,17,13,5,8,10,31,16,0,Matches
Stredair Appuah,fr FRA,"DF,MF",Nantes,18,2004,0.7,2,1,0,2,0,0,0,,0,2,0,2,1,3,0,0,Matches
Taïryk Arconte,fr FRA,FW,Brest,18,2003,1.4,1,1,0,0,1,0,3,0.0,3,1,0,1,0,1,2,0,Matches
Mohamed El Arouch,fr FRA,MF,Lyon,18,2004,0.0,1,1,1,0,0,0,0,,0,0,0,0,0,1,0,0,Matches
Lorenz Assignon,tg TOG,DF,Rennes,22,2000,2.9,6,2,4,2,0,2,4,50.0,2,6,0,6,2,8,9,0,Matches
Youcef Atal,dz ALG,"DF,MF",Nice,26,1996,8.7,38,22,18,15,5,23,32,71.9,9,9,0,9,14,52,13,0,Matches
Valentin Atangana Edoa,fr FRA,MF,Reims,16,2005,1.9,8,3,4,2,2,3,6,50.0,3,2,1,1,0,8,1,0,Matches
Mathias Autret,fr FRA,"MF,FW",Auxerre,31,1991,14.3,22,10,10,10,2,7,16,43.8,9,14,2,12,12,34,13,0,Matches
Cédric Avinel,gp GLP,DF,Ajaccio,35,1986,19.9,13,7,8,5,0,8,12,66.7,4,20,13,7,15,28,91,1,Matches
Loïc Bade,fr FRA,DF,Rennes,22,2000,1.0,1,1,1,0,0,0,0,,0,0,0,0,1,2,3,0,Matches
Benoît Badiashile,fr FRA,DF,Monaco,21,2001,9.3,10,8,6,4,0,5,10,50.0,5,9,6,3,17,27,40,1,Matches
Eric Bailly,ci CIV,DF,Marseille,28,1994,6.0,13,10,6,6,1,7,7,100.0,0,15,12,3,12,25,18,1,Matches
Dénys Bain,fr FRA,DF,Auxerre,29,1993,1.4,4,3,3,1,0,1,2,50.0,1,2,1,1,2,6,4,0,Matches
Brandon Baiye,be BEL,MF,Clermont Foot,21,2000,0.6,3,2,2,1,0,2,3,66.7,1,1,0,1,1,4,3,0,Matches
Cédric Bakambu,cd COD,MF,Marseille,31,1991,0.7,2,1,2,0,0,2,2,100.0,0,0,0,0,0,2,0,0,Matches
Thierno Balde,fr FRA,"DF,MF",Troyes,20,2002,23.9,27,14,19,4,4,18,30,60.0,12,15,3,12,23,50,39,0,Matches
Carlos Baleba,cm CMR,MF,Lille,18,2004,5.3,13,11,2,9,2,9,14,64.3,5,13,3,10,1,14,3,2,Matches
Leonardo Balerdi,ar ARG,DF,Marseille,23,1999,29.3,57,37,43,12,2,32,45,71.1,13,48,29,19,63,120,91,1,Matches
Folarin Balogun,us USA,FW,Reims,21,2001,33.3,9,5,1,5,3,2,20,10.0,18,20,1,19,3,12,15,0,Matches
Abdoulaye Bamba,ci CIV,DF,Angers,32,1990,15.2,22,12,15,5,2,16,19,84.2,3,7,3,4,18,40,38,0,Matches
Jonathan Bamba,ci CIV,FW,Lille,26,1996,30.9,37,17,12,14,11,14,45,31.1,31,36,1,35,22,59,14,0,Matches
Bradley Barcola,fr FRA,"FW,MF",Lyon,19,2002,16.0,25,16,8,10,7,8,39,20.5,31,29,0,29,19,44,10,0,Matches
Melvin Bard,fr FRA,DF,Nice,21,2000,27.3,96,60,61,29,6,59,89,66.3,30,35,4,31,64,160,40,1,Matches
Ross Barkley,eng ENG,"MF,FW",Nice,28,1993,10.7,16,9,7,4,5,7,13,53.8,6,7,2,5,8,24,6,0,Matches
Mickaël Barreto,fr FRA,MF,Ajaccio,31,1991,14.7,32,20,12,17,3,8,45,17.8,37,17,0,17,18,50,11,0,Matches

Cyrille Bayala,bf BFA,MF,Ajaccio,26,1996,22.3,53,37,16,20,17,23,48,47.9,25,20,3,17,25,78,21,0,Matches
Yanis Begraoui,ma MAR,"FW,MF",Toulouse,21,2001,0.7,2,0,1,0,1,1,2,50.0,1,0,0,0,1,3,0,0,Matches
Alexis Beka Beka,fr FRA,"MF,DF",Nice,21,2001,6.1,16,5,6,9,1,4,15,26.7,11,9,1,8,12,28,6,0,Matches
Jérémie Bela,ao ANG,"DF,MF",Clermont Foot,29,1993,8.3,6,4,2,1,3,3,4,75.0,1,10,1,9,9,15,8,0,Matches
Reda Belahyane,fr FRA,MF,Nice,18,2004,2.0,8,6,5,3,0,3,5,60.0,2,5,1,4,2,10,0,0,Matches
Youcef Belaïli,dz ALG,"MF,FW",Ajaccio,30,1992,12.8,18,10,3,9,6,8,20,40.0,12,10,1,9,5,23,4,0,Matches
Youcef Belaïli,dz ALG,"FW,MF",Brest,30,1992,4.0,5,2,3,2,0,2,7,28.6,5,2,0,2,1,6,1,0,Matches
Haris Belkebla,dz ALG,MF,Brest,28,1994,29.5,80,48,35,40,5,44,85,51.8,41,32,6,26,52,132,21,3,Matches
Jean-Ricner Bellegarde,fr FRA,"MF,FW",Strasbourg,24,1998,26.9,47,25,15,21,11,11,25,44.0,14,26,3,23,26,73,22,0,Matches
Jeanuël Belocian,fr FRA,DF,Rennes,17,2005,5.6,10,7,3,5,2,5,9,55.6,4,6,3,3,6,16,11,0,Matches
Eliesse Ben Seghir,ma MAR,"FW,MF",Monaco,17,2005,11.7,18,10,4,12,2,4,12,33.3,8,18,1,17,4,22,1,0,Matches
Salim Ben Seghir,fr FRA,MF,Marseille,19,2003,0.0,0,0,0,0,0,0,0,,0,1,0,1,0,0,0,0,Matches
Wissam Ben Yedder,fr FRA,FW,Monaco,31,1990,23.5,16,9,2,5,9,4,13,30.8,9,15,0,15,4,20,0,0,Matches
Nabil Bentaleb,dz ALG,MF,Angers,27,1994,27.7,74,40,31,35,8,36,61,59.0,25,33,11,22,44,118,29,3,Matches
Patrick Berg,no NOR,"MF,FW",Lens,24,1997,0.3,0,0,0,0,0,0,1,0.0,1,0,0,0,1,1,0,0,Matches
Mitchell van Bergen,nl NED,"FW,DF",Reims,22,1999,10.1,18,8,6,7,5,8,20,40.0,12,8,2,6,6,24,11,0,Matches
Quentin Bernard,fr FRA,DF,Auxerre,33,1989,7.0,9,7,4,2,3,7,15,46.7,8,9,1,8,15,24,17,0,Matches
Paul Bernardoni,fr FRA,GK,Angers,25,1997,27.0,2,0,2,0,0,2,3,66.7,1,1,0,1,1,3,12,1,Matches
Juan Bernat,es ESP,"DF,MF",Paris S-G,29,1993,18.3,32,16,18,9,5,21,39,53.8,18,11,2,9,9,41,22,1,Matches
Jason Berthomier,fr FRA,MF,Clermont Foot,32,1990,0.3,0,0,0,0,0,0,0,,0,0,0,0,0,0,0,0,Matches
El Bilal Touré,ml MLI,FW,Reims,20,2001,1.0,0,0,0,0,0,0,0,,0,2,0,2,0,0,1,0,Matches
Jean-Claude Billong,cm CMR,MF,Clermont Foot,28,1993,0.3,0,0,0,0,0,0,0,,0,1,1,0,1,1,0,0,Matches
Veljko Birmančević,rs SRB,"FW,MF",Toulouse,24,1998,4.9,13,7,5,4,4,7,21,33.3,14,12,2,10,7,20,1,0,Matches
Marco Bizot,nl NED,GK,Brest,31,1991,37.0,0,0,0,0,0,0,1,0.0,1,1,0,1,0,0,24,4,Matches
Rubén Blanco,es ESP,GK,Marseille,27,1995,5.5,0,0,0,0,0,0,0,,0,0,0,0,0,0,1,0,Matches

Ludovic Blas,fr FRA,"MF,FW",Nantes,24,1997,31.3,47,30,17,19,11,17,49,34.7,32,26,1,25,19,66,8,0,Matches
Miha Blažič,si SVN,DF,Angers,29,1993,22.0,8,6,8,0,0,7,15,46.7,8,25,19,6,22,30,80,1,Matches
Joaquín Blázquez,ar ARG,GK,Brest,21,2001,1.0,0,0,0,0,0,0,0,,0,0,0,0,0,0,2,0,Matches
Myron Boadu,nl NED,FW,Monaco,21,2001,3.3,3,3,0,2,1,1,7,14.3,6,1,0,1,0,3,1,0,Matches
Jérôme Boateng,de GER,DF,Lyon,33,1988,4.8,3,0,2,1,0,2,6,33.3,4,8,5,3,6,9,16,0,Matches
Antonin Bobichon,fr FRA,MF,Angers,26,1995,0.2,0,0,0,0,0,0,0,,0,1,0,1,0,0,0,0,Matches
Quentin Boisgard,fr FRA,MF,Lorient,25,1997,2.0,6,2,1,4,1,3,4,75.0,1,3,1,2,4,10,2,0,Matches
Neto Borges,br BRA,DF,Clermont Foot,25,1996,31.5,75,45,45,20,10,46,75,61.3,29,45,11,34,41,116,62,1,Matches
Kenji-Van Boto,mg MAD,DF,Auxerre,26,1996,2.0,3,2,2,0,1,2,4,50.0,2,0,0,0,1,4,3,0,Matches
Kouamé Botué,bf BFA,"FW,MF",Ajaccio,19,2002,2.5,4,2,2,1,1,0,2,0.0,2,1,0,1,0,4,1,0,Matches
Badredine Bouanani,dz ALG,"FW,MF",Nice,17,2004,9.6,13,9,2,7,4,7,14,50.0,7,4,0,4,1,14,2,0,Matches
Hicham Boudaoui,dz ALG,MF,Nice,22,1999,20.8,67,32,31,30,6,35,53,66.0,18,34,5,29,36,103,16,0,Matches
Franci Bouebari,fr FRA,DF,Strasbourg,18,2003,0.8,3,0,1,2,0,3,5,60.0,2,0,0,0,2,5,2,0,Matches
Sofiane Boufal,ma MAR,"FW,MF",Angers,28,1993,9.3,14,9,7,4,3,3,14,21.4,11,6,0,6,5,19,1,0,Matches
Ismaël Boura,km COM,"DF,FW",Lens,21,2000,1.0,6,4,4,2,0,5,6,83.3,1,2,1,1,2,8,3,0,Matches
Benjamin Bourigeaud,fr FRA,"MF,FW",Rennes,28,1994,34.1,45,29,16,23,6,21,65,32.3,44,38,3,35,31,76,32,0,Matches
Bilal Brahimi,dz ALG,"FW,MF",Nice,22,2000,8.9,8,5,2,5,1,1,7,14.3,6,4,0,4,4,12,0,0,Matches
Lilian Brassier,fr FRA,DF,Brest,22,1999,34.4,42,30,31,8,3,23,32,71.9,9,42,19,23,53,95,132,1,Matches
Andreas Bruus,dk DEN,"DF,FW",Troyes,23,1999,18.1,12,6,9,3,0,8,20,40.0,12,13,2,11,17,29,24,0,Matches
Joe Bryan,eng ENG,"MF,DF",Nice,28,1993,2.0,5,4,3,2,0,4,4,100.0,0,2,0,2,1,6,1,0,Matches
Adam Buksa,pl POL,"FW,MF",Lens,26,1996,1.1,1,0,0,0,1,0,3,0.0,3,0,0,0,0,1,0,0,Matches
Maxime Busi,be BEL,DF,Reims,22,1999,11.6,21,16,9,11,1,13,29,44.8,16,14,6,8,14,35,24,0,Matches
Marcin Bułka,pl POL,GK,Nice,22,1999,2.0,0,0,0,0,0,0,1,0.0,1,0,0,0,1,1,0,0,Matches
Rémy Cabella,fr FRA,"MF,FW",Lille,32,1990,28.1,64,37,21,28,15,29,64,45.3,35,41,5,36,17,81,7,1,Matches
Jimmy Cabot,fr FRA,"DF,MF",Lens,28,1994,5.7,20,12,10,8,2,12,26,46.2,14,5,0,5,4,24,12,0,Matches

Jens Cajuste,se SWE,MF,Reims,22,1999,17.0,46,25,25,14,7,25,48,52.1,23,30,6,24,18,64,22,0,Matches
Duje Ćaleta-Car,hr CRO,DF,Marseille,25,1996,0.1,0,0,0,0,0,0,0,,0,0,0,0,0,0,1,0,Matches
Mahdi Camara,fr FRA,MF,Brest,24,1998,20.2,63,36,18,38,7,25,43,58.1,18,35,4,31,40,103,16,0,Matches
Mohamed Camara,ml MLI,MF,Monaco,22,2000,24.4,83,45,38,39,6,48,92,52.2,44,45,6,39,27,110,14,1,Matches
Ousmane Camara,gn GUI,"FW,MF",Auxerre,20,2001,0.3,1,1,0,0,1,0,0,,0,0,0,0,0,1,0,0,Matches
Ousmane Camara,fr FRA,DF,Angers,19,2003,5.8,10,6,5,5,0,5,12,41.7,7,4,2,2,11,21,15,0,Matches
Axel Camblan,fr FRA,"FW,MF",Brest,18,2003,0.8,2,2,1,1,0,0,1,0.0,1,0,0,0,0,2,0,0,Matches
Pierrick Capelle,fr FRA,"MF,DF",Angers,35,1987,15.9,36,21,17,15,4,22,55,40.0,33,24,3,21,15,51,24,0,Matches
Maxence Caqueret,fr FRA,MF,Lyon,22,2000,30.7,87,54,27,38,22,43,109,39.4,66,45,3,42,39,126,27,0,Matches
Irvin Cardona,fr FRA,"FW,MF",Brest,24,1997,2.6,2,0,1,1,0,0,3,0.0,3,3,0,3,2,4,2,0,Matches
Igor Carioca,br BRA,DF,Lorient,25,1996,5.1,18,11,12,2,4,12,21,57.1,9,7,0,7,5,23,17,0,Matches
Matis Carvalho,pt POR,GK,Montpellier,23,1999,1.5,0,0,0,0,0,0,0,,0,0,0,0,1,1,0,0,Matches
Jean-Charles Castelletto,cm CMR,DF,Nantes,27,1995,28.5,43,26,29,12,2,22,36,61.1,14,35,22,13,58,101,90,0,Matches
Yoann Cathline,fr FRA,"FW,MF",Lorient,20,2002,12.1,19,12,7,6,6,5,12,41.7,7,10,1,9,8,27,16,1,Matches
Maximiliano Caufriez,be BEL,DF,Clermont Foot,25,1997,24.7,40,24,31,8,1,20,28,71.4,8,33,18,15,34,74,70,0,Matches
Fabien Centonze,fr FRA,DF,Nantes,26,1996,18.8,58,37,30,22,6,30,42,71.4,12,24,7,17,44,102,55,1,Matches
Florian Chabrolle,fr FRA,MF,Ajaccio,24,1998,3.7,6,4,1,5,0,2,4,50.0,2,3,0,3,7,13,2,0,Matches
El Chadaille Bitshiabu,fr FRA,DF,Paris S-G,17,2005,6.5,10,7,7,2,1,3,12,25.0,9,9,7,2,9,19,13,3,Matches
Fares Chaïbi,dz ALG,"FW,MF",Toulouse,19,2002,26.0,31,18,8,15,8,17,50,34.0,33,38,5,33,19,50,36,1,Matches
Muhammed Cham,at AUT,MF,Clermont Foot,21,2000,21.9,30,15,15,4,11,13,35,37.1,22,13,0,13,7,37,5,0,Matches
Gaëtan Charbonnier,fr FRA,"FW,MF",Auxerre,33,1988,2.8,2,1,0,2,0,0,4,0.0,4,2,0,2,0,2,5,0,Matches
Brendan Chardonnet,fr FRA,DF,Brest,27,1994,27.7,45,27,27,18,0,20,38,52.6,18,40,19,21,63,108,86,1,Matches
Xavier Chavalerin,fr FRA,MF,Troyes,31,1991,27.0,82,50,39,30,13,27,71,38.0,44,31,8,23,41,123,24,0,Matches
Ivane Chegra,fr FRA,"MF,FW",Ajaccio,18,2004,2.1,8,3,6,1,1,4,11,36.4,7,0,0,0,1,9,0,0,Matches
Rayan Cherki,fr FRA,"MF,FW",Lyon,18,2003,20.8,14,8,2,5,7,8,23,34.8,15,6,0,6,5,19,1,0,Matches

Ilyes Cheti,dz ALG,DF,Angers,27,1995,2.3,6,4,4,0,2,5,8,62.5,3,5,1,4,4,10,7,0,Matches
Lucas Chevalier,fr FRA,GK,Lille,20,2001,32.0,2,1,2,0,0,2,2,100.0,0,1,0,1,2,4,7,2,Matches
Pedro Chirivella,es ESP,MF,Nantes,25,1997,22.5,33,22,12,15,6,17,44,38.6,27,24,1,23,20,53,7,0,Matches
Joris Chotard,fr FRA,MF,Montpellier,20,2001,27.3,64,34,37,23,4,40,78,51.3,38,40,11,29,40,104,42,1,Matches
Yanis Cimignani,fr FRA,"MF,DF",Ajaccio,20,2002,3.1,11,5,3,7,1,4,5,80.0,1,5,1,4,2,13,2,0,Matches
Souleymane Cissé,fr FRA,DF,Clermont Foot,19,2002,0.4,1,1,1,0,0,1,1,100.0,0,1,1,0,1,2,2,0,Matches
Alexis Claude-Maurice,fr FRA,FW,Nice,24,1998,0.7,3,2,2,1,0,3,3,100.0,0,0,0,0,2,5,1,0,Matches
Alexis Claude-Maurice,fr FRA,"MF,FW",Lens,24,1998,6.7,14,9,5,8,1,6,16,37.5,10,6,0,6,2,16,1,0,Matches
Jonathan Clauss,fr FRA,DF,Marseille,29,1992,28.8,46,28,21,16,9,23,52,44.2,29,29,4,25,31,77,40,2,Matches
Marcus Coco,fr FRA,"FW,MF",Nantes,26,1996,7.1,24,15,11,9,4,11,23,47.8,12,13,3,10,14,38,7,0,Matches
Alexandre Coeff,fr FRA,DF,Auxerre,30,1992,6.5,10,5,6,4,0,4,9,44.4,5,9,4,5,8,18,35,1,Matches
Abdu Conté,pt POR,DF,Troyes,24,1998,14.6,25,17,14,8,3,12,22,54.5,10,13,6,7,6,31,25,0,Matches
Sébastien Corchia,fr FRA,DF,Nantes,31,1990,8.7,16,6,10,2,4,11,22,50.0,11,9,3,6,14,30,21,0,Matches
David Costa,pt POR,"MF,FW",Lens,21,2001,15.6,13,7,1,10,2,7,19,36.8,12,19,1,18,11,24,6,0,Matches
Logan Costa,cv CPV,DF,Toulouse,21,2001,4.6,9,4,7,1,1,6,9,66.7,3,6,3,3,4,13,12,0,Matches
Nuno da Costa,cv CPV,"FW,MF",Auxerre,31,1991,22.3,45,23,14,23,8,11,46,23.9,35,21,1,20,20,65,15,0,Matches
Benoît Costil,fr FRA,GK,Auxerre,35,1987,19.0,2,0,2,0,0,2,4,50.0,2,0,0,0,0,2,5,0,Matches
Mathieu Coutadeur,fr FRA,MF,Ajaccio,36,1986,21.6,23,13,13,10,0,8,28,28.6,20,19,3,16,19,42,21,0,Matches
Nicolas Cozza,fr FRA,DF,Montpellier,23,1999,14.2,38,21,27,9,2,26,38,68.4,12,11,5,6,21,59,35,1,Matches
Damien Da Silva,fr FRA,DF,Lyon,34,1988,3.8,8,7,5,3,0,3,3,100.0,0,4,3,1,5,13,12,0,Matches
Andréa Dacourt,fr FRA,MF,Nice,17,2005,0.0,0,0,0,0,0,0,0,,0,0,0,0,0,0,0,0,Matches
Colin Dagba,fr FRA,"DF,MF",Strasbourg,23,1998,10.6,32,20,17,10,5,19,26,73.1,7,18,2,16,17,49,19,0,Matches
Thijs Dallinga,nl NED,FW,Toulouse,21,2000,26.1,8,6,2,2,4,1,13,7.7,12,17,3,14,3,11,20,0,Matches
Flavius Daniliuc,at AUT,DF,Nice,21,2001,1.0,2,0,2,0,0,1,1,100.0,0,4,1,3,0,2,1,0,Matches
Kévin Danois,fr FRA,MF,Auxerre,18,2004,0.0,1,1,0,1,0,0,0,,0,0,0,0,1,2,0,0,Matches

Kevin Danso,at AUT,DF,Lens,23,1998,35.9,37,19,25,11,1,19,30,63.3,11,48,34,14,33,70,124,0,Matches
Dante,br BRA,DF,Nice,38,1983,36.7,70,40,45,21,4,36,59,61.0,23,52,31,21,47,117,125,2,Matches
Achraf Dari,ma MAR,DF,Brest,23,1999,14.6,21,14,15,5,1,14,20,70.0,6,16,10,6,19,40,65,2,Matches
Jonathan David,ca CAN,FW,Lille,22,2000,35.2,24,17,6,11,7,10,27,37.0,17,20,2,18,8,32,13,0,Matches
Thibault De Smet,be BEL,DF,Reims,24,1998,19.5,24,17,10,14,0,11,37,29.7,26,28,5,23,20,44,40,1,Matches
Brecht Dejaegere,be BEL,MF,Toulouse,31,1991,20.1,40,23,10,20,10,15,51,29.4,36,25,5,20,14,54,11,0,Matches
Romain Del Castillo,fr FRA,"MF,FW",Brest,26,1996,15.8,39,24,13,17,9,16,36,44.4,20,14,1,13,11,50,5,0,Matches
Thomas Delaine,fr FRA,"DF,MF",Strasbourg,30,1992,11.9,28,14,16,6,6,13,26,50.0,13,8,3,5,16,44,9,0,Matches
Sacha Delaye,fr FRA,"FW,MF",Montpellier,20,2002,0.2,1,0,0,0,1,1,1,100.0,0,0,0,0,0,1,0,0,Matches
Andy Delort,dz ALG,FW,Nice,30,1991,8.7,2,0,1,1,0,1,2,50.0,1,0,0,0,1,3,7,0,Matches
Andy Delort,dz ALG,FW,Nantes,30,1991,5.2,5,4,1,2,2,2,6,33.3,4,3,0,3,0,5,2,0,Matches
Karamoko Dembélé,eng ENG,"FW,MF",Brest,19,2003,2.0,2,0,1,1,0,2,2,100.0,0,1,0,1,1,3,0,0,Matches
Moussa Dembélé,fr FRA,"FW,MF",Lyon,26,1996,9.7,8,4,3,3,2,4,7,57.1,3,5,0,5,2,10,6,0,Matches
Siriki Dembélé,ci CIV,"MF,FW",Auxerre,25,1996,4.1,10,6,4,3,3,4,12,33.3,8,2,0,2,1,11,2,0,Matches
Branco van den Boomen,nl NED,MF,Toulouse,27,1995,32.1,71,36,26,32,13,36,89,40.4,53,27,4,23,10,81,27,2,Matches
Rémy Descamps,fr FRA,GK,Nantes,26,1996,1.0,0,0,0,0,0,0,0,,0,0,0,0,0,0,0,0,Matches
Mikkel Desler,dk DEN,DF,Toulouse,27,1995,25.1,71,38,36,27,8,43,67,64.2,24,35,6,29,36,107,48,2,Matches
Mamadou Diakhon,fr FRA,FW,Reims,16,2005,0.2,2,0,2,0,0,0,1,0.0,1,1,0,1,1,3,0,0,Matches
Bafodé Diakité,fr FRA,DF,Lille,21,2001,29.5,54,35,23,24,7,32,57,56.1,25,37,8,29,17,71,58,0,Matches
Ibrahim Diakité,gn GUI,DF,Reims,18,2003,1.5,3,3,3,0,0,2,3,66.7,1,0,0,0,5,8,6,0,Matches
Baila Diallo,fr FRA,"DF,MF",Clermont Foot,21,2001,1.0,1,0,1,0,0,0,0,,0,1,1,0,0,1,1,0,Matches
Habib Diallo,sn SEN,FW,Strasbourg,27,1995,32.0,18,10,8,7,3,6,16,37.5,10,19,4,15,12,30,26,0,Matches
Ismael Diallo,ci CIV,DF,Ajaccio,25,1997,24.2,46,33,35,9,2,35,63,55.6,28,26,12,14,30,76,46,1,Matches
Habib Diarra,sn SEN,"MF,FW",Strasbourg,18,2004,18.1,24,16,10,11,3,15,29,51.7,14,17,1,16,11,35,13,0,Matches
Moussa Diarra,ml MLI,DF,Toulouse,21,2000,13.6,20,9,9,9,2,9,15,60.0,6,25,10,15,19,39,27,1,Matches

Stéphane Diarra,fr FRA,"FW,MF",Lorient,23,1998,11.8,25,17,14,9,2,11,29,37.9,18,13,1,12,22,47,9,0,Matches
Krépin Diatta,sn SEN,"MF,FW",Monaco,23,1999,23.0,30,21,4,17,9,13,32,40.6,19,29,1,28,17,47,12,0,Matches
Mory Diaw,sn SEN,GK,Clermont Foot,29,1993,37.0,0,0,0,0,0,0,4,0.0,4,0,0,0,2,2,13,5,Matches
Bamba Dieng,sn SEN,"FW,MF",Marseille,22,2000,2.2,4,4,2,1,1,3,4,75.0,1,5,1,4,0,4,0,0,Matches
Bamba Dieng,sn SEN,FW,Lorient,22,2000,8.3,19,10,5,12,2,3,11,27.3,8,6,0,6,2,21,6,0,Matches
Tristan Dingomé,cm CMR,MF,Troyes,31,1991,1.1,1,1,0,1,0,0,2,0.0,2,0,0,0,0,1,0,0,Matches
Sinaly Diomande,ci CIV,DF,Lyon,21,2001,21.7,42,24,26,15,1,31,49,63.3,18,26,13,13,49,91,75,1,Matches
Lois Diony,fr FRA,FW,Angers,29,1992,5.6,1,0,0,1,0,1,3,33.3,2,2,0,2,0,1,1,0,Matches
Edan Diop,fr FRA,"DF,FW",Monaco,17,2004,2.5,13,8,3,3,7,7,15,46.7,8,7,1,6,4,17,1,0,Matches
Sofiane Diop,fr FRA,"MF,FW",Nice,22,2000,13.6,23,11,12,6,5,7,20,35.0,13,14,2,12,16,39,5,0,Matches
Sofiane Diop,fr FRA,MF,Monaco,22,2000,0.7,0,0,0,0,0,0,0,,0,0,0,0,1,1,0,0,Matches
Yehvann Diouf,fr FRA,GK,Reims,22,1999,31.0,2,0,2,0,0,1,3,33.3,2,0,0,0,1,3,13,5,Matches
Axel Disasi,fr FRA,DF,Monaco,24,1998,37.0,30,20,13,13,4,13,27,48.1,14,51,31,20,56,86,112,2,Matches
Tiago Djaló,pt POR,DF,Lille,22,2000,22.4,31,21,23,7,1,13,20,65.0,7,17,11,6,23,54,60,1,Matches
Alexander Djiku,gh GHA,DF,Strasbourg,27,1994,29.7,53,36,37,16,0,26,46,56.5,20,45,19,26,66,119,151,3,Matches
Moussa Djitte,sn SEN,FW,Ajaccio,22,1999,1.5,1,0,0,0,1,1,2,50.0,1,0,0,0,0,1,1,0,Matches
Ouparine Djoco,gw GNB,GK,Clermont Foot,24,1998,1.0,0,0,0,0,0,0,0,,0,0,0,0,0,0,1,0,Matches
Alan Do Marcolino,ga GAB,FW,Rennes,20,2002,0.2,0,0,0,0,0,0,0,,0,0,0,0,0,0,1,0,Matches
Jeremy Doku,be BEL,"MF,FW",Rennes,20,2002,14.3,25,16,6,13,6,12,24,50.0,12,10,0,10,5,30,2,0,Matches
Kyliane Dong,fr FRA,"MF,FW",Troyes,17,2004,2.4,3,1,0,2,1,1,2,50.0,1,1,0,1,1,4,0,0,Matches
Jordan Dongmo,cm CMR,MF,Troyes,21,2001,0.2,1,0,0,1,0,1,1,100.0,0,0,0,0,0,1,0,0,Matches
Gianluigi Donnarumma,it ITA,GK,Paris S-G,23,1999,37.9,1,0,1,0,0,1,2,50.0,1,0,0,0,0,1,12,4,Matches
Jodel Dossou,bj BEN,"MF,DF",Clermont Foot,30,1992,2.9,7,4,3,2,2,4,4,100.0,0,2,1,1,1,8,0,0,Matches
Lohann Doucet,fr FRA,"MF,FW",Nantes,19,2002,1.0,3,0,2,0,1,3,4,75.0,1,2,0,2,2,5,4,0,Matches
Siriné Doucouré,ml MLI,"FW,MF",Lorient,20,2002,1.5,2,2,2,0,0,1,2,50.0,1,0,0,0,1,3,0,0,Matches

Désiré Doué,fr FRA,"MF,FW",Rennes,17,2005,12.4,37,18,10,23,4,13,32,40.6,19,17,1,16,13,50,3,0,Matches
Guela Doué,ci CIV,"FW,MF",Rennes,19,2002,0.1,0,0,0,0,0,0,0,,0,0,0,0,0,0,0,0,Matches
Ismaël Doukouré,fr FRA,"DF,MF",Strasbourg,19,2003,25.5,48,24,23,21,4,20,34,58.8,14,26,8,18,27,75,54,0,Matches
Kamory Doumbia,ml MLI,MF,Reims,19,2003,12.8,31,16,9,14,8,12,37,32.4,25,17,1,16,13,44,3,0,Matches
Souleyman Doumbia,ci CIV,"DF,FW",Angers,25,1996,19.9,45,31,31,13,1,17,31,54.8,14,20,3,17,27,72,27,1,Matches
Rémy Dugimont,fr FRA,"FW,MF",Auxerre,36,1986,1.3,2,1,0,1,1,1,2,50.0,1,3,0,3,0,2,5,0,Matches
Maxime Dupé,fr FRA,GK,Toulouse,29,1993,38.0,0,0,0,0,0,0,0,,0,0,0,0,0,0,9,3,Matches
Jean-Kevin Duverne,ht HAI,DF,Brest,25,1997,27.9,72,38,44,24,4,42,73,57.5,31,33,5,28,28,100,65,1,Matches
Hugo Ekitike,fr FRA,FW,Paris S-G,20,2002,12.8,12,4,1,10,1,4,12,33.3,8,12,0,12,9,21,3,0,Matches
Alberth Elis,hn HON,"MF,FW",Brest,26,1996,2.9,4,3,1,2,1,1,7,14.3,6,1,0,1,1,5,2,0,Matches
Breel Embolo,ch SUI,FW,Monaco,25,1997,20.7,15,9,2,7,6,5,10,50.0,5,14,3,11,5,20,12,0,Matches
Maxime Estève,fr FRA,DF,Montpellier,20,2002,18.3,24,13,17,5,2,12,17,70.6,5,28,17,11,34,58,90,0,Matches
Fábio,br BRA,"DF,MF",Nantes,32,1990,2.5,4,2,1,2,1,4,6,66.7,2,2,0,2,3,7,11,0,Matches
Noah Fadiga,sn SEN,DF,Brest,22,1999,14.5,30,21,18,9,3,14,26,53.8,12,17,7,10,26,56,18,0,Matches
Wout Faes,be BEL,DF,Reims,24,1998,3.0,1,1,1,0,0,1,2,50.0,1,6,3,3,7,8,19,0,Matches
Romain Faivre,fr FRA,"MF,FW",Lorient,24,1998,13.8,13,8,5,4,4,5,25,20.0,20,11,0,11,1,14,4,0,Matches
Romain Faivre,fr FRA,MF,Lyon,24,1998,3.3,6,3,2,2,2,1,3,33.3,2,3,0,3,0,6,0,0,Matches
Fallou Fall,sn SEN,DF,Reims,18,2004,0.4,0,0,0,0,0,0,1,0.0,1,3,3,0,0,0,4,0,Matches
Khalil Fayad,fr FRA,MF,Montpellier,18,2004,8.0,30,14,12,16,2,12,21,57.1,9,8,1,7,9,39,4,0,Matches
Cheikh Faye,sn SEN,FW,Montpellier,23,1999,0.4,0,0,0,0,0,0,0,,0,0,0,0,1,1,0,0,Matches
Jordan Ferri,fr FRA,MF,Montpellier,30,1992,30.4,55,35,32,19,4,30,89,33.7,59,22,6,16,26,81,21,0,Matches
Karol Fila,pl POL,DF,Strasbourg,24,1998,0.5,0,0,0,0,0,0,0,,0,0,0,0,1,1,1,0,Matches
Alexis Flips,fr FRA,"FW,MF",Reims,22,2000,22.0,51,30,18,17,16,27,64,42.2,37,35,5,30,24,75,12,0,Matches
Seko Fofana,ci CIV,MF,Lens,27,1995,34.1,28,13,8,18,2,15,39,38.5,24,17,4,13,19,47,14,0,Matches
Yahia Fofana,ci CIV,GK,Angers,21,2000,11.0,0,0,0,0,0,0,0,,0,0,0,0,1,1,4,1,Matches

Youssouf Fofana,fr FRA,MF,Monaco,23,1999,34.3,81,41,31,42,8,38,74,51.4,36,50,6,44,56,137,32,1,Matches
Thomas Foket,be BEL,DF,Reims,27,1994,22.0,35,22,18,11,6,17,46,37.0,29,21,7,14,33,68,29,2,Matches
José Fonte,pt POR,DF,Lille,38,1983,28.8,23,17,18,4,1,10,21,47.6,11,27,14,13,25,48,112,2,Matches
Steven Fortes,cv CPV,DF,Lens,30,1992,0.1,0,0,0,0,0,0,0,,0,0,0,0,0,0,0,0,Matches
Przemysław Frankowski,pl POL,"DF,MF",Lens,27,1995,31.5,77,51,37,31,9,39,80,48.8,41,38,6,32,41,118,42,2,Matches
Angelo Fulgini,fr FRA,"MF,FW",Lens,25,1996,9.5,14,7,2,4,8,5,14,35.7,9,11,0,11,8,22,2,0,Matches
Gauthier Gallon,fr FRA,GK,Troyes,29,1993,29.6,2,2,2,0,0,2,4,50.0,2,0,0,0,2,4,17,0,Matches
Kévin Gameiro,fr FRA,FW,Strasbourg,35,1987,23.3,20,10,6,10,4,8,28,28.6,20,10,1,9,9,29,0,0,Matches
Ignatius Ganago,cm CMR,"FW,MF",Nantes,23,1999,16.9,9,7,2,3,4,4,7,57.1,3,13,1,12,2,11,12,0,Matches
Ignatius Ganago,cm CMR,FW,Lens,23,1999,0.7,0,0,0,0,0,0,0,,0,0,0,0,0,0,1,0,Matches
Johan Gastien,fr FRA,MF,Clermont Foot,34,1988,28.9,62,34,30,23,9,38,111,34.2,73,37,7,30,36,98,25,1,Matches
Denis Genreau,au AUS,MF,Toulouse,23,1999,7.3,35,13,16,12,7,13,31,41.9,18,16,1,15,8,43,9,0,Matches
Valère Germain,fr FRA,"FW,MF",Montpellier,32,1990,7.6,13,11,3,5,5,4,12,33.3,8,8,0,8,6,19,12,0,Matches
Gerson,br BRA,MF,Marseille,25,1997,4.6,6,4,1,4,1,3,5,60.0,2,5,0,5,2,8,4,0,Matches
Ismaël Gharbi,es ESP,"MF,FW",Paris S-G,18,2004,0.6,0,0,0,0,0,0,2,0.0,2,2,0,2,3,3,0,0,Matches
Faouzi Ghoulam,dz ALG,DF,Angers,31,1991,5.3,3,3,1,1,1,3,5,60.0,2,4,2,2,4,7,12,1,Matches
Samuel Gigot,fr FRA,DF,Marseille,28,1993,20.9,46,24,22,21,3,12,15,80.0,3,24,7,17,45,91,85,1,Matches
Andrei Girotto,br BRA,"DF,MF",Nantes,30,1992,35.0,122,73,71,45,6,74,132,56.1,58,55,24,31,73,195,176,1,Matches
Aleksandr Golovin,ru RUS,"MF,FW",Monaco,26,1996,27.4,62,36,19,32,11,28,72,38.9,44,28,1,27,37,99,10,0,Matches
André Gomes,pt POR,MF,Lille,29,1993,18.1,37,19,12,17,8,19,52,36.5,33,20,5,15,9,46,16,1,Matches
Angel Gomes,eng ENG,MF,Lille,21,2000,31.3,41,19,12,21,8,18,49,36.7,31,22,2,20,13,54,11,1,Matches
Maxime Gonalons,fr FRA,MF,Clermont Foot,33,1989,16.1,52,32,25,21,6,25,53,47.2,28,21,1,20,20,72,7,1,Matches
Oumar Gonzalez,cm CMR,DF,Ajaccio,24,1998,28.6,51,28,34,13,4,23,37,62.2,14,32,11,21,52,103,82,0,Matches
Amine Gouiri,dz ALG,"FW,MF",Nice,22,2000,2.5,1,1,1,0,0,0,1,0.0,1,1,0,1,0,1,3,0,Matches
Amine Gouiri,dz ALG,"FW,MF",Rennes,22,2000,28.0,42,25,14,16,12,14,33,42.4,19,21,0,21,12,54,10,0,Matches

Jonathan Gradit,fr FRA,DF,Lens,29,1992,31.4,62,40,30,25,7,31,53,58.5,22,40,26,14,38,100,83,0,Matches
Andrew Gravillon,gp GLP,DF,Reims,24,1998,11.5,16,8,9,6,1,8,13,61.5,5,18,9,9,21,37,36,0,Matches
Adrian Grbić,at AUT,"MF,FW",Lorient,25,1996,0.3,0,0,0,0,0,0,1,0.0,1,3,0,3,0,0,0,0,Matches
Gabriel Gudmundsson,se SWE,"DF,FW",Lille,23,1999,9.3,19,11,7,10,2,12,22,54.5,10,11,2,9,10,29,20,0,Matches
Axel Gueguin,fr FRA,"FW,MF",Montpellier,17,2005,0.3,0,0,0,0,0,0,0,,0,1,0,1,0,0,0,0,Matches
Mattéo Guendouzi,fr FRA,MF,Marseille,23,1999,23.4,39,18,9,21,9,14,38,36.8,24,12,5,7,21,60,18,0,Matches
Evann Guessand,ci CIV,"FW,MF",Nantes,21,2001,14.0,24,16,8,13,3,6,12,50.0,6,17,1,16,9,33,6,0,Matches
Pape Gueye,sn SEN,"MF,DF",Marseille,23,1999,5.5,18,7,10,7,1,7,15,46.7,8,9,2,7,9,27,2,0,Matches
Frederic Guilbert,fr FRA,DF,Strasbourg,27,1994,16.2,47,29,18,23,6,25,43,58.1,18,24,3,21,43,90,33,1,Matches
Serhou Guirassy,gn GUI,MF,Rennes,26,1996,0.3,0,0,0,0,0,0,0,,0,0,0,0,0,0,0,0,Matches
Rafik Guitane,fr FRA,FW,Reims,23,1999,0.0,0,0,0,0,0,0,0,,0,0,0,0,0,0,1,0,Matches
Malo Gusto,fr FRA,DF,Lyon,19,2003,17.7,42,26,23,11,8,21,43,48.8,22,22,5,17,28,70,23,1,Matches
Jaouen Hadjam,dz ALG,DF,Nantes,19,2003,8.9,27,21,13,9,5,16,25,64.0,9,10,3,7,12,39,12,0,Matches
Massadio Haïdara,ml MLI,"DF,MF",Lens,29,1992,18.6,24,16,9,9,6,12,24,50.0,12,26,9,17,36,60,39,1,Matches
Achraf Hakimi,ma MAR,"DF,MF",Paris S-G,23,1998,22.8,54,34,19,20,15,31,59,52.5,28,34,2,32,16,70,19,0,Matches
Mathis Hamdi,fr FRA,DF,Troyes,18,2003,0.8,0,0,0,0,0,0,1,0.0,1,0,0,0,1,1,1,0,Matches
Ben Hamed Touré,ci CIV,FW,Ajaccio,18,2003,2.3,4,4,2,2,0,1,5,20.0,4,2,0,2,1,5,4,0,Matches
Romain Hamouma,fr FRA,"FW,MF",Ajaccio,35,1987,12.0,8,3,3,3,2,3,6,50.0,3,8,0,8,2,10,2,0,Matches
Saïd Hamulic,ba BIH,FW,Toulouse,21,2000,1.2,0,0,0,0,0,0,0,,0,0,0,0,0,0,0,0,Matches
Amine Harit,ma MAR,"MF,FW",Marseille,25,1997,5.7,6,4,0,3,3,3,8,37.5,5,4,1,3,4,10,6,0,Matches
Rhys Healey,wls WAL,FW,Toulouse,27,1994,0.7,0,0,0,0,0,0,0,,0,0,0,0,0,0,0,0,Matches
Gauthier Hein,fr FRA,"MF,FW",Auxerre,25,1996,20.8,27,20,13,11,3,18,48,37.5,30,10,0,10,6,33,10,0,Matches
Henrique,br BRA,"DF,FW",Lyon,28,1994,4.0,9,4,3,2,4,6,13,46.2,7,3,1,2,5,14,8,0,Matches
Christophe Hérelle,mq MTQ,DF,Brest,29,1992,11.8,10,4,7,2,1,4,13,30.8,9,16,11,5,20,30,48,0,Matches
Noah Holm,no NOR,"FW,MF",Reims,21,2001,2.2,6,4,2,2,2,2,5,40.0,3,0,0,0,0,6,5,0,Matches

Franck Honorat,fr FRA,"FW,MF",Brest,25,1996,28.2,41,29,20,8,13,19,34,55.9,15,22,2,20,21,62,18,0,Matches
Cédric Hountondji,bj BEN,DF,Angers,28,1994,34.4,50,36,31,17,2,19,29,65.5,10,44,22,22,59,109,132,1,Matches
Ilyes Housni,fr FRA,FW,Paris S-G,17,2005,0.1,1,1,1,0,0,1,1,100.0,0,0,0,0,0,1,0,0,Matches
Adrien Hunou,fr FRA,"MF,FW",Angers,28,1994,24.8,39,20,17,16,6,16,45,35.6,29,35,0,35,7,46,7,0,Matches
Mounaim El Idrissy,fr FRA,FW,Ajaccio,23,1999,27.7,32,19,5,20,7,10,36,27.8,26,22,0,22,13,45,20,0,Matches
Rareş Ilie,ro ROU,"MF,FW",Nice,19,2003,1.6,3,3,0,1,2,2,4,50.0,2,2,0,2,1,4,1,0,Matches
Bonke Innocent,ng NGA,MF,Lorient,26,1996,13.1,28,17,13,14,1,11,36,30.6,25,22,5,17,26,54,31,0,Matches
Ismaily,br BRA,DF,Lille,32,1990,19.8,41,18,16,16,9,17,32,53.1,15,25,5,20,21,62,39,0,Matches
Junya Ito,jp JPN,FW,Reims,29,1993,32.4,40,20,14,15,11,13,53,24.5,40,29,1,28,8,48,4,1,Matches
Ismail Jakobs,sn SEN,"DF,FW",Monaco,22,1999,12.4,11,5,7,3,1,5,12,41.7,7,9,1,8,9,20,18,0,Matches
Marin Jakoliš,hr CRO,FW,Angers,25,1996,0.3,1,1,0,0,1,0,0,,0,0,0,0,0,1,0,0,Matches
Léo Jardim,br BRA,GK,Lille,27,1995,6.0,0,0,0,0,0,0,1,0.0,1,0,0,0,0,0,0,1,Matches
Luis Javier Suárez,co COL,FW,Marseille,24,1997,3.3,4,1,1,2,1,1,4,25.0,3,1,0,1,3,7,6,0,Matches
Dany Jean,ht HAI,"DF,MF",Strasbourg,19,2002,0.1,0,0,0,0,0,0,1,0.0,1,1,0,1,0,0,0,0,Matches
Julian Jeanvier,gn GUI,DF,Auxerre,30,1992,19.6,32,17,24,8,0,13,22,59.1,9,24,17,7,27,59,96,1,Matches
Jeffinho,br BRA,FW,Lyon,22,1999,5.0,17,4,4,9,4,6,15,40.0,9,6,0,6,1,18,0,0,Matches
Paul Joly,fr FRA,DF,Auxerre,22,2000,9.6,33,21,21,10,2,19,35,54.3,16,13,2,11,24,57,29,2,Matches
Jubal,br BRA,DF,Auxerre,28,1993,35.7,41,26,29,11,1,19,38,50.0,19,57,34,23,53,94,193,0,Matches
Christopher Jullien,fr FRA,DF,Montpellier,29,1993,29.9,46,28,29,14,3,28,51,54.9,23,35,18,17,43,89,114,1,Matches
Eli Junior Kroupi,fr FRA,"FW,MF",Lorient,16,2006,0.1,0,0,0,0,0,0,1,0.0,1,0,0,0,1,1,0,0,Matches
Issa Kaboré,bf BFA,DF,Marseille,21,2001,11.4,33,19,10,18,5,21,32,65.6,11,11,1,10,12,45,21,1,Matches
Abdoul Kader Bamba,fr FRA,"FW,MF",Nantes,28,1994,0.9,0,0,0,0,0,0,2,0.0,2,3,1,2,0,0,1,0,Matches
Gaël Kakuta,cd COD,FW,Lens,31,1991,0.2,0,0,0,0,0,0,0,,0,0,0,0,0,0,1,0,Matches
Arnaud Kalimuendo,fr FRA,FW,Rennes,20,2002,20.5,15,8,3,6,6,5,20,25.0,15,15,2,13,2,17,9,0,Matches
Gedeon Kalulu,cd COD,DF,Lorient,24,1997,27.1,64,34,43,14,7,30,48,62.5,18,32,3,29,28,92,79,2,Matches

Justin-Noël Kalumba,fr FRA,DF,Angers,17,2004,6.1,9,5,5,2,2,5,16,31.3,11,4,1,3,4,13,5,0,Matches
Waren Kamanzi,no NOR,DF,Toulouse,21,2000,7.4,16,9,9,5,2,13,19,68.4,6,8,2,6,8,24,9,0,Matches
Bingourou Kamara,sn SEN,GK,Montpellier,25,1996,4.5,0,0,0,0,0,0,0,,0,0,0,0,0,0,2,0,Matches
Nordine Kandil,fr FRA,"MF,FW",Strasbourg,20,2001,1.1,3,2,1,2,0,0,3,0.0,3,2,0,2,1,4,1,0,Matches
Ayman Kari,fr FRA,"MF,DF",Lorient,17,2004,1.1,0,0,0,0,0,0,0,,0,4,0,4,3,3,0,0,Matches
Kévin Keben Biakolo,cm CMR,DF,Toulouse,18,2004,4.0,3,2,2,0,1,0,4,0.0,4,1,0,1,5,8,9,0,Matches
Check Keita,fr FRA,DF,Reims,19,2003,7.6,12,9,9,3,0,4,9,44.4,5,6,5,1,5,17,24,1,Matches
Saîf-Eddine Khaoui,tn TUN,MF,Clermont Foot,27,1995,22.5,47,28,14,25,8,15,47,31.9,32,17,2,15,33,80,8,0,Matches
Wahbi Khazri,tn TUN,"FW,MF",Montpellier,31,1991,18.2,26,13,13,7,6,6,25,24.0,19,17,1,16,9,35,20,0,Matches
Anthony Khelifa,fr FRA,DF,Ajaccio,16,2005,0.1,0,0,0,0,0,0,0,,0,0,0,0,0,0,0,0,Matches
Presnel Kimpembe,fr FRA,DF,Paris S-G,26,1995,8.1,17,8,9,6,2,9,13,69.2,4,12,7,5,13,30,9,1,Matches
Samuel Koeberlé,fr FRA,MF,Reims,17,2004,0.0,0,0,0,0,0,0,0,,0,0,0,0,0,0,0,0,Matches
Rudy Kohon,fr FRA,DF,Troyes,18,2004,0.7,4,3,4,0,0,2,2,100.0,0,1,0,1,1,5,2,0,Matches
Sead Kolašinac,ba BIH,DF,Marseille,29,1993,24.6,52,36,24,22,6,24,37,64.9,13,19,2,17,43,95,35,1,Matches
Cheick Konaté,ml MLI,DF,Clermont Foot,18,2004,6.4,19,12,10,7,2,13,22,59.1,9,7,1,6,13,32,8,1,Matches
Ibrahima Koné,ml MLI,FW,Lorient,23,1999,17.5,24,13,3,13,8,5,11,45.5,6,13,0,13,4,28,18,0,Matches
Youssouf Koné,ml MLI,DF,Ajaccio,27,1995,10.2,28,19,24,4,0,18,25,72.0,7,9,2,7,12,40,32,1,Matches
Rominigue Kouamé,ml MLI,MF,Troyes,25,1996,29.6,44,27,28,14,2,17,41,41.5,24,32,11,21,49,93,46,1,Matches
Boubakar Kouyaté,ml MLI,DF,Montpellier,25,1997,14.0,31,18,18,11,2,19,35,54.3,16,24,14,10,34,65,73,1,Matches
Sael Kumbedi,fr FRA,DF,Lyon,17,2005,14.7,47,27,27,13,7,20,38,52.6,18,23,7,16,10,57,16,0,Matches
Grejohn Kyei,fr FRA,FW,Clermont Foot,26,1995,24.8,16,7,2,9,5,4,13,30.8,9,14,3,11,6,22,22,0,Matches
Rémy Labeau Lascary,gp GLP,"FW,MF",Lens,19,2003,1.4,4,2,4,0,0,0,0,,0,4,0,4,1,5,0,0,Matches
Gaëtan Laborde,fr FRA,FW,Nice,28,1994,27.8,45,25,13,17,15,18,40,45.0,22,27,2,25,9,54,13,0,Matches
Gaëtan Laborde,fr FRA,FW,Rennes,28,1994,2.8,1,1,1,0,0,0,1,0.0,1,1,0,1,0,1,1,0,Matches
Alexandre Lacazette,fr FRA,FW,Lyon,31,1991,32.5,43,23,7,17,19,10,29,34.5,19,23,3,20,15,58,4,0,Matches

Qazim Laçi,al ALB,MF,Ajaccio,26,1996,2.4,6,3,2,3,1,4,9,44.4,5,5,0,5,2,8,3,0,Matches
Alban Lafont,fr FRA,GK,Nantes,23,1999,37.0,0,0,0,0,0,0,1,0.0,1,0,0,0,0,0,20,4,Matches
Kenny Lala,mg MAD,DF,Brest,30,1991,15.7,36,19,19,15,2,22,38,57.9,16,15,5,10,21,57,28,0,Matches
Mohamed Lamine Bayo,gn GUI,"FW,MF",Lille,24,1998,7.2,3,3,0,2,1,0,12,0.0,12,3,1,2,0,3,1,0,Matches
Julien Laporte,fr FRA,DF,Lorient,28,1993,18.4,22,16,18,3,1,16,22,72.7,6,33,27,6,18,40,108,2,Matches
Yasser Larouci,dz ALG,"DF,MF",Troyes,21,2001,20.0,23,13,13,8,2,15,24,62.5,9,15,1,14,26,49,46,0,Matches
Armand Lauriente,fr FRA,FW,Lorient,23,1998,3.0,8,7,3,4,1,3,7,42.9,4,5,1,4,4,12,1,0,Matches
Théo Le Bris,fr FRA,"MF,DF",Lorient,19,2002,16.1,31,19,17,11,3,15,33,45.5,18,21,2,19,18,49,31,0,Matches
Julien Le Cardinal,fr FRA,DF,Lens,24,1997,1.8,6,4,5,0,1,4,6,66.7,2,3,0,3,2,8,5,0,Matches
Jérémy Le Douaron,fr FRA,"MF,FW",Brest,24,1998,23.0,15,9,5,9,1,3,27,11.1,24,29,2,27,11,26,30,0,Matches
Enzo Le Fée,fr FRA,MF,Lorient,22,2000,33.6,108,64,52,40,16,43,113,38.1,70,50,5,45,34,142,38,1,Matches
Vincent Le Goff,fr FRA,DF,Lorient,32,1989,37.0,75,32,56,16,3,45,62,72.6,17,29,9,20,41,116,105,1,Matches
Maxime Le Marchand,fr FRA,DF,Strasbourg,32,1989,22.4,39,24,23,14,2,19,31,61.3,12,22,14,8,37,76,74,0,Matches
Paolo Lebas,fr FRA,MF,Ajaccio,19,2003,0.6,0,0,0,0,0,0,0,,0,0,0,0,0,0,0,0,Matches
Jean-Louis Leca,fr FRA,GK,Lens,36,1985,1.0,0,0,0,0,0,0,0,,0,0,0,0,0,0,0,1,Matches
Benjamin Lecomte,fr FRA,GK,Montpellier,31,1991,19.0,0,0,0,0,0,0,2,0.0,2,0,0,0,0,0,6,0,Matches
Pierre Lees-Melou,fr FRA,MF,Brest,29,1993,30.7,97,55,55,37,5,57,123,46.3,66,48,13,35,52,149,46,1,Matches
Félix Lemaréchal,fr FRA,MF,Brest,18,2003,3.2,5,5,2,1,2,0,3,0.0,3,6,0,6,1,6,2,0,Matches
Mario Lemina,ga GAB,"MF,DF",Nice,28,1993,9.3,32,21,11,14,7,12,18,66.7,6,13,5,8,11,43,20,0,Matches
Donovan Léon,gf GUF,GK,Auxerre,29,1992,2.0,0,0,0,0,0,0,0,,0,0,0,0,0,0,1,0,Matches
Johann Lepenant,fr FRA,MF,Lyon,19,2002,21.5,58,34,24,27,7,32,86,37.2,54,29,5,24,28,86,17,3,Matches
Benjamin Leroy,fr FRA,GK,Ajaccio,33,1989,31.1,0,0,0,0,0,0,2,0.0,2,0,0,0,1,1,16,2,Matches
Léo Leroy,fr FRA,MF,Montpellier,22,2000,13.2,53,38,24,26,3,31,57,54.4,26,25,2,23,14,67,8,0,Matches
Alexandre Letellier,fr FRA,GK,Paris S-G,31,1990,0.1,0,0,0,0,0,0,0,,0,0,0,0,0,0,0,0,Matches
Ruan Levine,br BRA,"MF,FW",Ajaccio,23,1999,0.3,2,2,1,1,0,0,0,,0,1,0,1,2,4,0,0,Matches

Dimitri Liénard,fr FRA,"DF,MF",Strasbourg,34,1988,17.1,46,29,20,18,8,34,57,59.6,23,28,4,24,16,62,24,0,Matches
Mateusz Lis,pl POL,GK,Troyes,25,1997,8.3,0,0,0,0,0,0,1,0.0,1,1,0,1,0,0,3,0,Matches
Bradley Locko,fr FRA,DF,Reims,20,2002,11.8,31,16,21,4,6,15,27,55.6,12,17,4,13,20,51,21,0,Matches
Bradley Locko,fr FRA,DF,Brest,20,2002,3.0,4,3,2,1,1,2,3,66.7,1,4,0,4,2,6,13,0,Matches
Anthony Lopes,pt POR,GK,Lyon,31,1990,31.3,1,0,1,0,0,1,4,25.0,3,0,0,0,3,4,10,0,Matches
Rony Lopes,pt POR,"MF,FW",Troyes,26,1995,26.1,24,12,6,15,3,7,31,22.6,24,14,2,12,9,33,10,0,Matches
Pau López,es ESP,GK,Marseille,27,1994,32.5,0,0,0,0,0,0,1,0.0,1,0,0,0,0,0,5,1,Matches
Dion Lopy,sn SEN,MF,Reims,20,2002,15.3,45,24,22,16,7,23,62,37.1,39,27,3,24,22,67,18,0,Matches
Jordan Lotomba,ch SUI,DF,Nice,23,1998,27.3,65,38,33,24,8,31,48,64.6,17,38,11,27,32,97,53,0,Matches
Dejan Lovren,hr CRO,DF,Lyon,33,1989,16.2,25,19,20,5,0,20,29,69.0,9,20,10,10,26,51,70,1,Matches
Jean Lucas,br BRA,MF,Monaco,24,1998,3.2,9,5,3,5,1,6,12,50.0,6,2,1,1,4,13,2,0,Matches
Castello Lukeba,fr FRA,DF,Lyon,19,2002,33.2,39,23,27,8,4,21,31,67.7,10,42,24,18,75,114,105,1,Matches
Youssouf M'Changama,km COM,MF,Auxerre,31,1990,12.0,22,11,7,12,3,7,13,53.8,6,6,0,6,15,37,6,1,Matches
Deiver Machado,co COL,"DF,MF",Lens,28,1993,24.3,45,26,18,20,7,21,34,61.8,13,21,4,17,21,66,27,0,Matches
Soungoutou Magassa,fr FRA,MF,Monaco,18,2003,0.9,4,1,2,2,0,2,4,50.0,2,3,0,3,1,5,1,0,Matches
Hugo Magnetti,fr FRA,MF,Brest,24,1998,18.8,43,27,18,23,2,23,63,36.5,40,21,1,20,25,68,12,0,Matches
Yohann Magnin,fr FRA,MF,Clermont Foot,25,1997,26.7,89,54,37,45,7,54,106,50.9,52,50,12,38,25,114,46,0,Matches
Lovro Majer,hr CRO,"MF,FW",Rennes,24,1998,18.5,34,23,16,13,5,8,29,27.6,21,21,1,20,21,55,5,1,Matches
Jean-Victor Makengo,fr FRA,MF,Lorient,24,1998,11.8,16,8,5,10,1,6,20,30.0,14,8,5,3,10,26,13,1,Matches
Béni Makouana,cg CGO,"FW,MF",Montpellier,19,2002,2.2,1,0,0,1,0,0,2,0.0,2,3,1,2,0,1,1,0,Matches
Ruslan Malinovskyi,ua UKR,"MF,FW",Marseille,29,1993,13.6,21,11,3,12,6,10,26,38.5,16,13,1,12,3,24,9,0,Matches
Hianga Mananga Mbock,fr FRA,MF,Brest,22,1999,0.2,0,0,0,0,0,0,1,0.0,1,0,0,0,0,0,0,0,Matches
Steve Mandanda,fr FRA,GK,Rennes,37,1985,33.5,0,0,0,0,0,0,2,0.0,2,0,0,0,0,0,9,3,Matches
Thomas Mangani,fr FRA,MF,Ajaccio,35,1987,14.8,32,17,14,15,3,18,47,38.3,29,22,3,19,24,56,22,1,Matches
Vito Mannone,it ITA,GK,Lorient,34,1988,17.9,0,0,0,0,0,0,0,,0,0,0,0,0,0,4,3,Matches

Myziane Maolida,km COM,"MF,FW",Reims,23,1999,2.6,8,3,2,5,1,5,12,41.7,7,1,0,1,2,10,0,0,Matches
Faitout Maouassa,fr FRA,"FW,DF",Montpellier,24,1998,21.4,52,32,26,20,6,18,41,43.9,23,31,3,28,20,72,23,0,Matches
Vincent Marchetti,fr FRA,MF,Ajaccio,25,1997,27.2,55,26,29,19,7,25,68,36.8,43,23,3,20,19,74,31,0,Matches
Guillermo Maripán,cl CHI,DF,Monaco,28,1994,24.0,46,26,26,20,0,17,33,51.5,16,39,27,12,38,84,87,0,Matches
Marquinhos,br BRA,DF,Paris S-G,28,1994,30.2,33,25,18,12,3,18,26,69.2,8,43,27,16,23,56,83,2,Matches
Jonas Martin,fr FRA,MF,Lille,32,1990,3.1,9,7,4,5,0,5,14,35.7,9,3,1,2,7,16,3,0,Matches
Gelson Martins,pt POR,"MF,FW",Monaco,27,1995,3.8,15,8,6,4,5,4,13,30.8,9,4,1,3,3,18,2,0,Matches
Han-Noah Massengo,fr FRA,MF,Auxerre,21,2001,12.4,27,15,10,15,2,7,16,43.8,9,12,3,9,14,41,7,0,Matches
Yanis Massolin,fr FRA,MF,Clermont Foot,19,2002,0.7,2,1,1,0,1,0,1,0.0,1,1,0,1,2,4,0,0,Matches
Eliot Matazo,be BEL,MF,Monaco,20,2002,13.1,26,12,11,13,2,11,26,42.3,15,18,4,14,15,41,11,1,Matches
Chrislain Matsima,fr FRA,"DF,MF",Lorient,20,2002,2.5,0,0,0,0,0,0,0,,0,3,3,0,2,2,7,0,Matches
Chrislain Matsima,fr FRA,DF,Monaco,20,2002,5.0,11,6,7,2,2,4,7,57.1,3,5,5,0,9,20,16,0,Matches
Jean Mattéo Bahoya,fr FRA,"FW,MF",Angers,17,2005,3.0,7,3,1,3,3,4,7,57.1,3,4,0,4,0,7,0,0,Matches
Azor Matusiwa,nl NED,MF,Reims,24,1998,27.6,66,41,30,29,7,36,61,59.0,25,37,11,26,46,112,52,0,Matches
Aïman Maurer,ma MAR,MF,Clermont Foot,17,2004,5.6,2,1,1,1,0,1,10,10.0,9,1,0,1,3,5,5,0,Matches
Stephy Mavididi,eng ENG,FW,Montpellier,24,1998,14.3,24,19,12,8,4,13,27,48.1,14,21,1,20,4,28,10,0,Matches
Christian Mawissa,fr FRA,DF,Toulouse,17,2005,1.1,2,0,1,1,0,1,3,33.3,2,0,0,0,3,5,1,0,Matches
Fernand Mayembo,cg CGO,DF,Ajaccio,26,1996,7.9,8,5,6,2,0,4,9,44.4,5,2,0,2,11,19,36,0,Matches
Derek Mazou-Sacko,fr FRA,MF,Troyes,17,2004,0.2,0,0,0,0,0,0,1,0.0,1,1,0,1,1,1,1,0,Matches
Kylian Mbappé,fr FRA,FW,Paris S-G,23,1998,31.3,10,4,0,5,5,5,16,31.3,11,5,0,5,5,15,6,0,Matches
Chancel Mbemba,cd COD,DF,Marseille,27,1994,31.7,43,26,24,17,2,22,31,71.0,9,25,12,13,42,85,89,0,Matches
Jason Mbock,fr FRA,"MF,FW",Angers,22,1999,0.3,0,0,0,0,0,0,0,,0,0,0,0,0,0,0,0,Matches
Nathanael Mbuku,fr FRA,"FW,MF",Reims,20,2002,0.7,2,1,2,0,0,2,2,100.0,0,0,0,0,0,2,0,0,Matches
Facundo Medina,ar ARG,DF,Lens,23,1999,30.9,31,20,16,15,0,13,35,37.1,22,25,9,16,26,57,62,1,Matches
Bamo Meïté,ci CIV,DF,Lorient,20,2001,16.7,18,8,13,4,1,7,16,43.8,9,33,23,10,16,34,70,0,Matches

Farid El Melali,dz ALG,"DF,FW",Angers,25,1997,9.0,21,12,7,12,2,11,22,50.0,11,16,0,16,8,29,7,0,Matches
Birger Meling,no NOR,DF,Rennes,27,1994,13.4,24,15,9,12,3,12,25,48.0,13,18,2,16,23,47,26,0,Matches
Nuno Mendes,pt POR,DF,Paris S-G,20,2002,17.2,45,30,29,12,4,30,41,73.2,11,19,3,16,17,62,18,0,Matches
Pedro Mendes,pt POR,DF,Montpellier,31,1990,0.1,0,0,0,0,0,0,0,,0,0,0,0,0,0,0,1,Matches
Thiago Mendes,br BRA,"MF,DF",Lyon,30,1992,22.9,48,27,24,21,3,30,40,75.0,10,28,8,20,47,95,51,4,Matches
Antoine Mendy,fr FRA,DF,Nice,18,2004,5.8,22,13,16,5,1,9,15,60.0,6,6,1,5,2,24,16,0,Matches
Arial Mendy,sn SEN,DF,Clermont Foot,27,1994,2.5,4,2,3,0,1,2,2,100.0,0,2,0,2,4,8,4,0,Matches
Batista Mendy,fr FRA,"MF,DF",Angers,22,2000,31.8,70,30,34,28,8,37,53,69.8,16,38,6,32,21,91,29,2,Matches
Gideon Mensah,gh GHA,DF,Auxerre,24,1998,25.1,80,44,43,32,5,44,77,57.1,33,33,10,23,38,118,41,0,Matches
Quentin Merlin,fr FRA,DF,Nantes,20,2002,19.9,31,19,19,8,4,18,38,47.4,20,27,4,23,24,55,30,0,Matches
Lionel Messi,ar ARG,"FW,MF",Paris S-G,35,1987,31.5,26,18,1,13,12,11,27,40.7,16,11,0,11,2,28,0,0,Matches
Amine Messoussa,fr FRA,FW,Lille,17,2004,0.0,0,0,0,0,0,0,0,,0,0,0,0,0,0,0,0,Matches
Arkadiusz Milik,pl POL,FW,Marseille,28,1994,1.4,1,1,0,0,1,0,1,0.0,1,0,0,0,0,1,2,0,Matches
Takumi Minamino,jp JPN,"MF,FW",Monaco,27,1995,8.0,15,8,5,7,3,7,35,20.0,28,14,0,14,6,21,4,0,Matches
Terem Moffi,ng NGA,FW,Nice,23,1999,14.8,12,6,0,6,6,2,12,16.7,10,3,0,3,2,14,5,0,Matches
Terem Moffi,ng NGA,FW,Lorient,23,1999,15.4,8,5,1,4,3,3,5,60.0,2,11,3,8,3,11,10,0,Matches
Mostafa Mohamed,eg EGY,FW,Nantes,24,1997,21.5,18,13,5,7,6,9,20,45.0,11,23,1,22,10,28,33,0,Matches
Florent Mollet,fr FRA,MF,Nantes,30,1991,12.1,14,6,5,4,5,7,24,29.2,17,12,1,11,10,24,11,0,Matches
Marlos Moreno,co COL,"MF,DF",Troyes,25,1996,0.1,2,2,2,0,0,2,3,66.7,1,1,1,0,0,2,0,0,Matches
Lebo Mothiba,za RSA,"FW,MF",Strasbourg,26,1996,4.8,1,0,1,0,0,0,1,0.0,1,6,1,5,0,1,4,0,Matches
Steve Mounié,bj BEN,FW,Brest,27,1994,18.4,13,5,1,7,5,5,14,35.7,9,18,7,11,3,16,20,0,Matches
Bevic Moussiti-Oko,cg CGO,FW,Ajaccio,27,1995,7.8,3,1,1,1,1,1,2,50.0,1,5,3,2,2,5,8,0,Matches
Samuel Moutoussamy,cd COD,MF,Nantes,25,1996,26.7,64,34,27,28,9,26,76,34.2,50,23,2,21,24,88,15,0,Matches
François Mughe,cm CMR,MF,Marseille,18,2004,0.1,0,0,0,0,0,0,0,,0,0,0,0,0,0,0,0,Matches
Nordi Mukiele,fr FRA,DF,Paris S-G,24,1997,12.6,31,23,16,6,9,19,29,65.5,10,22,9,13,14,45,16,0,Matches

Marshall Munetsi,zw ZIM,MF,Reims,26,1996,30.0,58,27,13,31,14,20,48,41.7,28,37,11,26,26,84,41,1,Matches
Yvon Mvogo,ch SUI,GK,Lorient,28,1994,20.1,0,0,0,0,0,0,0,,0,0,0,0,2,2,6,3,Matches
Nathan N'Goumou,fr FRA,FW,Toulouse,22,2000,1.0,3,2,2,1,0,1,1,100.0,0,2,0,2,2,5,0,0,Matches
Youssouf Ndayishimiye,bi BDI,"MF,DF",Nice,23,1998,6.3,13,9,8,5,0,6,11,54.5,5,8,5,3,12,25,22,1,Matches
Papa Ndiaga Yade,mr MTN,"DF,MF",Troyes,22,2000,6.3,10,6,6,2,2,7,22,31.8,15,10,2,8,8,18,10,0,Matches
Neymar,br BRA,"MF,FW",Paris S-G,30,1992,17.2,22,14,6,9,7,9,19,47.4,10,7,1,6,4,26,1,1,Matches
Ibrahima Niane,sn SEN,FW,Angers,23,1999,12.6,6,2,1,4,1,1,6,16.7,5,8,2,6,1,7,9,0,Matches
M'Baye Niang,sn SEN,FW,Auxerre,27,1994,16.5,13,7,1,8,4,3,13,23.1,10,22,1,21,1,14,20,0,Matches
Rasmus Nicolaisen,dk DEN,DF,Toulouse,25,1997,33.3,48,21,34,14,0,29,46,63.0,17,58,45,13,50,98,152,0,Matches
Arnaud Nordin,fr FRA,FW,Montpellier,24,1998,26.7,26,14,10,12,4,12,28,42.9,16,19,1,18,14,40,7,0,Matches
Riad Nouri,fr FRA,"MF,FW",Ajaccio,37,1985,18.8,21,12,7,10,4,12,29,41.4,17,8,1,7,15,36,11,0,Matches
Alexander Nübel,de GER,GK,Monaco,25,1996,38.0,0,0,0,0,0,0,1,0.0,1,0,0,0,1,1,10,3,Matches
Gerzino Nyamsi,fr FRA,DF,Strasbourg,25,1997,17.5,28,20,14,12,2,10,12,83.3,2,19,11,8,10,38,63,1,Matches
Wilson Odobert,fr FRA,"MF,FW",Troyes,17,2004,19.6,20,14,10,7,3,9,25,36.0,16,11,0,11,15,35,5,0,Matches
Florent Ogier,fr FRA,DF,Clermont Foot,33,1989,18.9,33,16,20,12,1,22,39,56.4,17,22,13,9,18,51,64,1,Matches
Warmed Omari,km COM,DF,Rennes,22,2000,15.1,20,11,14,6,0,14,28,50.0,14,13,7,6,17,37,43,1,Matches
Jonas Omlin,ch SUI,GK,Montpellier,28,1994,13.0,1,0,1,0,0,0,0,,0,0,0,0,0,1,8,1,Matches
Ado Onaiwu,jp JPN,FW,Toulouse,26,1995,12.0,11,6,4,4,3,5,13,38.5,8,5,1,4,2,13,5,0,Matches
Jean Onana,cm CMR,"MF,DF",Lens,22,2000,9.0,28,17,8,17,3,10,22,45.5,12,15,5,10,18,46,20,0,Matches
Loïs Openda,be BEL,FW,Lens,22,2000,28.0,11,9,2,6,3,2,13,15.4,11,9,0,9,2,13,6,0,Matches
Dango Ouattara,bf BFA,"FW,MF",Lorient,20,2002,17.2,41,26,20,11,10,15,28,53.6,13,24,6,18,19,60,21,0,Matches
Zinédine Ould Khaled,fr FRA,"MF,FW",Angers,22,2000,0.6,1,1,0,1,0,0,1,0.0,1,0,0,0,2,3,0,0,Matches
Azzedine Ounahi,ma MAR,"MF,FW",Marseille,22,2000,1.3,2,1,1,1,0,0,2,0.0,2,1,0,1,0,2,0,0,Matches
Azzedine Ounahi,ma MAR,"MF,FW",Angers,22,2000,12.5,19,8,5,13,1,10,20,50.0,10,8,0,8,15,34,4,1,Matches
Adam Ounas,dz ALG,"FW,MF",Lille,25,1996,11.8,20,11,4,10,6,8,13,61.5,5,16,0,16,7,27,5,0,Matches

Ante Palaversa,hr CRO,MF,Troyes,22,2000,0.3,1,1,1,0,0,0,0,,0,0,0,0,1,2,0,0,Matches
Nicolas Pallois,fr FRA,DF,Nantes,34,1987,24.6,69,44,51,16,2,42,70,60.0,28,35,18,17,30,99,131,2,Matches
Erik Palmer-Brown,us USA,DF,Troyes,25,1997,35.5,42,27,31,10,1,18,33,54.5,15,56,29,27,26,68,166,1,Matches
Lucas Paquetá,br BRA,MF,Lyon,24,1997,1.8,5,4,0,5,0,1,3,33.3,2,2,0,2,1,6,3,0,Matches
Leandro Paredes,ar ARG,MF,Paris S-G,28,1994,0.6,1,1,1,0,0,1,1,100.0,0,2,1,1,1,2,0,0,Matches
Dimitri Payet,fr FRA,"MF,FW",Marseille,35,1987,9.3,6,4,2,2,2,3,11,27.3,8,4,0,4,0,6,4,0,Matches
Théo Pellenard,fr FRA,DF,Auxerre,28,1994,1.1,1,0,1,0,0,1,1,100.0,0,3,1,2,2,3,2,0,Matches
Timothee Pembele,fr FRA,DF,Paris S-G,19,2002,2.9,5,5,3,1,1,2,4,50.0,2,2,0,2,4,9,2,0,Matches
Patrick Pentz,at AUT,GK,Reims,25,1997,7.0,0,0,0,0,0,0,0,,0,0,0,0,0,0,1,0,Matches
Nicolas Pépé,ci CIV,"FW,MF",Nice,27,1995,16.6,25,13,14,5,6,11,25,44.0,14,17,0,17,3,28,1,0,Matches
Brayann Pereira,fr FRA,DF,Auxerre,19,2003,2.0,6,5,5,1,0,1,5,20.0,4,2,2,0,2,8,8,1,Matches
Danilo Pereira,pt POR,"DF,MF",Paris S-G,30,1991,26.8,32,17,15,14,3,19,26,73.1,7,26,19,7,36,68,59,1,Matches
Mathias Pereira Lage,pt POR,"MF,FW",Brest,25,1996,14.0,20,7,5,14,1,11,29,37.9,18,10,1,9,14,34,12,0,Matches
Gaëtan Perrin,fr FRA,"MF,FW",Auxerre,26,1996,15.5,17,8,5,6,6,8,30,26.7,22,15,0,15,10,27,9,0,Matches
Lucas Perrin,fr FRA,DF,Strasbourg,23,1998,19.6,44,27,28,14,2,25,49,51.0,24,13,5,8,36,80,53,0,Matches
Ronaël Pierre-Gabriel,fr FRA,DF,Strasbourg,24,1998,7.3,25,18,11,12,2,15,17,88.2,2,16,3,13,9,34,22,0,Matches
Julien Ponceau,fr FRA,MF,Lorient,21,2000,18.4,28,19,10,14,4,10,32,31.3,22,27,3,24,14,42,12,0,Matches
Łukasz Poręba,pl POL,MF,Lens,22,2000,2.9,5,4,2,1,2,2,3,66.7,1,3,0,3,4,9,2,0,Matches
Jackson Porozo,ec ECU,DF,Troyes,21,2000,18.0,32,20,24,7,1,13,31,41.9,18,24,17,7,33,65,75,0,Matches
Sanjin Prcić,ba BIH,MF,Strasbourg,28,1993,18.1,27,12,6,16,5,19,31,61.3,12,22,7,15,25,52,22,0,Matches
Mehdi Puch-Herrantz,fr FRA,MF,Ajaccio,18,2004,0.5,2,2,0,1,1,1,2,50.0,1,1,0,1,3,5,0,0,Matches
Ghjuvanni Quilichini,fr FRA,GK,Ajaccio,19,2002,0.9,0,0,0,0,0,0,0,,0,0,0,0,0,0,1,0,Matches
Ionuț Radu,ro ROU,GK,Auxerre,25,1997,17.0,0,0,0,0,0,0,0,,0,0,0,0,0,0,3,3,Matches
Simon Ramet,fr FRA,DF,Lille,19,2003,0.0,0,0,0,0,0,0,0,,0,0,0,0,0,0,0,0,Matches
Adil Rami,fr FRA,DF,Troyes,36,1985,17.7,19,14,13,5,1,17,32,53.1,15,23,16,7,25,44,75,3,Matches

Sergio Ramos,es ESP,DF,Paris S-G,36,1986,30.0,34,26,14,18,2,23,44,52.3,21,29,13,16,34,68,93,3,Matches
Aaron Ramsey,wls WAL,MF,Nice,31,1990,17.6,47,25,18,19,10,16,39,41.0,23,25,4,21,17,64,18,1,Matches
Lilian Raolisoa,fr FRA,"DF,MF",Angers,22,2000,1.9,11,9,6,3,2,7,10,70.0,3,3,1,2,3,14,5,0,Matches
Elba Rashani,xk KVX,"MF,FW",Clermont Foot,29,1993,24.0,39,26,13,19,7,13,39,33.3,26,27,2,25,21,60,19,0,Matches
Rafael Ratão,br BRA,"FW,MF",Toulouse,26,1995,20.6,52,36,29,16,7,27,73,37.0,46,34,0,34,21,73,7,0,Matches
Rayan Raveloson,mg MAD,"DF,MF",Auxerre,25,1997,27.0,38,23,21,16,1,23,33,69.7,10,43,12,31,39,77,70,0,Matches
Jeff Reine-Adélaïde,fr FRA,MF,Troyes,24,1998,2.6,3,2,2,1,0,1,2,50.0,1,2,0,2,2,5,1,0,Matches
Jeff Reine-Adélaïde,fr FRA,MF,Lyon,24,1998,3.7,8,5,1,5,2,5,9,55.6,4,4,0,4,6,14,0,0,Matches
Alexsandro Ribeiro,br BRA,DF,Lille,22,1999,17.9,32,18,24,7,1,19,28,67.9,9,11,2,9,25,57,59,1,Matches
Rémy Riou,fr FRA,GK,Lyon,34,1987,6.7,1,0,1,0,0,1,1,100.0,0,0,0,0,0,1,3,0,Matches
Renaud Ripart,fr FRA,"FW,MF",Troyes,29,1993,14.7,40,23,14,20,6,19,52,36.5,33,29,2,27,7,47,5,0,Matches
Joe Rodon,wls WAL,DF,Rennes,24,1997,15.7,11,7,9,2,0,4,10,40.0,6,16,12,4,9,20,54,1,Matches
Valentin Rongier,fr FRA,MF,Marseille,27,1994,33.7,93,59,33,47,13,41,77,53.2,36,50,11,39,54,147,38,1,Matches
Pablo Rosario,nl NED,"MF,DF",Nice,25,1997,19.6,46,26,22,20,4,18,34,52.9,16,15,5,10,23,69,32,1,Matches
Anthony Rouault,fr FRA,DF,Toulouse,21,2001,36.8,66,37,54,10,2,30,58,51.7,28,52,26,26,56,122,126,4,Matches
Kays Ruiz,fr FRA,MF,Auxerre,19,2002,0.7,1,1,1,0,0,0,1,0.0,1,2,1,1,3,4,0,0,Matches
Fabián Ruiz Peña,es ESP,MF,Paris S-G,26,1996,21.0,62,28,25,30,7,43,79,54.4,36,24,1,23,18,80,23,1,Matches
Halid Šabanović,ba BIH,DF,Angers,22,1999,7.1,8,6,7,1,0,6,8,75.0,2,8,2,6,8,16,12,0,Matches
Falaye Sacko,ml MLI,DF,Montpellier,27,1995,28.7,46,25,25,15,6,32,51,62.7,19,43,14,29,33,79,75,1,Matches
Wesley Saïd,fr FRA,"FW,MF",Lens,27,1995,7.2,4,1,1,2,1,2,6,33.3,4,4,0,4,1,5,2,0,Matches
Théo Sainte-Luce,fr FRA,DF,Montpellier,23,1998,5.9,13,11,8,5,0,7,14,50.0,7,7,2,5,10,23,11,0,Matches
Hamza Sakhi,fr FRA,MF,Auxerre,26,1996,18.4,44,22,22,17,5,22,42,52.4,20,16,1,15,25,69,9,0,Matches
Mamadou Sakho,fr FRA,DF,Montpellier,32,1990,8.5,9,5,4,5,0,3,5,60.0,2,17,12,5,8,17,35,1,Matches
Ibrahim Salah,ma MAR,"FW,MF",Rennes,20,2001,2.5,8,1,5,3,0,2,15,13.3,13,3,0,3,2,10,0,0,Matches
Amine Salama,fr FRA,"FW,MF",Angers,22,2000,13.9,11,9,3,7,1,2,12,16.7,10,8,2,6,10,21,2,0,Matches

Yoann Salmier,gf GUF,DF,Troyes,29,1992,29.4,51,29,34,12,5,21,35,60.0,14,34,19,15,39,90,124,0,Matches
Mama Samba Baldé,gw GNB,FW,Troyes,26,1995,29.6,46,21,14,21,11,13,28,46.4,15,30,3,27,10,56,13,0,Matches
Brice Samba,fr FRA,GK,Lens,28,1994,37.0,1,0,1,0,0,1,2,50.0,1,1,0,1,0,1,12,2,Matches
Renato Sanches,pt POR,MF,Paris S-G,24,1997,8.0,8,1,1,3,4,5,14,35.7,9,13,3,10,9,17,4,0,Matches
Alexis Sánchez,cl CHI,"FW,MF",Marseille,33,1988,29.8,27,17,5,16,6,3,24,12.5,21,14,0,14,5,32,6,0,Matches
Morgan Sanson,fr FRA,MF,Strasbourg,27,1994,15.8,36,25,10,16,10,17,56,30.4,39,21,1,20,22,58,9,0,Matches
Baptiste Santamaria,fr FRA,MF,Rennes,27,1995,20.1,41,22,13,23,5,21,41,51.2,20,21,5,16,21,62,23,0,Matches
Pablo Sarabia,es ESP,"FW,MF",Paris S-G,30,1992,4.1,5,4,2,2,1,1,7,14.3,6,3,0,3,2,7,0,0,Matches
Amin Sarr,se SWE,FW,Lyon,21,2001,6.0,9,6,1,4,4,1,4,25.0,3,2,0,2,0,9,4,0,Matches
Malang Sarr,fr FRA,DF,Monaco,23,1999,8.0,6,3,5,1,0,1,5,20.0,4,11,7,4,15,21,29,2,Matches
Mamadou Sarr,fr FRA,MF,Lyon,16,2005,0.1,0,0,0,0,0,0,0,,0,0,0,0,0,0,0,0,Matches
Téji Savanier,fr FRA,MF,Montpellier,30,1991,28.3,46,30,16,19,11,23,70,32.9,47,30,2,28,30,76,12,1,Matches
Kasper Schmeichel,dk DEN,GK,Nice,35,1986,36.0,1,0,1,0,0,1,4,25.0,3,1,0,1,1,2,11,1,Matches
Alidu Seidu,gh GHA,DF,Clermont Foot,22,2000,27.3,52,31,35,14,3,31,51,60.8,20,28,14,14,52,104,50,2,Matches
Matz Sels,be BEL,GK,Strasbourg,30,1992,38.0,4,3,4,0,0,4,4,100.0,0,0,0,0,4,8,23,0,Matches
Marvin Senaya,tg TOG,DF,Strasbourg,21,2001,0.1,0,0,0,0,0,0,1,0.0,1,1,0,1,0,0,1,0,Matches
Kaj Sierhuis,nl NED,"FW,MF",Reims,24,1998,2.4,3,3,1,0,2,0,5,0.0,5,3,1,2,1,4,2,0,Matches
Vincent Sierro,ch SUI,MF,Toulouse,26,1995,7.4,19,11,9,9,1,11,29,37.9,18,12,3,9,4,23,11,1,Matches
Caio Henrique Oliveira Silva,br BRA,DF,Monaco,25,1997,32.2,74,51,42,28,4,44,76,57.9,32,28,8,20,26,100,68,1,Matches
Abdallah Sima,sn SEN,FW,Angers,21,2001,20.4,22,13,4,15,3,7,19,36.8,12,8,0,8,4,26,19,0,Matches
Moses Simon,ng NGA,"FW,MF",Nantes,27,1995,26.1,18,9,6,7,5,7,15,46.7,8,14,1,13,11,29,3,0,Matches
Lassine Sinayoko,ml MLI,"MF,FW",Auxerre,22,1999,17.4,33,15,14,12,7,21,40,52.5,19,12,0,12,18,51,17,0,Matches
Ibrahima Sissoko,ml MLI,MF,Strasbourg,24,1997,14.6,40,22,18,17,5,22,42,52.4,20,20,6,14,10,50,19,0,Matches
Moussa Sissoko,fr FRA,MF,Nantes,32,1989,21.3,26,16,16,7,3,12,18,66.7,6,22,5,17,16,42,17,0,Matches
Naatan Skyttä,fi FIN,MF,Toulouse,20,2002,0.3,0,0,0,0,0,0,0,,0,0,0,0,1,1,0,0,Matches

Islam Slimani,dz ALG,FW,Brest,34,1988,11.0,5,3,2,2,1,0,3,0.0,3,2,0,2,1,6,11,0,Matches
Eduard Sobol,ua UKR,DF,Strasbourg,27,1995,9.7,19,10,10,6,3,9,13,69.2,4,10,1,9,8,27,19,0,Matches
Carlos Soler,es ESP,MF,Paris S-G,25,1997,13.2,20,12,6,10,4,10,19,52.6,9,12,4,8,4,24,6,0,Matches
François-Joseph Sollacaro,fr FRA,GK,Ajaccio,28,1994,6.0,0,0,0,0,0,0,0,,0,0,0,0,0,0,2,2,Matches
Florian Sotoca,fr FRA,"MF,FW",Lens,31,1990,33.9,39,19,11,17,11,15,40,37.5,25,41,2,39,29,68,51,0,Matches
Moussa Soumano,fr FRA,FW,Ajaccio,17,2005,5.5,2,2,0,1,1,0,6,0.0,6,2,0,2,0,2,0,0,Matches
Arnaud Souquet,fr FRA,"DF,FW",Montpellier,30,1992,4.0,22,16,13,7,2,11,14,78.6,3,8,3,5,4,26,4,0,Matches
Kevin Spadanuda,ch SUI,"MF,FW",Ajaccio,25,1997,11.8,29,18,15,9,5,12,33,36.4,21,18,0,18,11,40,5,0,Matches
Djed Spence,eng ENG,DF,Rennes,21,2000,6.4,14,6,8,2,4,11,18,61.1,7,10,3,7,4,18,15,0,Matches
Stijn Spierings,nl NED,MF,Toulouse,26,1996,34.7,95,67,37,49,9,43,101,42.6,58,49,11,38,53,148,44,0,Matches
Calvin Stengs,nl NED,FW,Nice,23,1998,2.4,2,2,1,0,1,1,2,50.0,1,0,0,0,0,2,0,0,Matches
Tony Strata,ro ROU,"MF,DF",Ajaccio,17,2004,1.5,4,3,4,0,0,4,5,80.0,1,2,0,2,1,5,7,0,Matches
Gabriel Suazo,cl CHI,DF,Toulouse,24,1997,14.0,38,22,20,15,3,29,63,46.0,34,21,5,16,22,60,24,1,Matches
Kamaldeen Sulemana,gh GHA,"FW,MF",Rennes,20,2002,3.6,6,3,1,4,1,1,5,20.0,4,2,0,2,4,10,2,0,Matches
Yuito Suzuki,jp JPN,"FW,MF",Strasbourg,20,2001,0.4,0,0,0,0,0,0,0,,0,3,0,3,0,0,0,0,Matches
Issiaga Sylla,gn GUI,DF,Montpellier,28,1994,14.5,28,16,19,8,1,15,31,48.4,16,19,3,16,32,60,35,0,Matches
Issiaga Sylla,gn GUI,DF,Toulouse,28,1994,15.2,28,15,14,9,5,15,34,44.1,19,15,5,10,38,66,38,0,Matches
Nicolás Tagliafico,ar ARG,DF,Lyon,29,1992,33.2,91,53,36,41,14,50,78,64.1,28,45,11,34,57,148,47,0,Matches
Waniss Taibi,fr FRA,MF,Angers,20,2002,2.1,9,5,4,4,1,2,4,50.0,2,1,0,1,2,11,2,0,Matches
Flavien Tait,fr FRA,MF,Rennes,29,1993,18.7,30,15,8,17,5,19,42,45.2,23,16,4,12,20,50,12,0,Matches
Montassar Talbi,tn TUN,DF,Lorient,24,1998,38.0,53,25,40,13,0,22,35,62.9,13,55,34,21,40,93,190,3,Matches
Thibault Tamas,fr FRA,DF,Montpellier,21,2001,0.1,0,0,0,0,0,0,0,,0,0,0,0,1,1,0,0,Matches
Florian Tardieu,fr FRA,MF,Troyes,30,1992,11.2,31,20,19,12,0,12,31,38.7,19,19,4,15,23,54,15,0,Matches
Nuno Tavares,pt POR,"DF,MF",Marseille,22,2000,26.1,56,30,19,24,13,28,56,50.0,28,32,4,28,15,71,25,0,Matches
Enzo Tchato,cm CMR,DF,Montpellier,19,2002,12.2,26,17,14,11,1,13,22,59.1,9,17,2,15,7,33,33,0,Matches

Martin Terrier,fr FRA,"FW,MF",Rennes,25,1997,14.7,25,11,7,9,9,13,24,54.2,11,15,2,13,14,39,6,0,Matches
Tetê,br BRA,"FW,MF",Lyon,22,2000,12.3,21,10,8,5,8,10,19,52.6,9,9,0,9,13,34,2,0,Matches
Arthur Theate,be BEL,DF,Rennes,22,2000,34.7,29,19,17,8,4,17,30,56.7,13,26,14,12,30,59,114,3,Matches
Sada Thioub,sn SEN,"DF,FW",Angers,27,1995,11.8,19,10,9,8,2,8,17,47.1,9,13,0,13,7,26,5,1,Matches
Adrien Thomasson,fr FRA,MF,Strasbourg,28,1993,10.4,19,9,8,6,5,9,30,30.0,21,18,0,18,3,22,2,0,Matches
Adrien Thomasson,fr FRA,"MF,FW",Lens,28,1993,14.2,24,17,8,11,5,12,45,26.7,33,25,2,23,4,28,17,0,Matches
Khéphren Thuram,fr FRA,MF,Nice,21,2001,28.3,51,25,22,23,6,19,43,44.2,24,33,13,20,38,89,34,0,Matches
Alexis Tibidi,fr FRA,"FW,MF",Troyes,18,2003,0.8,1,1,1,0,0,0,0,,0,0,0,0,0,1,0,0,Matches
Jean-Clair Todibo,fr FRA,DF,Nice,22,1999,31.9,76,48,54,19,3,41,56,73.2,15,41,19,22,41,117,110,2,Matches
Karl Toko Ekambi,cm CMR,"FW,MF",Rennes,29,1992,10.8,3,1,1,1,1,3,9,33.3,6,5,0,5,9,12,3,0,Matches
Karl Toko Ekambi,cm CMR,"FW,MF",Lyon,29,1992,15.0,9,9,2,4,3,4,15,26.7,11,12,2,10,9,18,6,0,Matches
Corentin Tolisso,fr FRA,MF,Lyon,27,1994,22.6,44,27,16,23,5,25,66,37.9,41,25,5,20,24,68,23,1,Matches
Birama Touré,ml MLI,MF,Auxerre,30,1992,37.8,80,47,35,35,10,34,93,36.6,59,54,9,45,67,147,49,0,Matches
Mohamed Toure,au AUS,"FW,MF",Reims,18,2004,0.3,0,0,0,0,0,0,0,,0,0,0,0,0,0,0,0,Matches
Souleymane Touré,fr FRA,DF,Marseille,19,2003,0.8,2,1,1,1,0,1,2,50.0,1,1,0,1,0,2,5,0,Matches
Souleymane Touré,fr FRA,DF,Auxerre,19,2003,17.6,29,13,19,9,1,16,20,80.0,4,32,12,20,26,55,56,1,Matches
Yoann Touzghar,tn TUN,FW,Ajaccio,35,1986,5.0,3,2,0,2,1,0,1,0.0,1,0,0,0,0,3,1,0,Matches
Charles Traore,ml MLI,DF,Nantes,30,1992,5.4,8,5,5,2,1,5,7,71.4,2,9,2,7,10,18,12,0,Matches
Hamari Traoré,ml MLI,DF,Rennes,30,1992,28.1,48,32,26,15,7,28,52,53.8,24,33,7,26,38,86,64,0,Matches
Théo Trinker,fr FRA,MF,Nice,21,2001,0.0,0,0,0,0,0,0,0,,0,0,0,0,0,0,0,0,Matches
Adrien Truffert,fr FRA,DF,Rennes,20,2001,21.7,62,32,36,17,9,31,46,67.4,15,32,8,24,22,84,55,0,Matches
Theocharis Tsingaras,gr GRE,MF,Toulouse,21,2000,0.1,0,0,0,0,0,0,0,,0,0,0,0,0,0,0,0,Matches
Ike Ugbo,ca CAN,"FW,MF",Troyes,23,1998,9.9,5,2,2,2,1,3,11,27.3,8,8,2,6,2,7,4,0,Matches
Lesley Ugochukwu,fr FRA,MF,Rennes,18,2004,14.8,36,19,13,20,3,16,24,66.7,8,24,10,14,21,57,16,0,Matches
Cengiz Ünder,tr TUR,"MF,DF",Marseille,25,1997,27.7,37,19,15,13,9,13,34,38.2,21,18,2,16,18,55,13,0,Matches

Jere Uronen,fi FIN,DF,Brest,28,1994,3.3,8,5,4,4,0,7,12,58.3,5,6,2,4,7,15,5,0,Matches
Yan Valery,tn TUN,DF,Angers,23,1999,27.7,54,39,28,20,6,20,37,54.1,17,35,15,20,34,88,82,0,Matches
Vanderson,br BRA,"DF,MF",Monaco,21,2001,24.6,84,48,36,34,14,44,75,58.7,31,36,9,27,48,132,36,1,Matches
Jordan Veretout,fr FRA,MF,Marseille,29,1993,31.8,56,35,17,32,7,25,53,47.2,28,22,7,15,36,92,40,2,Matches
Marco Verratti,it ITA,MF,Paris S-G,29,1992,24.4,76,49,34,36,6,38,89,42.7,51,42,6,36,27,103,11,3,Matches
João Victor,br BRA,DF,Nantes,24,1998,9.4,19,11,9,7,3,12,22,54.5,10,11,1,10,15,34,30,0,Matches
Clément Vidal,fr FRA,"DF,MF",Ajaccio,22,2000,21.1,25,15,14,11,0,18,38,47.4,20,27,16,11,27,52,73,1,Matches
Alan Virginius,fr FRA,FW,Lille,19,2003,2.9,3,2,1,1,1,0,4,0.0,4,0,0,0,2,5,1,0,Matches
Mattia Viti,it ITA,DF,Nice,20,2002,7.0,4,2,1,1,2,2,5,40.0,3,9,3,6,8,12,22,0,Matches
Vitinha,pt POR,FW,Marseille,22,2000,5.2,15,7,0,6,9,3,11,27.3,8,3,0,3,2,17,6,0,Matches
Vitinha,pt POR,MF,Paris S-G,22,2000,27.2,58,25,21,27,10,27,83,32.5,56,27,4,23,25,83,15,0,Matches
Kevin Volland,de GER,"FW,MF",Monaco,30,1992,7.1,8,4,1,5,2,2,8,25.0,6,8,0,8,2,10,0,0,Matches
Elye Wahi,fr FRA,FW,Montpellier,19,2003,27.9,9,3,2,3,4,5,14,35.7,9,14,2,12,3,12,5,0,Matches
Timothy Weah,us USA,"DF,FW",Lille,22,2000,19.4,24,14,13,9,2,16,29,55.2,13,17,3,14,23,47,18,0,Matches
Mateusz Wieteska,pl POL,DF,Clermont Foot,25,1997,34.6,41,23,28,13,0,19,33,57.6,14,44,28,16,56,97,97,4,Matches
Christopher Wooh,cm CMR,DF,Rennes,20,2001,11.2,16,7,8,8,0,9,11,81.8,2,11,5,6,6,22,49,0,Matches
Christopher Wooh,cm CMR,MF,Lens,20,2001,0.0,0,0,0,0,0,0,1,0.0,1,0,0,0,0,0,1,0,Matches
Xeka,pt POR,MF,Rennes,27,1994,6.1,10,3,6,3,1,7,16,43.8,9,11,2,9,6,16,8,0,Matches
Yusuf Yazıcı,tr TUR,MF,Lille,25,1997,2.2,0,0,0,0,0,0,0,,0,2,0,2,0,0,1,0,Matches
Darlin Yongwa,cm CMR,DF,Lorient,21,2000,8.7,13,11,7,5,1,4,15,26.7,11,13,1,12,5,18,11,0,Matches
Leny Yoro,fr FRA,DF,Lille,16,2005,8.5,11,5,8,3,0,4,9,44.4,5,6,1,5,18,29,27,1,Matches
Mohamed Youssouf,km COM,DF,Ajaccio,34,1988,27.3,72,44,41,24,7,38,61,62.3,23,32,8,24,65,137,70,0,Matches
Warren Zaïre-Emery,fr FRA,"MF,DF",Paris S-G,16,2006,10.3,17,10,5,10,2,8,29,27.6,21,11,0,11,12,29,17,0,Matches
Oliver Zandén,se SWE,"DF,MF",Toulouse,20,2001,1.6,2,1,1,0,1,2,5,40.0,3,0,0,0,1,3,7,0,Matches
Akim Zedadka,dz ALG,DF,Auxerre,27,1995,17.8,35,21,21,10,4,18,32,56.3,14,17,3,14,23,58,51,1,Matches

Akim Zedadka,dz ALG,"DF,MF",Lille,27,1995,3.9,1,1,1,0,0,0,2,0.0,2,3,0,3,2,3,6,0,Matches
Mehdi Zeffane,dz ALG,"DF,MF",Clermont Foot,30,1992,7.3,12,7,5,7,0,4,21,19.0,17,14,6,8,22,34,12,0,Matches
Arber Zeneli,xk KVX,"FW,MF",Reims,27,1995,11.1,9,3,3,3,3,5,12,41.7,7,8,0,8,2,11,2,0,Matches
Nathan Zeze,fr FRA,DF,Nantes,17,2005,0.7,3,2,2,1,0,1,1,100.0,0,0,0,0,0,3,1,0,Matches
Edon Zhegrova,xk KVX,"FW,MF",Lille,23,1999,11.7,18,12,6,7,5,12,20,60.0,8,9,0,9,2,20,2,0,Matches
Tanguy Zoukrou,fr FRA,DF,Troyes,19,2003,5.7,14,7,8,6,0,10,14,71.4,4,18,11,7,2,16,24,0,Matches
