Player,Nation,Position,Squad,Age,Year of birth,90s Played,Tackles,Tackles Won,Tackles (Def 3rd),Tackles (Mid 3rd),Tackles (Att 3rd),Dribblers Tackled,Dribbles Challenged,% of Dribblers Tackled,Challenges Lost,Blocks,Shots Blocked,Passes Blocked,Interceptions,Tkl+Int,Clearances,Errors,Matches


Rodrigo Abascal,uy URU,DF,Boavista,29,1994,27.5,46,26,33,13,0,26,40,65.0,14,59,32,27,34,80,110,3,Matches
Antonio Adán,es ESP,GK,Sporting CP,36,1987,22.0,0,0,0,0,0,0,1,0.0,1,0,0,0,0,0,3,1,Matches
Dennis Adeniran,eng ENG,MF,Portimonense,24,1999,0.1,0,0,0,0,0,0,0,,0,0,0,0,2,2,0,0,Matches
Martin Agirregabiria,es ESP,DF,Famalicão,27,1996,13.4,21,18,15,4,2,17,24,70.8,7,12,2,10,11,32,31,1,Matches
Salvador Agra,pt POR,"FW,DF",Boavista,31,1991,27.3,21,9,14,5,2,9,31,29.0,22,8,1,7,16,37,19,0,Matches
Matheus Aiás,br BRA,"FW,MF",Moreirense,26,1996,5.3,4,2,2,0,2,1,10,10.0,9,7,4,3,4,8,2,0,Matches
Alan,br BRA,MF,Moreirense,23,2000,27.3,44,32,7,25,12,9,29,31.0,20,24,2,22,7,51,5,0,Matches
Rafael Alcobia,pt POR,DF,Portimonense,20,2003,2.3,3,3,2,1,0,1,1,100.0,0,4,1,3,1,4,4,0,Matches
Alemão,br BRA,DF,Portimonense,20,2002,26.3,49,34,39,10,0,27,39,69.2,12,49,33,16,30,79,137,1,Matches
Ali Alipour,ir IRN,FW,Gil Vicente FC,27,1995,8.9,9,4,0,3,6,2,5,40.0,3,6,0,6,0,9,4,0,Matches
Almeida,br BRA,DF,Estrela,23,2000,5.4,6,5,3,3,0,3,7,42.9,4,6,4,2,3,9,19,0,Matches
Pedro Álvaro,pt POR,DF,Estoril,23,2000,19.9,11,7,11,0,0,7,12,58.3,5,21,15,6,23,34,96,0,Matches
Pedro Amador,pt POR,DF,Moreirense,24,1998,12.6,28,19,16,10,2,16,31,51.6,15,17,3,14,15,43,32,0,Matches
Artur Jorge Marques Amorim,pt POR,DF,Farense,28,1994,5.5,7,4,5,2,0,4,5,80.0,1,10,8,2,7,14,37,0,Matches
André André,pt POR,MF,Vitória,33,1989,7.3,9,4,3,5,1,6,10,60.0,4,9,1,8,4,13,7,0,Matches
Andrew,br BRA,GK,Gil Vicente FC,22,2001,32.0,0,0,0,0,0,0,0,,0,0,0,0,0,0,14,2,Matches
Jeremy Antonisse,cw CUW,FW,Moreirense,21,2002,6.1,13,8,8,5,0,8,20,40.0,12,8,1,7,5,18,9,0,Matches
Pedro Aparício,pt POR,"MF,FW",Moreirense,27,1995,3.7,2,1,1,1,0,1,6,16.7,5,0,0,0,1,3,3,0,Matches
Óscar Aranda,es ESP,"FW,MF",Famalicão,21,2002,8.0,7,4,1,4,2,2,10,20.0,8,6,2,4,1,8,1,0,Matches
Henrique Araújo,pt POR,FW,Famalicão,21,2002,7.6,3,1,0,3,0,1,3,33.3,2,3,1,2,1,4,3,0,Matches
Tiago Araújo,pt POR,"DF,MF",Estoril,22,2001,25.0,34,22,17,14,3,21,48,43.8,27,23,0,23,27,61,67,1,Matches
Tomás Araújo,pt POR,DF,Benfica,21,2002,5.4,12,9,4,3,5,5,8,62.5,3,10,4,6,8,20,18,0,Matches
Gustavo Assuncao,pt POR,MF,Famalicão,23,2000,7.0,17,12,11,6,0,10,20,50.0,10,8,2,6,9,26,16,1,Matches
Otavio Ataide,br BRA,DF,Famalicão,21,2002,15.4,31,21,24,5,2,20,31,64.5,11,33,21,12,25,56,66,0,Matches
Otavio Ataide,br BRA,DF,Porto,21,2002,12.0,11,6,9,1,1,9,15,60.0,6,10,6,4,7,18,29,0,Matches

Fredrik Aursnes,no NOR,DF,Benfica,27,1995,31.0,73,43,32,32,9,49,84,58.3,35,41,8,33,18,91,43,0,Matches
Chidozie Awaziem,ng NGA,DF,Boavista,26,1997,21.7,23,18,18,3,2,13,21,61.9,8,27,17,10,18,41,98,2,Matches
Abdul Awudu,gh GHA,"FW,MF",Vizela,22,2001,2.1,4,3,1,1,2,2,7,28.6,5,2,1,1,0,4,1,0,Matches
Amadou Ba-Sy,fr FRA,"FW,MF",Vizela,22,2001,1.3,1,1,0,1,0,0,1,0.0,1,2,1,1,1,2,0,0,Matches
Alexander Bah,dk DEN,DF,Benfica,25,1997,16.9,52,35,23,19,10,30,44,68.2,14,24,4,20,32,84,28,1,Matches
Elves Baldé,gw GNB,"FW,MF",Farense,23,1999,10.8,9,5,6,2,1,6,17,35.3,11,11,2,9,1,10,12,0,Matches
Robson Bambu,br BRA,DF,Arouca,25,1997,9.8,15,12,9,6,0,7,11,63.6,4,12,8,4,9,24,35,0,Matches
Daniel Bandeira,pt POR,MF,Vitória,23,2000,7.8,8,6,3,3,2,3,7,42.9,4,6,0,6,11,19,11,0,Matches
Simon Banza,cd COD,FW,Braga,26,1996,22.2,11,6,4,2,5,1,10,10.0,9,16,1,15,8,19,14,0,Matches
Rafael Barbosa,pt POR,"MF,FW",Farense,27,1996,9.5,12,9,5,4,3,6,11,54.5,5,8,4,4,4,16,3,0,Matches
Romário Baró,pt POR,"MF,FW",Porto,23,2000,2.5,2,2,1,1,0,1,6,16.7,5,0,0,0,1,3,4,0,Matches
Afonso Bastardo,pt POR,"FW,DF",Gil Vicente FC,18,2005,0.5,1,1,0,0,1,0,1,0.0,1,1,0,1,1,2,0,0,Matches
Afonso Bastardo,pt POR,MF,Sporting CP,18,2005,0.3,1,1,1,0,0,1,2,50.0,1,1,0,1,0,1,1,0,Matches
Gilberto Batista,gw GNB,DF,Moreirense,19,2003,2.5,3,2,3,0,0,2,4,50.0,2,5,5,0,1,4,19,1,Matches
Ricardo Batista,pt POR,GK,Casa Pia,36,1986,30.9,1,0,1,0,0,1,3,33.3,2,0,0,0,0,1,6,1,Matches
Roko Baturina,hr CRO,FW,Gil Vicente FC,23,2000,7.9,1,1,0,0,1,0,3,0.0,3,2,0,2,0,1,5,0,Matches
Bachir Belloumi,dz ALG,"FW,MF",Farense,21,2002,23.0,41,28,19,17,5,17,41,41.5,24,38,6,32,21,62,32,0,Matches
Fahem Benaissa Yahia,fr FRA,MF,Casa Pia,21,2002,0.1,0,0,0,0,0,0,1,0.0,1,0,0,0,0,0,0,0,Matches
Beni,ao ANG,MF,Casa Pia,21,2002,16.3,32,24,17,15,0,13,28,46.4,15,17,2,15,19,51,18,1,Matches
Benny,pt POR,"MF,FW",Chaves,23,2000,14.1,10,3,4,4,2,3,14,21.4,11,18,0,18,6,16,17,0,Matches
Berna,ao ANG,"FW,DF",Boavista,19,2003,3.6,15,11,8,5,2,5,10,50.0,5,5,2,3,5,20,4,0,Matches
Juan Bernat,es ESP,DF,Benfica,30,1993,0.9,0,0,0,0,0,0,2,0.0,2,2,0,2,0,0,3,0,Matches
Emmanuel Boateng,gh GHA,FW,Rio Ave,27,1996,20.7,12,9,4,6,2,3,7,42.9,4,11,3,8,5,17,16,0,Matches
Kiko Bondoso,pt POR,"FW,MF",Vizela,27,1995,2.1,5,3,1,2,2,4,6,66.7,2,2,0,2,1,6,2,0,Matches
Toni Borevkovic,hr CRO,DF,Vitória,26,1997,22.7,22,14,20,2,0,22,28,78.6,6,25,11,14,36,58,108,0,Matches

Gonçalo Borges,pt POR,"MF,FW",Porto,22,2001,3.2,7,4,6,1,0,4,8,50.0,4,3,0,3,0,7,4,0,Matches
Cristian Borja,co COL,DF,Braga,30,1993,27.2,61,33,36,23,2,23,42,54.8,19,25,5,20,22,83,55,0,Matches
Róbert Boženík,sk SVK,FW,Boavista,23,1999,28.6,16,10,0,12,4,5,16,31.3,11,12,1,11,4,20,34,0,Matches
Daniel Bragança,pt POR,MF,Sporting CP,24,1999,11.4,33,22,9,15,9,14,26,53.8,12,11,2,9,19,52,4,2,Matches
Bruno Brigido,br BRA,GK,Estrela,32,1991,26.0,2,2,2,0,0,2,4,50.0,2,1,0,1,0,2,18,0,Matches
Rafael Brito,pt POR,MF,Casa Pia,21,2002,3.8,12,8,4,5,3,4,12,33.3,8,3,1,2,5,17,8,0,Matches
Bruma,pt POR,"FW,MF",Braga,28,1994,19.1,22,12,6,12,4,8,27,29.6,19,13,1,12,6,28,4,0,Matches
Jonathan Buatu Mananga,ao ANG,DF,Gil Vicente FC,29,1993,5.0,8,4,8,0,0,5,5,100.0,0,7,3,4,1,9,23,0,Matches
Leonel Bucca,ar ARG,"MF,FW",Estrela,24,1999,9.1,36,23,15,14,7,21,39,53.8,18,11,2,9,4,40,5,0,Matches
André Bukia,cd COD,"MF,FW",Arouca,28,1995,1.7,5,4,3,1,1,3,6,50.0,3,3,0,3,1,6,1,0,Matches
Fabijan Buntić,hr CRO,GK,Vizela,26,1997,27.7,0,0,0,0,0,0,0,,0,1,0,1,0,0,18,0,Matches
Aleksandar Busnić,rs SRB,"MF,FW",Vizela,25,1997,8.5,21,12,10,9,2,10,20,50.0,10,13,4,9,6,27,23,0,Matches
Oriol Busquets,es ESP,MF,Arouca,24,1999,4.8,9,5,5,3,1,3,4,75.0,1,5,3,2,2,11,10,0,Matches
Rafael Bustamante,co COL,MF,Vizela,23,1999,7.9,16,9,10,5,1,7,25,28.0,18,17,3,14,12,28,7,0,Matches
Leonardo Buta,pt POR,DF,Gil Vicente FC,21,2002,24.3,48,30,28,15,5,33,46,71.7,13,21,8,13,28,76,65,1,Matches
Adrián Butzke,es ESP,FW,Vitória,24,1999,4.1,3,3,0,3,0,1,2,50.0,1,4,1,3,0,3,8,0,Matches
Erick Cabaco,uy URU,DF,Estoril,28,1995,3.7,5,4,3,2,0,1,3,33.3,2,4,3,1,7,12,16,0,Matches
Arthur Cabral,br BRA,FW,Benfica,25,1998,14.8,11,7,2,5,4,3,9,33.3,6,8,0,8,1,12,7,0,Matches
Jhonder Cádiz,ve VEN,FW,Famalicão,28,1995,25.6,10,7,1,6,3,2,9,22.2,7,4,2,2,1,11,21,0,Matches
João Pedro Gomes Camacho,pt POR,"FW,MF",Moreirense,29,1994,23.1,37,25,13,14,10,15,28,53.6,13,23,2,21,14,51,16,0,Matches
Ibrahima Camará,gn GUI,"MF,DF",Boavista,24,1999,5.3,4,4,2,1,1,3,6,50.0,3,4,1,3,4,8,18,0,Matches
Cambila,ao ANG,GK,Estrela,21,2002,0.2,0,0,0,0,0,0,0,,0,0,0,0,0,0,1,1,Matches
Luan Campos,br BRA,"FW,MF",Portimonense,21,2002,5.2,7,5,2,4,1,4,8,50.0,4,4,1,3,5,12,6,0,Matches
Fábio Cardoso,pt POR,DF,Porto,29,1994,13.4,5,3,1,4,0,0,2,0.0,2,12,8,4,12,17,37,0,Matches
Felippe Cardoso,br BRA,FW,Casa Pia,24,1998,17.4,14,8,1,7,6,3,13,23.1,10,7,1,6,1,15,7,0,Matches

Carlinhos,br BRA,MF,Portimonense,29,1994,31.6,44,27,14,24,6,23,44,52.3,21,12,2,10,8,52,24,2,Matches
João Carlos,br BRA,"FW,DF",Estoril,28,1995,3.5,2,1,1,1,0,0,2,0.0,2,4,0,4,1,3,2,0,Matches
Zé Carlos,pt POR,"MF,DF",Vitória,21,2001,4.7,10,5,5,5,0,6,18,33.3,12,6,1,5,6,16,7,0,Matches
Zé Carlos,pt POR,DF,Gil Vicente FC,25,1998,21.4,50,34,34,9,7,20,37,54.1,17,21,6,15,30,80,56,2,Matches
David Carmo,ao ANG,DF,Porto,24,1999,6.8,5,4,2,2,1,4,5,80.0,1,11,7,4,2,7,31,1,Matches
Marcelo Carné,br BRA,GK,Estoril,33,1990,22.0,1,1,1,0,0,1,2,50.0,1,0,0,0,0,1,8,4,Matches
Carraça,pt POR,"DF,MF",Chaves,30,1993,11.1,9,5,3,6,0,6,11,54.5,5,7,0,7,7,16,23,0,Matches
Álvaro Carreras,es ESP,DF,Benfica,20,2003,6.3,18,10,7,9,2,8,12,66.7,4,8,3,5,10,28,9,0,Matches
Ronie Carrillo,ec ECU,"FW,MF",Portimonense,26,1996,14.6,9,4,1,5,3,2,7,28.6,5,13,1,12,3,12,19,0,Matches
António Filipe de Carvalho,pt POR,GK,Estrela,38,1985,3.0,0,0,0,0,0,0,0,,0,0,0,0,0,0,1,0,Matches
Miguel Carvalho,pt POR,GK,Farense,27,1996,2.0,0,0,0,0,0,0,0,,0,0,0,0,0,0,1,0,Matches
Vitor Carvalho,br BRA,MF,Braga,26,1997,14.5,41,22,21,19,1,22,37,59.5,15,22,4,18,18,59,29,1,Matches
Facundo Cáseres,ar ARG,MF,Farense,22,2001,12.4,49,25,27,20,2,21,33,63.6,12,35,14,21,11,60,17,0,Matches
Midana Cassama,gw GNB,"FW,MF",Portimonense,20,2002,3.2,4,3,1,2,1,2,3,66.7,1,2,1,1,2,6,2,0,Matches
Cassiano,br BRA,FW,Estoril,34,1989,17.9,31,20,10,13,8,13,30,43.3,17,16,2,14,0,31,11,0,Matches
Jesús Castillo,pe PER,MF,Gil Vicente FC,22,2001,2.7,6,5,1,4,1,4,9,44.4,5,4,1,3,4,10,8,0,Matches
André Castro,pt POR,MF,Braga,35,1988,0.5,1,0,0,1,0,1,4,25.0,3,4,1,3,1,2,1,0,Matches
André Castro,pt POR,MF,Moreirense,35,1988,6.0,15,10,6,7,2,10,17,58.8,7,6,0,6,6,21,15,0,Matches
Cristian Castro,co COL,DF,Rio Ave,22,2001,0.8,0,0,0,0,0,0,2,0.0,2,1,1,0,1,1,8,0,Matches
Geny Catamo,mz MOZ,"MF,DF",Sporting CP,22,2001,18.7,25,17,12,5,8,15,33,45.5,18,19,1,18,12,37,15,0,Matches
Tidjany Chabrol,fr FRA,"FW,MF",Gil Vicente FC,21,2002,12.0,13,8,3,9,1,5,17,29.4,12,14,2,12,3,16,8,1,Matches
Charles,br BRA,GK,Vitória,29,1994,7.5,0,0,0,0,0,0,1,0.0,1,0,0,0,0,0,6,0,Matches
Chiquinho,pt POR,"FW,MF",Famalicão,23,2000,19.3,31,18,13,15,3,12,31,38.7,19,43,4,39,13,44,10,0,Matches
Chiquinho,pt POR,MF,Benfica,28,1995,2.1,5,4,1,4,0,1,3,33.3,2,1,0,1,2,7,3,0,Matches
Clayton,br BRA,FW,Casa Pia,24,1999,18.8,9,7,1,3,5,1,14,7.1,13,13,2,11,3,12,12,0,Matches

Sebastián Coates,uy URU,DF,Sporting CP,32,1990,25.3,38,19,23,14,1,24,36,66.7,12,28,19,9,24,62,81,1,Matches
Fábio Conceição,pt POR,"MF,FW",Rio Ave,22,2001,28.2,36,24,25,7,4,22,52,42.3,30,35,5,30,17,53,35,0,Matches
Francisco Conceição,pt POR,"FW,MF",Porto,20,2002,21.0,40,31,9,15,16,16,30,53.3,14,14,1,13,2,42,4,1,Matches
Leo Cordeiro,br BRA,MF,Estrela,27,1995,29.0,60,40,23,30,7,32,64,50.0,32,36,8,28,19,79,20,0,Matches
Jeriel Córdova,ve VEN,FW,Boavista,21,2002,1.7,0,0,0,0,0,0,2,0.0,2,1,0,1,0,0,1,0,Matches
Félix Correia,pt POR,FW,Gil Vicente FC,22,2001,24.1,31,22,11,11,9,21,29,72.4,8,28,2,26,21,52,16,2,Matches
João Pedro Araújo Correia,cv CPV,"DF,MF",Chaves,26,1996,23.3,19,12,10,7,2,12,41,29.3,29,21,8,13,31,50,44,1,Matches
Alberto costa,pt POR,DF,Vitória,19,2003,0.2,0,0,0,0,0,0,0,,0,0,0,0,0,0,0,0,Matches
Bruno Xavier Almeida Costa,pt POR,MF,Vizela,26,1997,6.8,3,1,1,1,1,2,9,22.2,7,4,1,3,10,13,5,0,Matches
Diogo Costa,pt POR,GK,Porto,23,1999,32.7,0,0,0,0,0,0,0,,0,0,0,0,0,0,17,2,Matches
Gonçalo Costa,pt POR,"DF,MF",Portimonense,23,2000,19.0,59,38,32,22,5,33,48,68.8,15,27,3,24,27,86,46,1,Matches
Michel Costa,br BRA,MF,Estoril,21,2001,3.3,10,4,5,3,2,6,10,60.0,4,4,0,4,2,12,6,0,Matches
Murilo Costa,br BRA,FW,Gil Vicente FC,28,1994,22.1,21,15,9,12,0,10,20,50.0,10,16,0,16,16,37,13,0,Matches
Rui Costa,pt POR,"FW,MF",Farense,27,1996,7.8,3,2,2,1,0,3,5,60.0,2,7,1,6,0,3,2,0,Matches
Tomás Costa Silva,pt POR,DF,Vizela,23,1999,29.1,74,50,42,24,8,45,79,57.0,34,33,8,25,41,115,102,1,Matches
Costinha,pt POR,"MF,DF",Rio Ave,23,2000,33.9,95,60,41,43,11,55,104,52.9,49,88,12,76,40,135,92,3,Matches
Sandro Cruz,ao ANG,"DF,MF",Chaves,22,2001,18.1,34,23,23,10,1,22,35,62.9,13,23,8,15,20,54,70,2,Matches
Florian Danho Seke,fr FRA,FW,Famalicão,23,2000,2.7,3,3,1,0,2,2,2,100.0,0,5,0,5,0,3,3,0,Matches
Ignacio De Arruabarrena,uy URU,GK,Arouca,26,1997,31.0,3,2,3,0,0,3,6,50.0,3,0,0,0,1,4,23,3,Matches
Fran Delgado,es ESP,DF,Farense,22,2001,5.5,7,2,3,3,1,4,6,66.7,2,9,2,7,2,9,8,0,Matches
Dener,br BRA,MF,Portimonense,31,1992,19.6,51,31,26,21,4,22,47,46.8,25,16,4,12,26,77,43,0,Matches
Depú,ao ANG,FW,Gil Vicente FC,23,2000,8.6,5,4,2,1,2,2,5,40.0,3,3,0,3,2,7,4,0,Matches
Ángel Di María,ar ARG,FW,Benfica,35,1988,24.6,20,12,9,8,3,7,32,21.9,25,26,0,26,8,28,3,1,Matches
Tiago Dias,pt POR,"MF,FW",Casa Pia,25,1998,8.8,8,7,4,3,1,4,14,28.6,10,15,1,14,5,13,4,0,Matches
Vinicius Dias,br BRA,GK,Gil Vicente FC,26,1997,2.0,0,0,0,0,0,0,0,,0,0,0,0,0,0,0,1,Matches

Dida,br BRA,GK,Estrela,25,1998,4.7,0,0,0,0,0,0,0,,0,1,0,1,0,0,5,0,Matches
Ousmane Diomande,ci CIV,DF,Sporting CP,19,2003,23.5,41,24,23,14,4,17,22,77.3,5,11,7,4,13,54,43,1,Matches
Álvaro djaló,es ESP,"FW,MF",Braga,23,1999,19.9,27,19,7,14,6,15,45,33.3,30,17,1,16,23,50,15,0,Matches
Mihai Dobre,ro ROU,FW,Famalicão,24,1998,3.9,5,3,4,0,1,3,12,25.0,9,4,0,4,3,8,5,0,Matches
Maxime Dominguez,ch SUI,"MF,FW",Gil Vicente FC,27,1996,25.9,46,26,16,25,5,28,68,41.2,40,51,4,47,28,74,6,2,Matches
Bruno Duarte,br BRA,FW,Farense,27,1996,25.1,15,9,1,11,3,8,27,29.6,19,24,5,19,7,22,27,0,Matches
Jorge Eduardo Sánchez,mx MEX,DF,Porto,25,1997,6.3,19,13,12,5,2,15,23,65.2,8,5,0,5,7,26,7,0,Matches
Marcus Edwards,eng ENG,"FW,MF",Sporting CP,24,1998,14.9,10,7,2,6,2,1,8,12.5,7,8,0,8,6,16,2,0,Matches
Úmaro Embaló,pt POR,"MF,FW",Rio Ave,22,2001,8.8,10,4,3,6,1,0,7,0.0,7,9,0,9,3,13,9,0,Matches
João Escoval,pt POR,DF,Vizela,26,1997,15.2,25,10,20,4,1,10,17,58.8,7,14,9,5,14,39,55,1,Matches
Ricardo Esgaio,pt POR,"MF,DF",Sporting CP,30,1993,16.6,44,22,19,18,7,22,42,52.4,20,14,2,12,7,51,35,0,Matches
Tiago Esgaio,pt POR,DF,Arouca,27,1995,25.3,61,37,37,20,4,42,68,61.8,26,36,9,27,34,95,72,0,Matches
Samuel Essende,cd COD,FW,Vizela,25,1998,29.6,9,7,1,5,3,4,9,44.4,5,21,8,13,3,12,17,0,Matches
Dario Essugo,pt POR,MF,Chaves,18,2005,12.9,29,19,15,11,3,16,25,64.0,9,21,3,18,21,50,32,0,Matches
Dario Essugo,pt POR,MF,Sporting CP,18,2005,0.4,2,2,0,2,0,1,1,100.0,0,0,0,0,0,2,0,0,Matches
Paulo Estrela Moreira,pt POR,"MF,FW",Portimonense,24,1999,5.9,14,7,6,7,1,4,15,26.7,11,11,1,10,7,21,10,0,Matches
Stephen Eustáquio,ca CAN,MF,Porto,26,1996,17.0,41,27,16,19,6,19,35,54.3,16,28,5,23,18,59,25,0,Matches
Evanilson,br BRA,FW,Porto,23,1999,22.8,19,11,2,9,8,7,13,53.8,6,15,1,14,3,22,8,0,Matches
Fabiano,br BRA,DF,Moreirense,23,2000,23.7,45,30,27,11,7,25,35,71.4,10,13,2,11,29,74,60,1,Matches
Claudio Falcão,br BRA,MF,Farense,29,1994,28.9,78,45,33,44,1,29,82,35.4,53,48,17,31,40,118,128,1,Matches
Jean Felipe,br BRA,"MF,DF",Estrela,29,1994,12.8,24,18,9,13,2,18,30,60.0,12,11,1,10,10,34,21,0,Matches
Volnei Feltes,br BRA,DF,Estoril,23,2000,16.4,19,15,10,9,0,8,24,33.3,16,21,14,7,21,40,55,2,Matches
Jorge Filipe Oliveira Fernandes,pt POR,DF,Vitória,26,1997,27.1,52,39,29,22,1,38,68,55.9,30,35,11,24,26,78,115,0,Matches
Martim Fernandes,pt POR,DF,Porto,17,2006,2.8,10,6,6,3,1,6,7,85.7,1,2,0,2,5,15,7,0,Matches
Mateus Fernandes,pt POR,MF,Estoril,19,2004,24.8,79,46,28,40,11,39,78,50.0,39,44,6,38,25,104,16,2,Matches

Mateus Fernandes,pt POR,FW,Sporting CP,19,2004,0.0,0,0,0,0,0,0,0,,0,0,0,0,0,0,0,0,Matches
Rafael Fernandes,pt POR,DF,Arouca,21,2002,8.3,12,8,8,2,2,6,7,85.7,1,6,5,1,9,21,31,0,Matches
Roger Fernandes,gw GNB,"MF,FW",Braga,17,2005,7.5,16,11,3,10,3,9,20,45.0,11,10,0,10,4,20,3,0,Matches
Rúben Fernandes,pt POR,DF,Gil Vicente FC,37,1986,29.0,18,11,15,3,0,9,21,42.9,12,33,19,14,35,53,117,1,Matches
Vasco Fernandes,pt POR,DF,Casa Pia,36,1986,10.0,8,5,7,1,0,5,9,55.6,4,13,6,7,10,18,29,0,Matches
Vasco Fernandes,pt POR,DF,Chaves,36,1986,16.8,26,14,18,7,1,17,25,68.0,8,17,9,8,9,35,68,1,Matches
Fernando,br BRA,"FW,MF",Casa Pia,30,1993,6.0,10,6,4,3,3,3,8,37.5,5,6,0,6,0,10,2,0,Matches
Filipe Ferreira,pt POR,DF,Boavista,32,1990,19.2,31,22,16,15,0,19,26,73.1,7,21,8,13,18,49,47,1,Matches
Marcelo dos Santos Ferreira,br BRA,DF,Moreirense,34,1989,26.0,36,20,28,8,0,18,31,58.1,13,39,27,12,28,64,142,0,Matches
Vitó Ferreira,pt POR,MF,Estrela,25,1997,6.4,12,7,5,7,0,7,24,29.2,17,6,0,6,4,16,9,0,Matches
Daniel Figueira,pt POR,GK,Estoril,25,1998,12.0,3,2,3,0,0,3,3,100.0,0,0,0,0,0,3,9,0,Matches
Diogo Fonseca,pt POR,DF,Estrela,21,2002,4.8,6,4,3,3,0,2,3,66.7,1,3,1,2,4,10,15,0,Matches
Tiago Fonseca Morais,pt POR,"FW,MF",Boavista,19,2003,15.3,23,17,14,6,3,12,38,31.6,26,21,1,20,10,33,7,0,Matches
Théo Fonseca,fr FRA,FW,Famalicão,23,2000,7.2,10,3,5,3,2,3,6,50.0,3,7,2,5,7,17,7,0,Matches
José Fonte,pt POR,DF,Braga,39,1983,16.8,8,3,6,2,0,3,8,37.5,5,18,13,5,20,28,70,0,Matches
Hernâni Fortes,pt POR,FW,Rio Ave,31,1991,3.8,0,0,0,0,0,0,4,0.0,4,1,1,0,1,1,1,0,Matches
André Franco,pt POR,"MF,FW",Porto,25,1998,4.9,6,5,3,3,0,4,11,36.4,7,1,0,1,4,10,5,0,Matches
Gonçalo Franco,pt POR,MF,Moreirense,22,2000,30.2,81,54,38,33,10,29,75,38.7,46,57,5,52,59,140,52,0,Matches
Afonso freitas,pt POR,"DF,MF",Vitória,23,2000,8.1,16,11,8,5,3,8,12,66.7,4,5,0,5,4,20,15,0,Matches
Iván Fresneda,es ESP,"MF,DF",Sporting CP,18,2004,0.4,4,2,3,1,0,2,3,66.7,1,1,0,1,0,4,2,0,Matches
Godfried Frimpong,nl NED,DF,Moreirense,24,1999,22.4,35,22,26,7,2,21,29,72.4,8,21,5,16,39,74,81,0,Matches
Kanya Fujimoto,jp JPN,MF,Gil Vicente FC,24,1999,22.2,26,15,7,15,4,9,15,60.0,6,23,4,19,11,37,8,0,Matches
Taichi Fukui,jp JPN,MF,Portimonense,19,2004,6.6,8,5,0,3,5,2,11,18.2,9,4,0,4,5,13,8,0,Matches
Galeno,br BRA,"FW,MF",Porto,25,1997,24.9,25,18,11,8,6,11,28,39.3,17,22,2,20,15,40,18,0,Matches
Nino Galović,hr CRO,DF,Arouca,31,1992,16.0,10,6,6,2,2,7,17,41.2,10,10,7,3,16,26,68,0,Matches

Fabrício Garcia,cv CPV,"FW,MF",Estoril,22,2001,3.7,13,10,6,4,3,7,10,70.0,3,5,0,5,1,14,3,0,Matches
Gaspar,ao ANG,DF,Estrela,25,1997,26.1,53,36,29,20,4,32,41,78.0,9,35,19,16,40,93,146,2,Matches
Bruno Gaspar,ao ANG,"MF,DF",Vitória,30,1993,25.4,37,23,21,10,6,19,32,59.4,13,35,4,31,17,54,32,1,Matches
Mory Gbane,ci CIV,MF,Gil Vicente FC,22,2000,21.2,59,36,28,21,10,32,47,68.1,15,33,15,18,27,86,52,1,Matches
André Geraldes,pt POR,"MF,DF",Casa Pia,32,1991,6.7,7,3,6,1,0,3,4,75.0,1,5,1,4,2,9,15,0,Matches
Saviour Godwin,ng NGA,"FW,MF",Casa Pia,26,1996,3.8,5,3,3,1,1,0,1,0.0,1,7,0,7,4,9,0,0,Matches
Eulânio Ângelo Chipela Gomes,gw GNB,MF,Estrela,29,1994,6.5,8,5,1,2,5,2,4,50.0,2,10,1,9,5,13,6,0,Matches
Rodrigo Gomes,pt POR,"MF,DF",Estoril,20,2003,27.2,47,30,21,19,7,19,49,38.8,30,39,6,33,25,72,53,1,Matches
Vítor Gomes,pt POR,MF,Rio Ave,35,1987,3.6,5,4,2,3,0,2,4,50.0,2,7,3,4,3,8,5,0,Matches
Victor Gomez,es ESP,DF,Braga,23,2000,22.6,41,27,18,17,6,31,49,63.3,18,22,6,16,26,67,62,1,Matches
Nuno Gonçalo Moreira,pt POR,"FW,MF",Casa Pia,24,1999,11.3,21,12,4,13,4,8,21,38.1,13,12,1,11,9,30,7,0,Matches
Nuno Gonçalo Moreira,pt POR,"FW,MF",Vizela,24,1999,10.7,14,9,6,7,1,4,14,28.6,10,14,2,12,10,24,8,1,Matches
João Gonçalves,pt POR,GK,Boavista,22,2000,34.0,1,1,1,0,0,1,4,25.0,3,0,0,0,0,1,20,2,Matches
Jota Gonçalves,pt POR,DF,Vizela,23,2000,16.1,17,8,11,5,1,9,22,40.9,13,18,11,7,21,38,97,1,Matches
Pedro Gonçalves,pt POR,"FW,MF",Sporting CP,25,1998,28.6,47,30,10,23,14,20,55,36.4,35,31,2,29,10,57,4,0,Matches
Vítor Gonçalves,pt POR,MF,Farense,31,1992,7.7,10,7,2,4,4,2,4,50.0,2,12,3,9,4,14,17,0,Matches
Cristo González,es ESP,"FW,MF",Arouca,25,1997,30.9,20,15,4,7,9,9,31,29.0,22,9,1,8,6,26,12,0,Matches
Nicolás González,es ESP,MF,Porto,21,2002,18.9,42,28,13,21,8,22,38,57.9,16,24,3,21,10,52,11,0,Matches
Tiago Gouveia,pt POR,FW,Benfica,22,2001,6.0,12,7,3,4,5,8,14,57.1,6,7,0,7,1,13,0,0,Matches
João Graça,pt POR,MF,Rio Ave,28,1995,13.3,38,25,13,18,7,20,44,45.5,24,8,3,5,9,47,9,0,Matches
Marko Grujić,rs SRB,MF,Porto,27,1996,3.2,17,13,5,11,1,11,13,84.6,2,4,1,3,6,23,4,0,Matches
Gonçalo Guedes,pt POR,"FW,MF",Benfica,26,1996,1.4,1,0,0,1,0,1,3,33.3,2,0,0,0,1,2,0,0,Matches
Guga,pt POR,"DF,MF",Portimonense,19,2003,17.0,56,34,31,20,5,30,60,50.0,30,18,7,11,16,72,29,0,Matches
Ricardo Guimarães,mz MOZ,MF,Chaves,27,1995,13.9,35,19,20,11,4,18,37,48.6,19,16,5,11,18,53,15,1,Matches
Rafik Guitane,fr FRA,"FW,MF",Estoril,24,1999,30.1,18,9,5,10,3,5,18,27.8,13,18,1,17,7,25,3,0,Matches

Raphael Guzzo,pt POR,"MF,FW",Chaves,28,1995,13.2,13,7,7,3,3,2,11,18.2,9,17,6,11,11,24,13,0,Matches
Viktor Gyökeres,se SWE,FW,Sporting CP,25,1998,32.4,16,11,3,5,8,3,6,50.0,3,13,1,12,5,21,22,0,Matches
Justin de Haas,nl NED,DF,Famalicão,23,2000,17.8,23,16,17,6,0,11,21,52.4,10,16,12,4,24,47,80,1,Matches
Yanis Hamache,dz ALG,DF,Arouca,24,1999,0.5,1,0,1,0,0,0,0,,0,2,1,1,0,1,1,0,Matches
Tomás Händel,pt POR,MF,Vitória,22,2000,28.0,48,31,16,26,6,28,47,59.6,19,21,3,18,23,71,10,0,Matches
Héctor,es ESP,FW,Chaves,27,1995,28.8,11,8,3,5,3,5,17,29.4,12,14,3,11,5,16,18,0,Matches
Gustavo Henrique,br BRA,"DF,MF",Estrela,24,1999,1.4,2,2,2,0,0,2,3,66.7,1,2,0,2,0,2,2,0,Matches
Morten Hjulmand,dk DEN,MF,Sporting CP,24,1999,24.3,60,37,24,28,8,25,43,58.1,18,27,5,22,20,80,25,0,Matches
Jordan Holsgrove,sct SCO,MF,Estoril,23,1999,13.0,30,25,9,18,3,14,24,58.3,10,11,7,4,15,45,19,2,Matches
André Horta,pt POR,MF,Braga,26,1996,6.1,12,8,2,4,6,8,15,53.3,7,12,1,11,1,13,5,0,Matches
Ricardo Horta,pt POR,"FW,MF",Braga,28,1994,26.0,23,13,9,11,3,5,37,13.5,32,23,2,21,11,34,12,0,Matches
André Inácio,br BRA,"FW,MF",Estrela,21,2002,13.3,19,10,6,9,4,9,24,37.5,15,22,1,21,4,23,8,0,Matches
Gonçalo Inácio,pt POR,DF,Sporting CP,21,2001,27.6,48,35,20,26,2,26,42,61.9,16,29,14,15,25,73,64,1,Matches
Hernani Infande,pt POR,"FW,MF",Moreirense,22,2001,0.9,4,2,1,2,1,3,5,60.0,2,2,0,2,1,5,0,0,Matches
Fabrício Isidoro,br BRA,MF,Farense,31,1992,18.5,25,10,14,8,3,13,37,35.1,24,27,9,18,22,47,19,0,Matches
Ismael,pt POR,MF,Moreirense,24,1999,6.2,6,1,1,4,1,2,8,25.0,6,8,4,4,7,13,14,0,Matches
Franco Israel,uy URU,GK,Sporting CP,23,2000,10.0,0,0,0,0,0,0,0,,0,0,0,0,0,0,5,1,Matches
Abass Issah,gh GHA,"MF,FW",Chaves,24,1998,3.4,1,0,0,0,1,1,4,25.0,3,2,0,2,0,1,0,0,Matches
Léo Jabá,br BRA,"FW,MF",Estrela,24,1998,24.7,35,23,12,14,9,11,23,47.8,12,23,2,21,12,47,17,0,Matches
Ivan Jaime Pajuelo,es ESP,"MF,FW",Porto,22,2000,6.3,11,7,2,5,4,3,8,37.5,5,5,1,4,2,13,2,0,Matches
Jajá,br BRA,"FW,MF",Casa Pia,22,2001,4.8,19,16,4,7,8,9,16,56.3,7,9,0,9,1,20,2,0,Matches
Jardel,gw GNB,"FW,MF",Vizela,25,1997,2.1,2,1,1,1,0,1,2,50.0,1,0,0,0,2,4,2,0,Matches
Jason,es ESP,"FW,MF",Arouca,29,1994,28.5,22,17,5,10,7,9,39,23.1,30,29,3,26,12,34,8,0,Matches
Sylvester Jasper,bg BUL,"FW,MF",Portimonense,21,2001,18.6,22,12,9,8,5,10,21,47.6,11,17,0,17,15,37,16,0,Matches
Anderson Jesus,br BRA,DF,Vizela,28,1995,27.7,33,26,29,4,0,19,35,54.3,16,36,28,8,23,56,124,3,Matches

Jhonatan,br BRA,GK,Rio Ave,32,1991,26.0,0,0,0,0,0,0,0,,0,0,0,0,1,1,16,3,Matches
Jo,br BRA,"FW,MF",Chaves,28,1995,11.3,10,6,1,5,4,4,11,36.4,7,6,1,5,1,11,13,0,Matches
Joca,pt POR,"FW,MF",Rio Ave,27,1996,19.0,11,5,4,2,5,8,17,47.1,9,13,1,12,13,24,15,0,Matches
Nemanja Jović,rs SRB,MF,Estoril,20,2002,0.2,0,0,0,0,0,0,1,0.0,1,0,0,0,0,0,0,0,Matches
Luiz Lúcio Reis Júnior,br BRA,GK,Famalicão,22,2001,33.0,1,0,1,0,0,1,3,33.3,2,1,0,1,1,2,28,2,Matches
David Jurásek,cz CZE,DF,Benfica,22,2000,2.9,9,4,7,2,0,6,8,75.0,2,1,0,1,1,10,9,1,Matches
Samuel Justo,pt POR,MF,Casa Pia,19,2004,6.7,9,6,4,4,1,6,14,42.9,8,7,1,6,4,13,13,0,Matches
Kaio,br BRA,FW,Vitória,19,2004,4.7,10,8,6,3,1,6,13,46.2,7,8,0,8,0,10,1,0,Matches
Kazu,br BRA,"DF,FW",Gil Vicente FC,23,2000,0.6,2,0,1,0,1,1,4,25.0,3,0,0,0,2,4,0,0,Matches
Keliano,ao ANG,MF,Estrela,20,2003,1.3,5,3,1,4,0,3,4,75.0,1,6,4,2,4,9,6,1,Matches
Kewin,br BRA,GK,Moreirense,27,1995,29.8,1,1,1,0,0,0,0,,0,0,0,0,0,1,16,2,Matches
Kikas,pt POR,"FW,MF",Estrela,24,1998,17.3,3,3,0,2,1,1,2,50.0,1,2,0,2,1,4,13,0,Matches
Francisco Kiki,pt POR,MF,Casa Pia,25,1998,0.1,0,0,0,0,0,0,0,,0,0,0,0,0,0,0,0,Matches
Kobamelo Kodisang,za RSA,FW,Moreirense,23,1999,18.0,10,6,7,3,0,6,17,35.3,11,12,1,11,16,26,10,0,Matches
Koba Koindredi,fr FRA,MF,Estoril,21,2001,6.3,14,5,11,2,1,7,14,50.0,7,5,1,4,11,25,6,0,Matches
Koba Koindredi,fr FRA,MF,Sporting CP,21,2001,0.4,4,3,0,4,0,2,2,100.0,0,0,0,0,2,6,0,0,Matches
Orkun Kökçü,tr TUR,MF,Benfica,22,2000,19.8,32,22,10,18,4,17,35,48.6,18,15,2,13,8,40,7,1,Matches
Eboue Kouassi,ci CIV,MF,Arouca,25,1997,15.0,26,17,12,11,3,14,27,51.9,13,17,7,10,11,37,39,0,Matches
Kevin Krygård,no NOR,"MF,DF",Casa Pia,23,2000,0.7,4,1,3,1,0,1,6,16.7,5,3,1,2,3,7,0,0,Matches
Matías Lacava,ve VEN,"FW,MF",Vizela,20,2002,14.8,33,19,18,8,7,14,30,46.7,16,15,0,15,6,39,3,0,Matches
Tom Lacoux,fr FRA,MF,Famalicão,21,2002,4.0,12,8,7,4,1,7,11,63.6,4,9,4,5,6,18,2,0,Matches
André Lacximicant,pt POR,"FW,MF",Casa Pia,22,2001,2.4,4,2,0,2,2,0,0,,0,2,0,2,0,4,1,0,Matches
Rúben Lameiras,pt POR,"FW,MF",Casa Pia,28,1994,6.1,7,5,4,1,2,5,9,55.6,4,4,0,4,4,11,4,0,Matches
Rúben Lameiras,pt POR,"FW,MF",Chaves,28,1994,2.3,2,1,0,2,0,0,0,,0,1,0,1,1,3,2,0,Matches
Bruno Langa,mz MOZ,"DF,MF",Chaves,25,1997,11.9,22,14,8,12,2,8,18,44.4,10,9,2,7,18,40,27,1,Matches

Larra,es ESP,"DF,MF",Casa Pia,25,1997,27.9,46,36,27,14,5,26,45,57.8,19,28,6,22,43,89,69,0,Matches
Yusuf Lawal,ng NGA,"FW,MF",Arouca,25,1998,2.6,4,2,2,2,0,0,2,0.0,2,4,0,4,3,7,2,0,Matches
Orest Lebedenko,ua UKR,DF,Vizela,24,1998,16.1,35,20,18,16,1,18,29,62.1,11,24,7,17,23,58,58,0,Matches
Leonardo Lelo,pt POR,"DF,MF",Casa Pia,23,2000,32.7,53,32,35,13,5,40,74,54.1,34,35,6,29,37,90,70,0,Matches
Marcos Leonardo,br BRA,FW,Benfica,20,2003,3.7,2,1,0,0,2,0,0,,0,3,0,3,0,2,1,0,Matches
Otso Liimatta,fi FIN,"MF,FW",Famalicão,19,2004,5.2,6,3,3,2,1,3,9,33.3,6,2,0,2,3,9,0,0,Matches
Rúben Lima,pt POR,"DF,MF",Estrela,33,1989,10.3,14,8,7,6,1,4,11,36.4,7,12,1,11,8,22,36,0,Matches
Danny Loader,eng ENG,"FW,MF",Porto,22,2000,2.7,4,2,0,4,0,1,3,33.3,2,5,0,5,0,4,2,0,Matches
Jason Lokilo,be BEL,"FW,MF",Vizela,24,1998,7.8,4,3,2,2,0,2,6,33.3,4,3,0,3,0,4,7,0,Matches
Julien Lomboto,,MF,Rio Ave,21,2002,0.1,0,0,0,0,0,0,0,,0,1,1,0,0,0,2,0,Matches
Miguel Lopes,pt POR,DF,Estrela,36,1986,14.7,34,24,18,16,0,22,30,73.3,8,21,13,8,18,52,45,1,Matches
Né lopes,pt POR,DF,Gil Vicente FC,23,2000,2.9,4,3,2,1,1,3,3,100.0,0,3,1,2,4,8,12,0,Matches
Rony Lopes,pt POR,"FW,MF",Braga,27,1995,4.1,6,6,1,2,3,3,4,75.0,1,3,1,2,2,8,4,0,Matches
Bruno Lourenço,pt POR,"FW,MF",Boavista,25,1998,22.4,30,15,5,18,7,12,38,31.6,26,11,0,11,15,45,15,0,Matches
Thomas Luciano,br BRA,DF,Gil Vicente FC,21,2002,0.3,3,1,0,1,2,1,1,100.0,0,1,0,1,0,3,1,0,Matches
André Luis,br BRA,FW,Moreirense,29,1994,14.8,8,6,2,4,2,4,10,40.0,6,11,3,8,6,14,24,0,Matches
Florentino Luís,pt POR,MF,Benfica,23,1999,18.7,79,45,26,43,10,39,75,52.0,36,36,5,31,49,128,13,0,Matches
José Luis Rodríguez,pa PAN,FW,Famalicão,25,1998,16.6,20,14,12,5,3,16,30,53.3,14,13,3,10,10,30,16,0,Matches
Zé Luís,cv CPV,"FW,MF",Farense,32,1991,6.6,3,3,0,1,2,1,3,33.3,2,9,3,6,1,4,4,0,Matches
Luismi,gq EQG,FW,Moreirense,22,2001,10.4,20,11,7,10,3,7,19,36.8,12,22,3,19,4,24,10,0,Matches
Wallisson Luiz,br BRA,"MF,FW",Moreirense,25,1997,2.2,13,7,4,5,4,6,10,60.0,4,3,1,2,6,19,11,0,Matches
Rodrigo Macedo,pt POR,"FW,MF",Moreirense,20,2003,0.7,4,2,1,2,1,2,3,66.7,1,1,0,1,0,4,0,0,Matches
Tiago Machado,pt POR,"MF,FW",Boavista,19,2004,0.2,0,0,0,0,0,0,0,,0,0,0,0,0,0,0,0,Matches
Madson,br BRA,"FW,MF",Moreirense,23,1999,14.9,6,4,2,3,1,1,9,11.1,8,17,0,17,11,17,18,0,Matches
Miguel Maga,pt POR,"DF,MF",Vitória,20,2002,9.9,30,19,17,11,2,21,31,67.7,10,10,2,8,14,44,25,1,Matches

Magrão,br BRA,GK,Rio Ave,23,2000,7.0,2,1,2,0,0,2,2,100.0,0,0,0,0,0,2,2,1,Matches
Gaius Makouta,cg CGO,MF,Boavista,26,1997,25.9,29,22,11,17,1,14,23,60.9,9,21,2,19,20,49,34,0,Matches
Pedro Malheiro,pt POR,"DF,MF",Boavista,22,2001,21.9,58,33,34,21,3,36,57,63.2,21,27,8,19,24,82,48,1,Matches
Eliaquim Mangala,fr FRA,DF,Estoril,32,1991,11.6,15,7,9,5,1,8,11,72.7,3,11,9,2,21,36,40,1,Matches
Ricardo Mangas,pt POR,"MF,DF",Vitória,25,1998,21.2,25,17,16,7,2,14,27,51.9,13,15,3,12,14,39,27,0,Matches
Mansur,br BRA,DF,Estrela,30,1993,15.6,27,19,23,4,0,14,18,77.8,4,17,10,7,13,40,43,1,Matches
Manuel Manu,pt POR,"DF,MF",Vitória,22,2001,19.7,50,33,37,12,1,27,50,54.0,23,23,13,10,22,72,78,3,Matches
Zé Manuel,pt POR,"FW,MF",Rio Ave,32,1990,6.6,12,8,3,8,1,5,17,29.4,12,9,0,9,4,16,7,0,Matches
Maracás,br BRA,DF,Moreirense,29,1994,28.5,44,35,35,8,1,24,34,70.6,10,34,28,6,22,66,150,0,Matches
Iván Marcano,es ESP,DF,Porto,36,1987,4.1,9,4,5,4,0,5,7,71.4,2,1,1,0,4,13,9,0,Matches
Adrián Marín,es ESP,DF,Braga,26,1997,3.6,7,3,2,3,2,3,5,60.0,2,6,3,3,6,13,7,0,Matches
João Mário,pt POR,"FW,MF",Benfica,30,1993,26.9,39,27,8,21,10,15,34,44.1,19,24,0,24,16,55,8,0,Matches
João Mário Lopes,pt POR,DF,Porto,23,2000,22.9,33,20,13,16,4,22,44,50.0,22,19,4,15,13,46,18,1,Matches
Marlon,br BRA,"FW,MF",Gil Vicente FC,25,1997,4.8,4,3,1,2,1,3,12,25.0,9,8,0,8,3,7,5,0,Matches
Uladzislaŭ Marozaŭ,by BLR,"FW,MF",Arouca,22,2000,1.6,0,0,0,0,0,0,2,0.0,2,1,0,1,0,0,1,0,Matches
Alejandro Marqués,ve VEN,FW,Estoril,22,2000,15.1,10,7,1,8,1,2,9,22.2,7,14,4,10,3,13,15,0,Matches
Gustavo Marques,br BRA,DF,Benfica,21,2001,0.0,0,0,0,0,0,0,0,,0,0,0,0,1,1,0,0,Matches
Igor Marques,br BRA,"DF,MF",Portimonense,24,1999,16.5,55,34,25,24,6,23,50,46.0,27,35,5,30,41,96,45,1,Matches
João Marques,pt POR,"MF,FW",Estoril,21,2002,21.9,39,25,5,26,8,11,29,37.9,18,20,2,18,11,50,13,0,Matches
Toni Martínez,es ESP,FW,Porto,26,1997,5.8,2,1,1,0,1,1,6,16.7,5,2,0,2,0,2,0,0,Matches
Rafael Martins,br BRA,MF,Casa Pia,34,1989,0.3,0,0,0,0,0,0,0,,0,0,0,0,0,0,0,0,Matches
Rodrigo Martins,pt POR,"DF,FW",Estoril,24,1998,0.1,0,0,0,0,0,0,0,,0,0,0,0,1,1,0,0,Matches
Rodrigo Martins,pt POR,FW,Portimonense,24,1998,2.6,4,3,2,1,1,2,6,33.3,4,1,0,1,0,4,6,0,Matches
Matheus,br BRA,GK,Braga,31,1992,34.0,1,1,1,0,0,0,2,0.0,2,1,0,1,0,1,20,2,Matches
Marco Matias,pt POR,"FW,MF",Farense,34,1989,25.5,40,26,20,12,8,13,32,40.6,19,19,0,19,22,62,20,0,Matches

Nuno Matos,pt POR,DF,Braga,18,2004,0.1,0,0,0,0,0,0,2,0.0,2,0,0,0,0,0,0,0,Matches
Maurício,br BRA,MF,Portimonense,34,1988,5.0,11,8,3,8,0,8,14,57.1,6,7,3,4,9,20,11,1,Matches
Rodrigo Melro,pt POR,DF,Chaves,19,2004,0.0,0,0,0,0,0,0,1,0.0,1,0,0,0,0,0,0,0,Matches
João Mendes,pt POR,"FW,MF",Vitória,28,1994,16.0,21,9,5,10,6,10,29,34.5,19,19,1,18,9,30,7,1,Matches
Joe Mendes,se SWE,DF,Braga,20,2002,9.9,18,8,10,6,2,8,17,47.1,9,7,3,4,6,24,20,0,Matches
Pedro Mendes,pt POR,DF,Estrela,32,1990,9.0,13,9,10,2,1,7,12,58.3,5,14,10,4,15,28,42,1,Matches
Alex Mendez,us USA,"MF,FW",Vizela,22,2000,4.1,6,5,1,4,1,3,4,75.0,1,2,0,2,2,8,1,0,Matches
Miguel Menino,pt POR,MF,Sporting CP,20,2003,0.0,0,0,0,0,0,0,0,,0,1,0,1,0,0,0,0,Matches
Benji Michel,us USA,"FW,MF",Arouca,25,1997,0.5,0,0,0,0,0,0,0,,0,0,0,0,0,0,1,0,Matches
João Miguel,pt POR,DF,Porto,23,2000,3.2,3,2,2,1,0,3,5,60.0,2,5,3,2,2,5,2,0,Matches
Enea Mihaj,al ALB,DF,Famalicão,25,1998,17.3,20,15,14,6,0,14,22,63.6,8,25,19,6,23,43,75,0,Matches
Mika,pt POR,GK,Moreirense,32,1991,0.2,0,0,0,0,0,0,0,,0,0,0,0,0,0,0,0,Matches
Bogdan Milovanov,ua UKR,DF,Arouca,25,1998,13.4,49,30,24,21,4,29,51,56.9,22,12,4,8,13,62,33,0,Matches
Vinicius Mingotti,br BRA,FW,Moreirense,23,2000,5.4,6,3,1,4,1,0,1,0.0,1,4,0,4,0,6,3,0,Matches
Miro,ao ANG,"FW,MF",Gil Vicente FC,20,2003,1.8,2,2,0,1,1,0,2,0.0,2,1,0,1,1,3,1,0,Matches
Cezary Miszta,pl POL,GK,Rio Ave,21,2001,1.0,0,0,0,0,0,0,0,,0,0,0,0,0,0,2,0,Matches
Miguel Monteiro,pt POR,FW,Gil Vicente FC,20,2003,2.5,0,0,0,0,0,0,1,0.0,1,0,0,0,1,1,2,0,Matches
Francisco Montero,es ESP,DF,Arouca,24,1999,28.7,28,20,24,4,0,14,35,40.0,21,35,19,16,31,59,137,1,Matches
Morato,br BRA,DF,Benfica,22,2001,16.9,53,33,33,11,9,37,67,55.2,30,20,5,15,17,70,40,0,Matches
Hélder Morim,pt POR,"MF,DF",Chaves,22,2001,7.3,19,8,8,8,3,7,24,29.2,17,18,7,11,8,27,5,0,Matches
Hidemasa Morita,jp JPN,MF,Sporting CP,28,1995,23.8,55,35,16,32,7,28,58,48.3,30,17,1,16,17,72,25,0,Matches
Mosquito,br BRA,GK,Arouca,27,1996,2.0,0,0,0,0,0,0,0,,0,0,0,0,0,0,0,0,Matches
Moura,pt POR,DF,Famalicão,23,1999,33.0,55,35,29,13,13,29,41,70.7,12,43,7,36,33,88,79,1,Matches
Rodrigo Moura,br BRA,GK,Chaves,27,1996,7.0,3,0,3,0,0,3,3,100.0,0,0,0,0,0,3,3,0,Matches
João Moutinho,pt POR,MF,Braga,36,1986,23.5,68,42,24,42,2,31,69,44.9,38,27,8,19,30,98,28,1,Matches

Rafa Mújica,es ESP,FW,Arouca,24,1998,28.1,22,14,5,8,9,2,13,15.4,11,23,3,20,5,27,16,0,Matches
Petar Musa,hr CRO,FW,Benfica,25,1998,5.8,12,8,4,4,4,3,5,60.0,2,8,2,6,0,12,6,0,Matches
Zach Muscat,mt MLT,DF,Farense,29,1993,18.7,11,4,5,6,0,6,14,42.9,8,42,33,9,15,26,103,0,Matches
Almoatasem Al Musrati,ly LBY,MF,Braga,27,1996,8.9,20,14,9,10,1,9,14,64.3,5,4,2,2,14,34,8,1,Matches
Steve Mvoué,cm CMR,MF,Portimonense,21,2002,0.8,4,1,0,4,0,1,2,50.0,1,1,0,1,0,4,0,0,Matches
Kosuke Nakamura,jp JPN,GK,Portimonense,28,1995,20.0,0,0,0,0,0,0,1,0.0,1,0,0,0,0,0,17,1,Matches
Nuno Namora,pt POR,"DF,MF",Rio Ave,25,1998,0.3,1,0,0,0,1,1,3,33.3,2,0,0,0,0,1,3,0,Matches
Davis Nascimento,br BRA,MF,Portimonense,20,2002,0.0,0,0,0,0,0,0,1,0.0,1,0,0,0,0,0,0,0,Matches
Diogo Nascimento,pt POR,MF,Vizela,20,2002,24.0,29,19,9,17,3,14,32,43.8,18,17,2,15,10,39,24,0,Matches
Nathan,br BRA,DF,Famalicão,21,2001,20.5,61,42,39,20,2,27,59,45.8,32,18,1,17,19,80,38,0,Matches
Fran Navarro,es ESP,"FW,MF",Porto,25,1998,1.9,1,0,1,0,0,0,3,0.0,3,1,0,1,3,4,3,0,Matches
Mor Ndiaye,sn SEN,MF,Estoril,22,2000,2.8,5,3,3,1,1,5,7,71.4,2,2,0,2,1,6,6,0,Matches
Alioune Ndour,sn SEN,"FW,MF",Estrela,22,2001,1.9,4,3,0,2,2,0,1,0.0,1,0,0,0,0,4,2,0,Matches
Cher Ndour,it ITA,MF,Braga,19,2004,2.3,7,4,4,3,0,1,4,25.0,3,3,1,2,5,12,5,0,Matches
Nelson,ao ANG,"DF,FW",Vitória,25,1998,4.5,10,8,3,4,3,5,11,45.5,6,11,0,11,6,16,4,0,Matches
David Neres,br BRA,FW,Benfica,26,1997,12.6,12,3,2,8,2,4,11,36.4,7,15,2,13,5,17,2,0,Matches
Neto,br BRA,MF,Casa Pia,31,1991,25.0,50,32,26,18,6,31,62,50.0,31,37,9,28,22,72,44,0,Matches
Luís Neto,pt POR,DF,Sporting CP,35,1988,1.5,1,0,0,1,0,0,1,0.0,1,2,2,0,1,2,4,0,Matches
Martim Neto,pt POR,MF,Gil Vicente FC,20,2003,20.7,45,23,17,26,2,22,57,38.6,35,25,0,25,18,63,16,1,Matches
João Neves,pt POR,MF,Benfica,18,2004,25.7,65,53,21,26,18,29,63,46.0,34,49,12,37,35,100,38,0,Matches
Sikou Niakaté,ml MLI,DF,Braga,24,1999,16.5,13,9,8,5,0,8,12,66.7,4,13,7,6,16,29,72,2,Matches
Miguel Nóbrega,pt POR,DF,Rio Ave,23,2000,18.0,32,20,17,14,1,20,32,62.5,12,22,12,10,22,54,79,1,Matches
Gonçalo Nogueira,pt POR,MF,Vitória,19,2003,0.1,0,0,0,0,0,0,0,,0,1,0,1,0,0,0,0,Matches
Ygor Nogueira,br BRA,DF,Chaves,28,1995,18.4,37,25,32,5,0,24,33,72.7,9,22,15,7,27,64,101,0,Matches
Nonoca,br BRA,MF,Portimonense,25,1998,21.3,82,54,34,41,7,35,49,71.4,14,30,11,19,20,102,30,1,Matches

João Nunes,pt POR,DF,Casa Pia,27,1995,14.7,12,7,8,4,0,8,20,40.0,12,19,11,8,14,26,55,1,Matches
Kelechi Nwakali,ng NGA,MF,Chaves,25,1998,23.0,38,29,7,27,4,20,38,52.6,18,20,2,18,19,57,12,0,Matches
Régis N’Do,bf BFA,"FW,MF",Estrela,22,2001,11.0,16,9,5,8,3,10,25,40.0,15,15,2,13,3,19,4,0,Matches
Tashan Oakley-Boothe,eng ENG,"MF,DF",Estrela,23,2000,0.6,0,0,0,0,0,0,0,,0,0,0,0,1,1,2,0,Matches
Lawrence Ofori,gh GHA,MF,Moreirense,25,1998,27.3,27,13,10,15,2,8,38,21.1,30,22,5,17,17,44,19,1,Matches
Hugo Oliveira,pt POR,"DF,MF",Vizela,21,2002,5.5,8,6,5,2,1,5,8,62.5,3,5,3,2,8,16,15,0,Matches
Mattheus Oliveira,br BRA,MF,Farense,29,1994,24.8,44,34,24,17,3,19,43,44.2,24,40,8,32,27,71,42,0,Matches
Nélson Oliveira,pt POR,FW,Vitória,31,1991,6.7,4,4,1,3,0,0,1,0.0,1,4,1,3,2,6,3,0,Matches
Paulo Oliveira,pt POR,DF,Braga,31,1992,18.6,34,18,20,13,1,21,31,67.7,10,18,9,9,35,69,79,1,Matches
Talys Oliveira,br BRA,DF,Farense,24,1999,10.9,18,13,12,5,1,12,23,52.2,11,13,3,10,18,36,43,0,Matches
Joneston Omurwa,ke KEN,DF,Estrela,24,1998,12.7,20,12,13,6,1,12,20,60.0,8,20,12,8,21,41,47,1,Matches
Bruno Onyemaechi,ng NGA,"DF,MF",Boavista,24,1999,21.9,50,37,26,20,4,21,36,58.3,15,28,6,22,24,74,57,0,Matches
Jerome Opoku,gh GHA,DF,Arouca,24,1998,1.5,1,0,0,0,1,0,0,,0,2,0,2,0,1,9,0,Matches
Pedro Ortiz,es ESP,MF,Vizela,22,2000,10.2,27,15,10,14,3,15,26,57.7,11,9,4,5,7,34,21,0,Matches
Nicolás Otamendi,ar ARG,DF,Benfica,35,1988,30.6,50,36,33,16,1,30,58,51.7,28,30,14,16,53,103,109,3,Matches
Otávio,pt POR,"MF,FW",Porto,28,1995,1.0,0,0,0,0,0,0,3,0.0,3,0,0,0,0,0,0,0,Matches
João Othavio Basso,br BRA,DF,Estoril,26,1997,13.4,26,18,17,7,2,14,25,56.0,11,16,9,7,16,42,53,0,Matches
Amine Oudrhiri,ma MAR,MF,Rio Ave,30,1992,24.7,34,22,8,21,5,19,34,55.9,15,22,4,18,30,64,20,3,Matches
Pablo,br BRA,"FW,MF",Famalicão,19,2004,2.2,3,3,3,0,0,2,4,50.0,2,4,1,3,1,4,3,0,Matches
Lucas Paes,br BRA,GK,Casa Pia,25,1997,3.0,0,0,0,0,0,0,1,0.0,1,0,0,0,0,0,0,0,Matches
Renato Pantalon,hr CRO,DF,Rio Ave,25,1997,14.9,22,10,11,10,1,11,16,68.8,5,15,8,7,9,31,54,0,Matches
Raúl Parra,es ESP,DF,Estoril,23,1999,6.3,8,5,6,2,0,4,9,44.4,5,3,2,1,2,10,9,0,Matches
David Pastor,br BRA,DF,Farense,23,2000,27.5,55,34,34,19,2,31,60,51.7,29,32,7,25,50,105,83,0,Matches
Patrick,br BRA,DF,Rio Ave,26,1997,12.4,18,8,14,4,0,12,21,57.1,9,9,2,7,26,44,44,0,Matches
Paulinho,pt POR,"FW,MF",Portimonense,23,1999,1.9,0,0,0,0,0,0,0,,0,0,0,0,0,0,3,0,Matches

Paulinho,pt POR,"FW,MF",Sporting CP,30,1992,14.5,18,14,1,9,8,5,16,31.3,11,15,1,14,2,20,6,0,Matches
Ivan Pavlic,be BEL,MF,Estoril,21,2001,2.0,4,2,3,1,0,4,6,66.7,2,1,0,1,1,5,2,0,Matches
Pedrão,br BRA,DF,Portimonense,26,1997,29.3,48,29,34,12,2,22,38,57.9,16,32,17,15,50,98,136,0,Matches
Zé Pedro Figueiredo,pt POR,DF,Porto,26,1997,10.3,15,7,8,6,1,10,17,58.8,7,5,2,3,9,24,31,0,Matches
João Pedro,pt POR,MF,Chaves,30,1993,4.5,7,4,3,3,1,7,15,46.7,8,3,2,1,3,10,5,0,Matches
Pepe,pt POR,DF,Porto,40,1983,20.9,28,16,16,12,0,16,30,53.3,14,13,8,5,19,47,50,1,Matches
Pepê,br BRA,"MF,DF",Porto,26,1997,31.7,26,18,8,12,6,9,33,27.3,24,30,2,28,22,48,16,0,Matches
André Pereira,pt POR,FW,Rio Ave,28,1995,6.5,10,7,1,8,1,4,10,40.0,6,9,0,9,2,12,5,0,Matches
Gabriel Pereira,br BRA,DF,Gil Vicente FC,23,2000,30.9,34,24,25,6,3,26,38,68.4,12,42,30,12,26,60,130,0,Matches
Hildeberto Pereira,pt POR,FW,Portimonense,27,1996,9.4,2,2,2,0,0,0,12,0.0,12,10,1,9,2,4,3,0,Matches
Matheus Pereira,br BRA,"DF,FW",Vizela,22,2000,23.3,26,16,12,11,3,11,23,47.8,12,29,6,23,20,46,38,0,Matches
Sebastián Pérez Cardona,co COL,MF,Boavista,30,1993,24.3,74,39,41,30,3,39,68,57.4,29,30,8,22,22,96,26,1,Matches
Sava Petrov,rs SRB,"FW,MF",Vizela,25,1998,5.7,0,0,0,0,0,0,3,0.0,3,5,2,3,0,0,8,0,Matches
Thibang Phete,za RSA,"DF,MF",Chaves,29,1994,4.9,5,3,2,2,1,3,5,60.0,2,5,3,2,8,13,18,0,Matches
Wagner Pina,cv CPV,"MF,DF",Estoril,20,2002,12.2,34,24,22,10,2,23,29,79.3,6,24,5,19,8,42,29,0,Matches
Pedro Pinho,pt POR,MF,Chaves,23,2000,2.8,9,2,4,3,2,3,7,42.9,4,6,4,2,9,18,7,0,Matches
Rodrigo Pinho,br BRA,FW,Estrela,32,1991,3.5,2,2,1,1,0,0,1,0.0,1,2,0,2,1,3,1,0,Matches
Alexandre Pinto,pt POR,DF,Gil Vicente FC,25,1998,11.8,25,17,13,10,2,14,24,58.3,10,6,1,5,15,40,57,1,Matches
Dinis Pinto,pt POR,DF,Moreirense,22,2000,10.4,20,12,10,6,4,10,14,71.4,4,10,3,7,8,28,24,0,Matches
Diogo Pinto,pt POR,MF,Casa Pia,24,1999,0.1,0,0,0,0,0,0,0,,0,0,0,0,0,0,0,0,Matches
Diogo Pinto,pt POR,GK,Sporting CP,19,2004,1.9,0,0,0,0,0,0,0,,0,0,0,0,0,0,0,0,Matches
Gonçalo Pinto,pt POR,GK,Chaves,23,2000,1.0,0,0,0,0,0,0,0,,0,0,0,0,0,0,0,0,Matches
Junior Pius,ng NGA,DF,Chaves,27,1995,12.8,45,33,31,12,2,28,42,66.7,14,23,7,16,18,63,53,0,Matches
Pizzi,pt POR,"MF,FW",Braga,33,1989,10.7,6,4,4,1,1,2,8,25.0,6,8,0,8,3,9,6,1,Matches
Carlos Ponck,cv CPV,DF,Moreirense,28,1995,11.5,20,17,12,8,0,14,17,82.4,3,16,10,6,12,32,61,2,Matches

Cristian Ponde,pt POR,"MF,FW",Farense,28,1995,2.5,5,3,2,3,0,1,5,20.0,4,6,1,5,3,8,2,0,Matches
Rafael Pontelo,br BRA,DF,Sporting CP,20,2003,0.0,0,0,0,0,0,0,0,,0,0,0,0,0,0,0,0,Matches
Gianluca Prestianni,ar ARG,MF,Benfica,17,2006,0.0,0,0,0,0,0,0,1,0.0,1,0,0,0,0,0,0,0,Matches
Miguel Puche García,es ESP,"FW,MF",Arouca,22,2001,3.4,6,2,5,1,0,4,5,80.0,1,1,0,1,1,7,1,0,Matches
Quaresma,br BRA,DF,Arouca,26,1996,3.3,8,6,4,3,1,6,13,46.2,7,5,1,4,5,13,6,1,Matches
Eduardo Quaresma,pt POR,DF,Sporting CP,21,2002,10.7,28,18,15,12,1,13,20,65.0,7,11,7,4,9,37,23,0,Matches
João Queirós,pt POR,DF,Chaves,25,1998,2.6,4,2,3,1,0,3,4,75.0,1,2,1,1,4,8,6,1,Matches
Domingos Quina,pt POR,"FW,MF",Vizela,23,1999,8.1,18,9,1,14,3,4,12,33.3,8,11,0,11,4,22,5,0,Matches
Cláudio Ramos,pt POR,GK,Porto,31,1991,1.3,0,0,0,0,0,0,0,,0,0,0,0,1,1,0,0,Matches
Osama Rashid,iq IRQ,"MF,FW",Vizela,31,1992,0.3,0,0,0,0,0,0,1,0.0,1,0,0,0,1,1,2,0,Matches
Miguel Rebelo,pt POR,MF,Moreirense,19,2003,0.0,0,0,0,0,0,0,0,,0,0,0,0,0,0,0,0,Matches
João Rêgo,pt POR,MF,Benfica,18,2005,0.1,0,0,0,0,0,0,0,,0,0,0,0,0,0,0,0,Matches
João Reis,pt POR,"DF,MF",Estrela,31,1992,16.1,40,24,24,13,3,25,51,49.0,26,27,2,25,24,64,45,0,Matches
Matheus Reis,br BRA,"DF,MF",Sporting CP,28,1995,15.8,20,13,7,11,2,15,24,62.5,9,16,3,13,9,29,27,0,Matches
Miguel Reisinho,pt POR,MF,Boavista,24,1999,23.3,48,30,14,29,5,22,48,45.8,26,22,8,14,21,69,37,2,Matches
Filipe Relvas,pt POR,DF,Portimonense,23,1999,31.1,56,32,43,13,0,28,46,60.9,18,48,25,23,58,114,140,1,Matches
Rúben Tiago Rodrigues Ribeiro,pt POR,"FW,MF",Chaves,35,1987,18.7,23,14,14,7,2,12,20,60.0,8,12,0,12,12,35,11,0,Matches
Tomás Ribeiro,pt POR,DF,Vitória,24,1999,27.0,33,17,16,14,3,19,34,55.9,15,36,17,19,21,54,88,0,Matches
Riccieli,br BRA,DF,Famalicão,24,1998,19.7,23,14,17,6,0,15,29,51.7,14,26,13,13,13,36,84,0,Matches
Rildo,br BRA,"FW,MF",Portimonense,23,2000,5.7,5,3,0,5,0,1,3,33.3,2,9,0,9,1,6,3,0,Matches
Mihailo Ristić,rs SRB,DF,Benfica,27,1995,0.0,1,0,1,0,0,0,0,,0,0,0,0,0,1,0,0,Matches
Pablo Roberto,br BRA,"MF,FW",Casa Pia,23,1999,18.5,25,13,4,19,2,13,33,39.4,20,18,1,17,17,42,9,1,Matches
Matí­as Rocha,uy URU,DF,Arouca,22,2001,6.2,6,4,3,3,0,5,8,62.5,3,2,2,0,6,12,26,0,Matches
Afonso Rodrigues,pt POR,"FW,MF",Famalicão,20,2002,2.6,4,0,0,2,2,2,5,40.0,3,4,0,4,2,6,4,0,Matches
Bruno Rodrigues,pt POR,DF,Chaves,22,2001,15.0,14,8,11,1,2,9,13,69.2,4,15,3,12,18,32,47,0,Matches

Gonçalo Rodrigues,pt POR,MF,Rio Ave,26,1997,13.7,22,12,3,15,4,10,27,37.0,17,8,0,8,4,26,8,0,Matches
Benjamín Rollheiser,ar ARG,FW,Benfica,23,2000,1.7,0,0,0,0,0,0,1,0.0,1,3,1,2,0,0,1,0,Matches
Ronald,br BRA,"MF,FW",Estrela,22,2001,14.7,14,8,3,7,4,7,18,38.9,11,13,0,13,4,18,6,0,Matches
Igor Rossi Branco,br BRA,DF,Farense,34,1989,11.3,8,6,7,0,1,6,7,85.7,1,4,4,0,12,20,64,1,Matches
Francesco Ruberto,ch SUI,GK,Vizela,30,1993,6.3,0,0,0,0,0,0,2,0.0,2,0,0,0,0,0,3,1,Matches
Abel Ruiz,es ESP,"FW,MF",Braga,23,2000,21.1,8,6,1,4,3,4,8,50.0,4,6,1,5,6,14,12,0,Matches
Leonardo Ruíz,co COL,FW,Rio Ave,27,1996,8.3,6,6,2,3,1,5,12,41.7,7,3,1,2,4,10,13,0,Matches
Gustavo sá,pt POR,MF,Famalicão,18,2004,20.4,37,22,6,22,9,12,40,30.0,28,16,5,11,12,49,31,0,Matches
Helder Sá,pt POR,"DF,MF",Rio Ave,20,2002,0.5,0,0,0,0,0,0,1,0.0,1,2,2,0,0,0,4,0,Matches
Josué Sá,pt POR,DF,Rio Ave,31,1992,21.8,30,20,18,11,1,16,26,61.5,10,24,11,13,23,53,78,0,Matches
Pedro Sá,pt POR,MF,Estrela,29,1993,7.2,9,4,4,5,0,3,10,30.0,7,4,2,2,6,15,7,0,Matches
Serdar Saatçı,tr TUR,DF,Braga,20,2003,16.6,27,17,18,9,0,17,24,70.8,7,17,10,7,38,65,46,3,Matches
Safira,br BRA,FW,Vitória,28,1995,1.6,4,2,2,2,0,1,1,100.0,0,2,0,2,0,4,3,0,Matches
Dylan Saint-Louis,cg CGO,"FW,MF",Vizela,28,1995,2.9,5,2,3,1,1,3,6,50.0,3,3,1,2,1,6,2,0,Matches
Samu,pt POR,MF,Vizela,27,1996,30.7,70,37,32,27,11,34,78,43.6,44,54,12,42,20,90,48,0,Matches
Leandro Sanca,gw GNB,"FW,MF",Chaves,23,2000,16.3,17,5,5,9,3,6,29,20.7,23,25,1,24,9,26,8,0,Matches
Aderlan Santos,br BRA,DF,Rio Ave,34,1989,31.6,68,44,50,18,0,34,47,72.3,13,58,40,18,45,113,167,1,Matches
Hevertton Santos,br BRA,"DF,MF",Estrela,22,2001,21.9,25,18,12,10,3,18,29,62.1,11,27,7,20,20,45,53,0,Matches
Luís Santos,pt POR,"DF,FW",Boavista,23,2000,7.6,17,9,13,3,1,10,16,62.5,6,8,3,5,11,28,23,0,Matches
Nuno Santos,pt POR,"FW,MF",Vitória,24,1999,10.7,10,6,3,7,0,5,26,19.2,21,12,0,12,5,15,5,0,Matches
Nuno Santos,pt POR,"MF,DF",Sporting CP,28,1995,22.9,26,18,8,12,6,9,22,40.9,13,8,1,7,25,51,13,1,Matches
Pedro Santos,pt POR,MF,Arouca,22,2000,16.1,29,20,8,18,3,18,45,40.0,27,19,1,18,11,40,8,0,Matches
Zaidu Sanusi,ng NGA,DF,Porto,26,1997,3.2,3,2,1,2,0,2,3,66.7,1,4,2,2,4,7,4,0,Matches
Vincent Sasso,fr FRA,DF,Boavista,32,1991,14.2,23,10,13,9,1,13,23,56.5,10,20,13,7,14,37,69,3,Matches
Savio,br BRA,"DF,MF",Rio Ave,28,1995,2.8,4,2,2,2,0,3,8,37.5,5,3,1,2,2,6,6,2,Matches

Caio Secco,br BRA,GK,Moreirense,32,1990,4.0,0,0,0,0,0,0,0,,0,0,0,0,0,0,1,0,Matches
Moustapha Seck,sn SEN,"DF,MF",Portimonense,27,1996,9.8,29,19,17,9,3,15,19,78.9,4,17,6,11,11,40,28,0,Matches
Telasco Segovia,ve VEN,MF,Casa Pia,20,2003,8.3,29,19,12,16,1,15,31,48.4,16,7,1,6,15,44,6,0,Matches
Artur Serobyan,am ARM,MF,Casa Pia,20,2003,0.7,1,1,0,1,0,1,2,50.0,1,0,0,0,1,2,1,0,Matches
André Seruca,pt POR,MF,Farense,22,2000,0.4,3,2,3,0,0,2,2,100.0,0,2,0,2,0,3,0,0,Matches
Nkanyiso Shinga,za RSA,"DF,MF",Estrela,23,2000,5.7,12,11,4,5,3,10,12,83.3,2,12,7,5,7,19,20,1,Matches
Adrien Silva,pt POR,MF,Rio Ave,34,1989,3.8,13,4,4,7,2,4,10,40.0,6,6,0,6,5,18,7,1,Matches
André Silva,br BRA,FW,Vitória,26,1997,19.7,19,10,3,12,4,8,13,61.5,5,20,1,19,5,24,17,0,Matches
António Silva,pt POR,DF,Benfica,19,2003,29.1,64,43,34,24,6,33,42,78.6,9,47,24,23,23,87,91,0,Matches
Francisco Silva,pt POR,GK,Sporting CP,17,2005,0.1,0,0,0,0,0,0,0,,0,0,0,0,0,0,0,0,Matches
Gonçalo Silva,pt POR,DF,Farense,32,1991,32.0,36,21,29,7,0,22,35,62.9,13,45,32,13,39,75,231,1,Matches
Joel silva,pt POR,MF,Boavista,20,2003,4.1,11,7,3,7,1,5,12,41.7,7,6,1,5,3,14,5,0,Matches
Jota Silva,pt POR,"FW,MF",Vitória,23,1999,30.9,35,18,12,14,9,11,43,25.6,32,34,2,32,17,52,28,0,Matches
Felipe Silva Lipe,br BRA,DF,Gil Vicente FC,21,2002,3.0,7,2,4,3,0,5,7,71.4,2,3,2,1,2,9,8,0,Matches
Pedro Manuel da Silva Moreira,pt POR,MF,Arouca,34,1989,0.5,1,0,0,0,1,0,0,,0,0,0,0,0,1,0,0,Matches
Rafa Silva,pt POR,"MF,FW",Benfica,30,1993,27.5,23,12,10,7,6,10,32,31.3,22,11,0,11,7,30,4,0,Matches
Tiago Silva,pt POR,MF,Vitória,30,1993,25.9,45,30,14,24,7,22,46,47.8,24,17,1,16,27,72,13,0,Matches
Vinicius Silvestre,br BRA,GK,Portimonense,29,1994,14.0,0,0,0,0,0,0,3,0.0,3,0,0,0,0,0,10,1,Matches
David Simão,pt POR,MF,Arouca,33,1990,28.4,47,28,22,21,4,28,63,44.4,35,40,9,31,34,81,22,3,Matches
André Simões,pt POR,FW,Gil Vicente FC,19,2003,0.2,0,0,0,0,0,0,1,0.0,1,0,0,0,0,0,0,0,Matches
Alexandre Miguel Barros Soares,pt POR,MF,Estoril,32,1991,2.8,9,4,2,6,1,4,6,66.7,2,2,1,1,3,12,3,0,Matches
Filipe Soares,pt POR,MF,Famalicão,24,1999,1.9,4,2,1,1,2,1,3,33.3,2,0,0,0,0,4,1,0,Matches
Samuel Soares,pt POR,GK,Benfica,21,2002,5.0,0,0,0,0,0,0,0,,0,0,0,0,0,0,2,0,Matches
Yuki Soma,jp JPN,"FW,MF",Casa Pia,26,1997,21.0,21,15,6,11,4,7,21,33.3,14,12,1,11,4,25,11,0,Matches
Alberto Soro,es ESP,"FW,MF",Vizela,24,1999,10.0,21,13,9,8,4,6,16,37.5,10,10,0,10,1,22,8,0,Matches

Gonçalo Sousa,pt POR,FW,Porto,17,2006,0.1,0,0,0,0,0,0,0,,0,0,0,0,0,0,1,0,Matches
Aloísio Souza Genézio,br BRA,MF,Estrela,27,1996,16.6,44,30,13,27,4,19,46,41.3,27,16,4,12,24,68,20,0,Matches
Hugo Souza,br BRA,GK,Chaves,24,1999,26.0,0,0,0,0,0,0,1,0.0,1,0,0,0,0,0,16,2,Matches
Jose Souza,pt POR,MF,Portimonense,22,2001,0.1,0,0,0,0,0,0,1,0.0,1,1,0,1,0,0,0,0,Matches
Diogo Spencer,pt POR,DF,Benfica,19,2004,0.0,0,0,0,0,0,0,0,,0,0,0,0,0,0,0,0,Matches
Jerry St. Juste,nl NED,DF,Sporting CP,26,1996,6.0,13,5,7,5,1,5,9,55.6,4,5,0,5,6,19,8,0,Matches
Harouna Sy,fr FRA,FW,Estoril,27,1996,0.1,0,0,0,0,0,0,0,,0,0,0,0,0,0,1,0,Matches
Habib sylla,ci CIV,DF,Chaves,24,1999,4.5,6,2,3,2,1,2,3,66.7,1,9,2,7,1,7,16,0,Matches
Morlaye Sylla,gn GUI,"MF,FW",Arouca,25,1998,28.7,69,41,24,31,14,38,73,52.1,35,42,3,39,27,96,17,0,Matches
Talocha,pt POR,DF,Farense,33,1989,22.9,36,26,21,13,2,18,25,72.0,7,31,13,18,26,62,87,0,Matches
Tamble,pt POR,FW,Portimonense,22,2000,4.0,0,0,0,0,0,0,2,0.0,2,3,3,0,1,1,3,0,Matches
Mateo Tanlongo,ar ARG,MF,Rio Ave,19,2003,6.8,18,8,6,9,3,5,15,33.3,10,4,1,3,8,26,1,0,Matches
Mehdi Taremi,ir IRN,"FW,MF",Porto,31,1992,16.4,24,15,8,9,7,8,24,33.3,16,14,3,11,7,31,21,0,Matches
Heriberto Tavares,pt POR,"FW,MF",Estoril,26,1997,13.9,14,9,7,5,2,4,18,22.2,14,6,0,6,4,18,5,2,Matches
Martim Tavares,pt POR,"FW,MF",Boavista,19,2003,6.0,4,3,1,3,0,1,4,25.0,3,6,3,3,2,6,4,0,Matches
Ronaldo Tavares,pt POR,FW,Estrela,26,1997,12.8,9,4,2,4,3,2,4,50.0,2,10,1,9,2,11,15,0,Matches
Duplexe Tchamba,cm CMR,DF,Casa Pia,25,1998,13.9,23,14,17,5,1,16,26,61.5,10,14,6,8,18,41,79,1,Matches
João Teixeira,pt POR,"MF,FW",Rio Ave,29,1994,8.0,17,10,9,7,1,9,21,42.9,12,14,2,12,4,21,5,0,Matches
Casper Tengstedt,dk DEN,FW,Benfica,23,2000,7.4,11,5,2,5,4,7,12,58.3,5,6,0,6,0,11,2,0,Matches
Pedro Tiba,pt POR,MF,Gil Vicente FC,34,1988,16.6,46,35,23,15,8,22,44,50.0,22,15,4,11,15,61,17,0,Matches
Mirko Topić,rs SRB,MF,Famalicão,22,2001,26.1,51,39,24,24,3,22,32,68.8,10,27,4,23,47,98,47,1,Matches
Alfonso Trezza,uy URU,"FW,MF",Arouca,24,1999,9.3,17,14,11,6,0,7,24,29.2,17,15,0,15,6,23,8,0,Matches
Francisco Trincão,pt POR,"FW,MF",Sporting CP,23,1999,18.9,28,19,8,16,4,9,24,37.5,15,13,2,11,4,32,8,0,Matches
Anatolii Trubin,ua UKR,GK,Benfica,21,2001,28.0,1,1,1,0,0,1,2,50.0,1,0,0,0,1,2,10,3,Matches
Ukra,pt POR,"FW,MF",Rio Ave,35,1988,0.9,0,0,0,0,0,0,1,0.0,1,0,0,0,0,0,0,0,Matches

Iker Unzueta,es ESP,FW,Vizela,24,1998,0.3,0,0,0,0,0,0,0,,0,0,0,0,0,0,0,0,Matches
João Valido,pt POR,GK,Arouca,23,2000,1.0,1,1,1,0,0,1,2,50.0,1,0,0,0,0,1,2,0,Matches
Alan Varela,ar ARG,MF,Porto,22,2001,24.7,36,20,11,21,4,15,35,42.9,20,32,8,24,23,59,28,0,Matches
Bruno Varela,cv CPV,GK,Vitória,28,1994,26.5,0,0,0,0,0,0,1,0.0,1,0,0,0,0,0,9,1,Matches
Fernando Varela,cv CPV,DF,Casa Pia,35,1987,23.0,28,20,20,7,1,15,23,65.2,8,33,19,14,17,45,113,0,Matches
Gustavo Varela,pt POR,FW,Benfica,18,2005,0.2,0,0,0,0,0,0,0,,0,0,0,0,0,0,0,0,Matches
Hélio Varela,cv CPV,"FW,MF",Portimonense,21,2002,30.5,35,22,19,10,6,14,39,35.9,25,29,4,25,15,50,31,0,Matches
Nilton Varela,pt POR,"DF,MF",Estrela,22,2001,6.2,20,15,15,5,0,16,22,72.7,6,5,1,4,4,24,9,0,Matches
Jhon Velásquez,co COL,"FW,MF",Farense,28,1995,0.3,0,0,0,0,0,0,1,0.0,1,0,0,0,0,0,1,0,Matches
Ricardo Velho,pt POR,GK,Farense,24,1998,32.0,0,0,0,0,0,0,1,0.0,1,0,0,0,0,0,21,2,Matches
Bruno Ventura,pt POR,"FW,MF",Rio Ave,22,2001,5.8,3,1,2,0,1,2,7,28.6,5,3,0,3,2,5,7,0,Matches
João Victor,br BRA,DF,Benfica,25,1998,0.3,0,0,0,0,0,0,0,,0,2,1,1,1,1,0,0,Matches
Paulo Victor,br BRA,"FW,MF",Chaves,22,2001,9.1,14,8,4,10,0,5,9,55.6,4,15,2,13,6,20,5,0,Matches
Kiko Vilas Boas,pt POR,DF,Gil Vicente FC,23,1999,6.3,18,11,11,7,0,8,11,72.7,3,3,0,3,7,25,26,0,Matches
Mikel Villanueva,ve VEN,DF,Vitória,30,1993,5.1,4,3,1,1,2,3,4,75.0,1,8,5,3,8,12,16,0,Matches
Marcos Vinicios Sorriso,br BRA,"FW,MF",Famalicão,22,2001,9.5,14,9,4,8,2,8,17,47.1,9,11,0,11,7,21,11,0,Matches
Bernardo Vital,pt POR,DF,Estoril,22,2000,28.3,39,21,24,14,1,23,40,57.5,17,38,24,14,23,62,107,2,Matches
Vitinho,br BRA,"FW,MF",Arouca,23,2000,1.1,4,4,3,0,1,1,3,33.3,2,2,0,2,2,6,1,0,Matches
Steven Vitória,ca CAN,DF,Chaves,36,1987,15.0,11,8,8,3,0,8,9,88.9,1,17,14,3,4,15,75,3,Matches
Odisseas Vlachodimos,gr GRE,GK,Benfica,29,1994,1.0,0,0,0,0,0,0,0,,0,0,0,0,0,0,0,0,Matches
Marious Vrousai,gr GRE,"MF,DF",Rio Ave,25,1998,7.4,20,13,9,9,2,10,18,55.6,8,15,3,12,6,26,18,0,Matches
Ilija Vukotić,me MNE,MF,Boavista,24,1999,11.1,22,16,8,10,4,13,25,52.0,12,7,4,3,3,25,27,0,Matches
Masaki Watai,jp JPN,"FW,MF",Boavista,24,1999,4.8,8,4,4,2,2,2,10,20.0,8,4,0,4,5,13,2,0,Matches
Wendell,br BRA,DF,Porto,30,1993,23.3,40,23,16,23,1,21,37,56.8,16,21,3,18,14,54,42,0,Matches
Weverson,br BRA,DF,Arouca,23,2000,22.2,53,29,25,24,4,34,48,70.8,14,28,6,22,17,70,46,0,Matches

Bruno Wilson,pt POR,DF,Vizela,26,1996,15.6,15,8,9,5,1,11,14,78.6,3,20,14,6,19,34,62,0,Matches
Roan Wilson,cr CRC,"MF,DF",Gil Vicente FC,21,2002,1.4,8,4,2,6,0,4,6,66.7,2,3,0,3,2,10,3,0,Matches
Frederik Winther,dk DEN,DF,Estoril,22,2001,1.3,0,0,0,0,0,0,1,0.0,1,0,0,0,0,0,9,1,Matches
Abdul-Aziz Yakubu,gh GHA,FW,Rio Ave,24,1998,12.4,2,2,0,2,0,1,8,12.5,7,3,2,1,0,2,17,0,Matches
Moses Yaw,gh GHA,"DF,MF",Arouca,24,1999,0.8,1,1,1,0,0,1,1,100.0,0,1,0,1,0,1,1,0,Matches
Zaydou Youssouf,fr FRA,MF,Famalicão,24,1999,30.7,76,48,34,32,10,28,60,46.7,32,32,2,30,27,103,25,0,Matches
Rodrigo Zalazar,uy URU,MF,Braga,23,1999,20.2,40,27,11,24,5,18,42,42.9,24,33,3,30,9,49,16,3,Matches
Vinícius Zanocelo,br BRA,MF,Estoril,22,2001,12.4,18,9,9,8,1,8,21,38.1,13,7,2,5,10,28,25,0,Matches
Zinho,br BRA,"FW,MF",Portimonense,20,2003,1.6,4,3,1,1,2,3,4,75.0,1,2,0,2,1,5,1,0,Matches
Ivan Zlobin,ru RUS,GK,Famalicão,26,1997,1.0,0,0,0,0,0,0,0,,0,0,0,0,0,0,0,0,Matches
Nermin Zolotić,ba BIH,DF,Casa Pia,30,1993,29.7,41,29,26,14,1,32,49,65.3,17,40,22,18,28,69,127,2,Matches
