Player,Nation,Position,Squad,Age,Year of birth,90s Played,Tackles,Tackles Won,Tackles (Def 3rd),Tackles (Mid 3rd),Tackles (Att 3rd),Dribblers Tackled,Dribbles Challenged,% of Dribblers Tackled,Challenges Lost,Blocks,Shots Blocked,Passes Blocked,Interceptions,Tkl+Int,Clearances,Errors,Matches


Patrick van Aanholt,nl NED,"MF,DF",nl PSV Eindhoven,32,1990,1.1,4,1,0,4,0,2,6,33.3,4,1,0,1,2,6,0,0,Matches
Brenden Aaronson,us USA,MF,de Union Berlin,22,2000,1.5,1,0,1,0,0,0,4,0.0,4,5,1,4,3,4,1,0,Matches
Salis Abdul Samed,gh GHA,MF,fr Lens,23,2000,5.5,9,5,3,6,0,2,6,33.3,4,6,1,5,5,14,7,0,Matches
Francesco Acerbi,it ITA,DF,it Inter,35,1988,4.7,3,1,2,0,1,2,5,40.0,3,1,0,1,5,8,15,0,Matches
Elias Achouri,tn TUN,"FW,MF",dk FC Copenhagen,24,1999,6.1,16,11,10,0,6,5,11,45.5,6,6,0,6,2,18,4,1,Matches
Marcos Acuña,ar ARG,DF,es Sevilla,31,1991,2.2,2,2,1,1,0,1,2,50.0,1,1,1,0,1,3,2,0,Matches
Karim Adeyemi,de GER,FW,de Dortmund,21,2002,7.9,7,5,4,3,0,4,8,50.0,4,7,0,7,8,15,5,0,Matches
Yacine Adli,fr FRA,MF,it Milan,23,2000,1.4,3,2,1,2,0,2,4,50.0,2,0,0,0,3,6,4,0,Matches
Ruben Aguilar,fr FRA,DF,fr Lens,30,1993,1.1,4,4,2,2,0,2,3,66.7,1,3,0,3,0,4,1,0,Matches
Manuel Akanji,ch SUI,"DF,MF",eng Manchester City,28,1995,7.4,12,7,5,4,3,4,7,57.1,3,4,2,2,2,14,11,0,Matches
Nathan Aké,nl NED,"DF,MF",eng Manchester City,28,1995,4.3,4,2,3,1,0,2,3,66.7,1,1,0,1,0,4,11,0,Matches
Kerem Aktürkoğlu,tr TUR,"MF,FW",tr Galatasaray,24,1998,4.9,5,4,1,2,2,5,7,71.4,2,3,0,3,2,7,5,0,Matches
David Alaba,at AUT,DF,es Real Madrid,31,1992,2.8,1,1,0,1,0,1,1,100.0,0,1,1,0,3,4,9,1,Matches
Luis Alberto,es ESP,MF,it Lazio,30,1992,7.1,4,2,1,2,1,1,10,10.0,9,13,4,9,7,11,3,0,Matches
Toby Alderweireld,be BEL,DF,be Antwerp,34,1989,5.0,6,4,4,2,0,5,9,55.6,4,9,5,4,5,11,24,0,Matches
Mohamed Ali Cho,fr FRA,"FW,MF",es Real Sociedad,19,2004,1.5,0,0,0,0,0,0,0,,0,1,0,1,0,0,0,0,Matches
Miguel Almirón,py PAR,FW,eng Newcastle Utd,29,1994,4.6,15,11,4,7,4,10,15,66.7,5,8,1,7,4,19,2,0,Matches
Marcos Alonso,es ESP,"DF,FW",es Barcelona,32,1990,1.5,1,0,0,1,0,1,1,100.0,0,3,0,3,2,3,5,0,Matches
Barış Alper Yılmaz,tr TUR,"FW,MF",tr Galatasaray,23,2000,1.4,2,2,0,1,1,0,4,0.0,4,0,0,0,2,4,0,0,Matches
Julián Álvarez,ar ARG,"MF,FW",eng Manchester City,23,2000,3.1,3,2,0,2,1,2,5,40.0,3,1,1,0,0,3,2,0,Matches
Mohamed Aly Camara,gn GUI,DF,ch Young Boys,25,1997,5.0,8,4,6,2,0,3,6,50.0,3,12,9,3,6,14,24,0,Matches
Aurele Amenda,ch SUI,DF,ch Young Boys,20,2003,3.5,7,4,4,3,0,3,9,33.3,6,5,1,4,6,13,10,0,Matches
Sofyan Amrabat,ma MAR,"MF,DF",eng Manchester Utd,26,1996,3.6,8,5,5,2,1,6,8,75.0,2,10,1,9,3,11,3,0,Matches
Elliot Anderson,eng ENG,MF,eng Newcastle Utd,20,2002,0.5,2,1,1,1,0,0,2,0.0,2,1,1,0,2,4,0,0,Matches
Felipe Anderson,br BRA,FW,it Lazio,30,1993,6.0,17,7,5,10,2,5,21,23.8,16,7,0,7,12,29,5,0,Matches

Angeliño,es ESP,DF,tr Galatasaray,26,1997,4.7,7,5,3,2,2,4,9,44.4,5,6,3,3,6,13,9,0,Matches
Peter Ankersen,dk DEN,DF,dk FC Copenhagen,32,1990,5.2,12,8,7,4,1,8,17,47.1,9,5,4,1,10,22,11,0,Matches
Antony,br BRA,FW,eng Manchester Utd,23,2000,2.6,7,6,5,1,1,5,9,55.6,4,5,1,4,5,12,2,0,Matches
Jon Aramburu,ve VEN,DF,es Real Sociedad,21,2002,0.0,0,0,0,0,0,0,0,,0,0,0,0,0,0,1,0,Matches
Ronald Araújo,uy URU,DF,es Barcelona,24,1999,7.3,12,10,4,7,1,4,5,80.0,1,14,10,4,8,20,20,0,Matches
Tomás Araújo,pt POR,DF,pt Benfica,21,2002,1.8,3,2,1,2,0,1,1,100.0,0,5,4,1,4,7,5,0,Matches
Marko Arnautović,at AUT,FW,it Inter,34,1989,2.1,0,0,0,0,0,0,0,,0,1,0,1,1,1,2,0,Matches
Kepa Arrizabalaga,es ESP,GK,es Real Madrid,28,1994,4.0,0,0,0,0,0,0,0,,0,0,0,0,0,0,0,0,Matches
Marco Asensio,es ESP,"FW,MF",fr Paris S-G,27,1996,1.4,2,1,2,0,0,0,1,0.0,1,2,2,0,0,2,0,0,Matches
Kristjan Asllani,al ALB,MF,it Inter,21,2002,2.3,2,1,1,1,0,0,2,0.0,2,3,1,2,1,3,3,0,Matches
Otavio Ataide,br BRA,DF,pt Porto,21,2002,2.3,4,4,3,1,0,1,1,100.0,0,3,3,0,0,4,6,0,Matches
Emil Audero,it ITA,GK,it Inter,26,1997,1.0,0,0,0,0,0,0,0,,0,0,0,0,0,0,0,0,Matches
Carlos Augusto,br BRA,"DF,FW",it Inter,24,1999,5.3,10,6,6,4,0,5,10,50.0,5,6,2,4,0,10,15,0,Matches
Yann Aurel Bisseck,de GER,DF,it Inter,22,2000,1.9,1,0,1,0,0,0,1,0.0,1,3,2,1,1,2,8,0,Matches
Fredrik Aursnes,no NOR,"DF,MF",pt Benfica,27,1995,6.0,13,8,8,4,1,7,13,53.8,6,9,2,7,3,16,13,0,Matches
Kaan Ayhan,tr TUR,"MF,DF",tr Galatasaray,28,1994,4.2,8,5,2,5,1,3,9,33.3,6,3,2,1,11,19,8,0,Matches
Neil El Aynaoui,fr FRA,MF,fr Lens,22,2001,1.5,5,2,2,2,1,2,2,100.0,0,2,1,1,1,6,4,0,Matches
Irakli Azarov,ge GEO,DF,ua Shakhtar,21,2002,3.3,9,5,6,3,0,3,13,23.1,10,2,1,1,4,13,12,0,Matches
César Azpilicueta,es ESP,DF,es Atlético Madrid,33,1989,3.2,6,5,3,2,1,2,6,33.3,4,11,5,6,5,11,13,0,Matches
Isaac Babadi,nl NED,"FW,MF",nl PSV Eindhoven,18,2005,0.2,1,1,1,0,0,0,0,,0,1,0,1,0,1,0,1,Matches
Loïc Bade,fr FRA,DF,es Sevilla,23,2000,1.1,4,3,4,0,0,4,4,100.0,0,1,1,0,1,5,7,0,Matches
Alexander Bah,dk DEN,DF,pt Benfica,25,1997,2.1,11,6,7,3,1,7,9,77.8,2,7,1,6,4,15,6,0,Matches
Samson Baidoo,at AUT,DF,at RB Salzburg,19,2004,3.4,9,5,6,3,0,5,10,50.0,5,6,3,3,0,9,12,0,Matches
Cédric Bakambu,cd COD,FW,tr Galatasaray,32,1991,0.4,0,0,0,0,0,0,0,,0,0,0,0,0,0,0,0,Matches
Johan Bakayoko,be BEL,FW,nl PSV Eindhoven,20,2003,7.2,10,8,4,4,2,6,9,66.7,3,8,1,7,4,14,3,0,Matches

Alejandro Balde,es ESP,DF,es Barcelona,19,2003,3.7,6,4,2,2,2,4,5,80.0,1,3,0,3,1,7,5,0,Matches
Michel-Ange Balikwisha,be BEL,"FW,MF",be Antwerp,22,2001,4.3,9,4,1,7,1,3,8,37.5,5,5,0,5,5,14,1,0,Matches
David von Ballmoos,ch SUI,GK,ch Young Boys,28,1994,1.0,0,0,0,0,0,0,0,,0,0,0,0,0,0,1,0,Matches
Simon Banza,cd COD,FW,pt Braga,26,1996,3.8,1,0,0,1,0,0,0,,0,3,0,3,0,1,2,0,Matches
Bradley Barcola,fr FRA,"FW,DF",fr Paris S-G,20,2002,5.3,12,10,4,5,3,3,16,18.8,13,9,0,9,3,15,3,0,Matches
Abdülkerim Bardakcı,tr TUR,DF,tr Galatasaray,28,1994,6.0,19,9,13,4,2,13,19,68.4,6,6,5,1,11,30,25,0,Matches
Roony Bardghji,se SWE,"MF,FW",dk FC Copenhagen,17,2005,1.6,0,0,0,0,0,0,3,0.0,3,0,0,0,1,1,1,0,Matches
Nicolò Barella,it ITA,MF,it Inter,26,1997,5.2,16,13,6,7,3,5,10,50.0,5,6,2,4,5,21,5,0,Matches
Harvey Barnes,eng ENG,FW,eng Newcastle Utd,25,1997,0.0,0,0,0,0,0,0,0,,0,0,0,0,0,0,0,0,Matches
Romário Baró,pt POR,MF,pt Porto,23,2000,0.7,0,0,0,0,0,0,1,0.0,1,1,0,1,1,1,1,1,Matches
Ander Barrenetxea,es ESP,"FW,MF",es Real Sociedad,21,2001,4.4,12,6,7,2,3,7,14,50.0,7,3,0,3,1,13,2,0,Matches
Pablo Barrios,es ESP,MF,es Atlético Madrid,20,2003,2.9,5,5,4,1,0,2,6,33.3,4,4,3,1,7,12,4,0,Matches
Davide Bartesaghi,it ITA,FW,it Milan,17,2005,0.0,0,0,0,0,0,0,1,0.0,1,0,0,0,0,0,0,0,Matches
Alessandro Bastoni,it ITA,DF,it Inter,24,1999,5.6,5,1,3,2,0,1,3,33.3,2,6,1,5,6,11,15,1,Matches
Jelle Bataille,be BEL,DF,be Antwerp,24,1999,4.6,9,6,6,1,2,7,12,58.3,5,3,0,3,5,14,2,0,Matches
Christoph Baumgartner,at AUT,MF,de RB Leipzig,23,1999,1.3,3,1,2,0,1,2,5,40.0,3,2,0,2,3,6,3,0,Matches
Sheraldo Becker,sr SUR,FW,de Union Berlin,28,1995,4.1,0,0,0,0,0,0,0,,0,3,1,2,1,1,1,0,Matches
Sheraldo Becker,sr SUR,FW,es Real Sociedad,28,1995,0.7,0,0,0,0,0,0,0,,0,0,0,0,0,0,0,0,Matches
Thomas Beelen,nl NED,DF,nl Feyenoord,22,2001,0.9,2,1,1,1,0,1,1,100.0,0,0,0,0,0,2,2,0,Matches
Kevin Behrens,de GER,FW,de Union Berlin,32,1991,3.3,3,2,0,2,1,1,2,50.0,1,4,2,2,1,4,9,0,Matches
Armel Bella Kotchap,de GER,DF,nl PSV Eindhoven,21,2001,0.9,3,2,3,0,0,3,4,75.0,1,2,2,0,0,3,1,0,Matches
Jude Bellingham,eng ENG,"MF,FW",es Real Madrid,20,2003,11.0,20,9,8,7,5,5,12,41.7,7,7,2,5,7,27,7,0,Matches
Walter Benítez,ar ARG,GK,nl PSV Eindhoven,30,1993,8.0,0,0,0,0,0,0,0,,0,0,0,0,0,0,2,0,Matches
Loris Benito,ch SUI,DF,ch Young Boys,31,1992,4.5,6,4,3,3,0,3,8,37.5,5,7,5,2,7,13,15,0,Matches
Ramy Bensebaini,dz ALG,DF,de Dortmund,28,1995,4.2,21,12,12,7,2,12,15,80.0,3,16,6,10,7,28,9,0,Matches

Lucas Beraldo,br BRA,DF,fr Paris S-G,19,2003,4.5,11,7,7,4,0,6,13,46.2,7,4,2,2,5,16,13,0,Matches
Paulo Bernardo,pt POR,MF,sct Celtic,21,2002,3.5,2,0,2,0,0,0,7,0.0,7,8,2,6,5,7,2,0,Matches
Juan Bernat,es ESP,DF,pt Benfica,30,1993,1.2,3,2,1,2,0,3,3,100.0,0,1,1,0,1,4,1,0,Matches
Mads Bidstrup,dk DEN,MF,at RB Salzburg,22,2001,5.5,22,15,12,8,2,9,18,50.0,9,22,4,18,7,29,16,0,Matches
Justin Bijlow,nl NED,GK,nl Feyenoord,25,1998,4.0,0,0,0,0,0,0,1,0.0,1,1,0,1,0,0,3,0,Matches
Janis Blaswich,de GER,GK,de RB Leipzig,32,1991,5.0,0,0,0,0,0,0,0,,0,0,0,0,0,0,2,0,Matches
Lewin Blum,ch SUI,DF,ch Young Boys,22,2001,2.4,5,5,4,0,1,4,7,57.1,3,2,1,1,2,7,6,0,Matches
Oscar Bobb,no NOR,"FW,MF",eng Manchester City,20,2003,2.4,2,1,0,2,0,2,2,100.0,0,0,0,0,0,2,0,0,Matches
Sacha Boey,fr FRA,DF,tr Galatasaray,22,2000,6.0,20,12,13,5,2,11,22,50.0,11,10,3,7,6,26,20,0,Matches
Nicolai Boilesen,dk DEN,"DF,FW",dk FC Copenhagen,31,1992,1.0,1,1,1,0,0,1,2,50.0,1,2,1,1,0,1,5,0,Matches
Valerii Bondar,ua UKR,DF,ua Shakhtar,24,1999,4.0,7,4,4,3,0,5,7,71.4,2,6,3,3,5,12,18,2,Matches
Artem Bondarenko,ua UKR,MF,ua Shakhtar,22,2000,2.5,4,4,2,2,0,2,4,50.0,2,6,1,5,2,6,4,0,Matches
Leonardo Bonucci,it ITA,DF,de Union Berlin,36,1987,2.9,1,0,1,0,0,1,2,50.0,1,5,5,0,2,3,23,0,Matches
Gonçalo Borges,pt POR,FW,pt Porto,22,2001,0.4,1,1,0,1,0,0,0,,0,0,0,0,1,2,0,0,Matches
Cristian Borja,co COL,DF,pt Braga,30,1993,5.7,13,7,6,6,1,6,8,75.0,2,10,0,10,3,16,11,0,Matches
Olivier Boscagli,fr FRA,DF,nl PSV Eindhoven,25,1997,6.8,15,7,9,5,1,6,10,60.0,4,10,5,5,11,26,26,0,Matches
Sven Botman,nl NED,DF,eng Newcastle Utd,23,2000,1.0,0,0,0,0,0,0,1,0.0,1,1,1,0,0,0,2,0,Matches
Julian Brandt,de GER,"MF,FW",de Dortmund,27,1996,8.7,17,9,7,9,1,14,22,63.6,8,10,0,10,4,21,10,0,Matches
Bruma,pt POR,FW,pt Braga,28,1994,4.1,8,4,3,3,2,4,7,57.1,3,3,0,3,1,9,2,0,Matches
Osman Bukari,gh GHA,FW,rs Red Star,24,1998,5.4,5,3,1,1,3,2,4,50.0,2,2,0,2,2,7,2,0,Matches
Dan Burn,eng ENG,DF,eng Newcastle Utd,31,1992,3.1,6,3,5,1,0,3,4,75.0,1,9,5,4,1,7,16,0,Matches
Jean Butez,fr FRA,GK,be Antwerp,28,1995,5.0,0,0,0,0,0,0,2,0.0,2,0,0,0,0,0,0,2,Matches
Arthur Cabral,br BRA,"FW,DF",pt Benfica,25,1998,1.3,3,2,1,2,0,1,1,100.0,0,0,0,0,0,3,2,0,Matches
Jens Cajuste,se SWE,MF,it Napoli,23,1999,1.8,7,4,5,2,0,4,6,66.7,2,3,1,2,2,9,2,0,Matches
Davide Calabria,it ITA,DF,it Milan,26,1996,4.8,18,14,10,3,5,11,18,61.1,7,8,2,6,3,21,10,0,Matches

Hakan Çalhanoğlu,tr TUR,MF,it Inter,29,1994,5.7,10,5,7,2,1,4,13,30.8,9,8,2,6,6,16,4,0,Matches
Eduardo Camavinga,fr FRA,MF,es Real Madrid,20,2002,8.8,25,13,13,6,6,10,20,50.0,10,21,6,15,9,34,20,0,Matches
Emre Can,de GER,"MF,DF",de Dortmund,29,1994,10.1,19,12,10,8,1,11,22,50.0,11,13,3,10,12,31,14,0,Matches
João Cancelo,pt POR,DF,es Barcelona,29,1994,9.0,32,22,16,11,5,21,28,75.0,7,13,6,7,19,51,17,1,Matches
Nicolás Capaldo,ar ARG,"MF,DF",at RB Salzburg,25,1997,2.4,9,3,6,3,0,4,9,44.4,5,4,0,4,6,15,3,0,Matches
Fábio Cardoso,pt POR,DF,pt Porto,29,1994,3.0,2,2,0,1,1,0,1,0.0,1,3,2,1,3,5,5,0,Matches
David Carmo,ao ANG,DF,pt Porto,24,1999,4.0,5,2,4,1,0,2,3,66.7,1,7,5,2,4,9,20,0,Matches
Cameron Carter-Vickers,us USA,DF,sct Celtic,25,1997,3.3,4,2,2,2,0,3,4,75.0,1,4,2,2,4,8,12,0,Matches
Dani Carvajal,es ESP,DF,es Real Madrid,31,1992,9.4,24,13,13,11,0,11,18,61.1,7,17,7,10,9,33,27,0,Matches
Fabio Carvalho,pt POR,MF,de RB Leipzig,20,2002,1.4,6,2,2,1,3,3,10,30.0,7,3,0,3,1,7,0,0,Matches
Vitor Carvalho,br BRA,MF,pt Braga,26,1997,2.9,4,3,2,2,0,3,5,60.0,2,5,2,3,1,5,6,0,Matches
Marc Casado,es ESP,MF,es Barcelona,19,2003,0.3,0,0,0,0,0,0,0,,0,2,1,1,1,1,1,0,Matches
Nicolò Casale,it ITA,DF,it Lazio,25,1998,2.0,1,1,1,0,0,0,2,0.0,2,1,0,1,0,1,9,0,Matches
Casemiro,br BRA,MF,eng Manchester Utd,31,1992,1.8,6,3,4,2,0,3,9,33.3,6,3,0,3,1,7,4,0,Matches
Valentín Castellanos,ar ARG,FW,it Lazio,24,1998,2.4,2,0,1,1,0,0,5,0.0,5,1,0,1,0,2,2,0,Matches
André Castro,pt POR,MF,pt Braga,35,1988,0.1,0,0,0,0,0,0,0,,0,0,0,0,0,0,0,0,Matches
Danilo Cataldi,it ITA,MF,it Lazio,28,1994,1.8,2,1,1,1,0,1,2,50.0,1,0,0,0,1,3,1,0,Matches
Dani Ceballos,es ESP,MF,es Real Madrid,26,1996,1.7,3,1,1,1,1,1,4,25.0,3,1,0,1,3,6,2,0,Matches
Miguel Chaiwa,zm ZAM,MF,ch Young Boys,19,2004,0.7,1,1,0,1,0,0,7,0.0,7,5,2,3,1,2,1,0,Matches
Chiquinho,pt POR,MF,pt Benfica,28,1995,0.6,1,1,0,1,0,0,0,,0,1,1,0,0,1,2,0,Matches
Andreas Christensen,dk DEN,"DF,MF",es Barcelona,27,1996,4.9,11,7,5,5,1,5,7,71.4,2,3,1,2,7,18,11,0,Matches
Samuel Chukwueze,ng NGA,FW,it Milan,24,1999,1.8,2,2,0,1,1,1,3,33.3,2,2,1,1,0,2,1,0,Matches
Viktor Claesson,se SWE,"FW,MF",dk FC Copenhagen,31,1992,5.3,7,4,4,1,2,6,11,54.5,5,17,3,14,4,11,10,0,Matches
William Clem,dk DEN,MF,dk FC Copenhagen,19,2004,0.8,1,0,1,0,0,0,3,0.0,3,0,0,0,0,1,2,0,Matches
Ebrima Colley,gm GAM,"MF,FW",ch Young Boys,23,2000,1.4,3,2,1,2,0,1,4,25.0,3,2,0,2,1,4,0,0,Matches

Kingsley Coman,fr FRA,FW,de Bayern Munich,27,1996,5.0,4,2,2,2,0,0,4,0.0,4,6,0,6,0,4,1,0,Matches
Francisco Conceição,pt POR,"FW,MF",pt Porto,20,2002,2.7,2,1,1,0,1,0,5,0.0,5,3,0,3,1,3,1,0,Matches
Kobe Corbanie,be BEL,"DF,FW",be Antwerp,18,2005,0.4,1,0,0,1,0,0,0,,0,0,0,0,1,2,4,0,Matches
Andreas Cornelius,dk DEN,"FW,MF",dk FC Copenhagen,30,1993,0.9,1,1,0,1,0,0,0,,0,0,0,0,0,1,0,0,Matches
Ángel Correa,ar ARG,"FW,MF",es Atlético Madrid,28,1995,3.6,1,1,0,1,0,0,1,0.0,1,3,0,3,0,1,4,0,Matches
David Costa,pt POR,"MF,FW",fr Lens,22,2001,1.3,2,2,0,1,1,2,2,100.0,0,1,0,1,2,4,0,0,Matches
Diogo Costa,pt POR,GK,pt Porto,23,1999,8.3,0,0,0,0,0,0,0,,0,0,0,0,0,0,6,1,Matches
Soumaïla Coulibaly,fr FRA,DF,be Antwerp,19,2003,6.0,5,3,5,0,0,3,4,75.0,1,8,7,1,7,12,26,0,Matches
Thibaut Courtois,be BEL,GK,es Real Madrid,31,1992,1.0,0,0,0,0,0,0,1,0.0,1,0,0,0,0,0,0,0,Matches
Juan Cuadrado,co COL,"DF,FW",it Inter,35,1988,1.3,0,0,0,0,0,0,0,,0,1,0,1,1,1,1,0,Matches
Pau Cubarsí,es ESP,DF,es Barcelona,16,2007,3.0,6,5,5,1,0,1,1,100.0,0,2,1,1,1,7,13,0,Matches
Diogo Dalot,pt POR,DF,eng Manchester Utd,24,1999,5.1,7,5,4,2,1,3,8,37.5,5,8,4,4,3,10,13,0,Matches
Kevin Danso,at AUT,DF,fr Lens,24,1998,6.0,4,2,3,1,0,3,5,60.0,2,4,2,2,4,8,27,0,Matches
Matteo Darmian,it ITA,"DF,FW",it Inter,33,1989,4.5,8,3,3,4,1,5,9,55.6,4,9,2,7,2,10,10,0,Matches
David Datro Fofana,ci CIV,FW,de Union Berlin,20,2002,2.2,2,1,0,1,1,1,1,100.0,0,1,0,1,0,2,6,0,Matches
Alphonso Davies,ca CAN,DF,de Bayern Munich,22,2000,7.8,14,9,10,2,2,8,17,47.1,9,11,3,8,5,19,14,0,Matches
Kevin De Bruyne,be BEL,MF,eng Manchester City,32,1991,2.2,4,3,0,2,2,3,6,50.0,3,2,0,2,0,4,0,0,Matches
Ritchie De Laet,be BEL,DF,be Antwerp,34,1988,2.5,4,2,3,1,0,2,5,40.0,3,5,3,2,3,7,11,0,Matches
Rodrigo De Paul,ar ARG,MF,es Atlético Madrid,29,1994,6.8,10,4,3,6,1,6,11,54.5,5,16,0,16,4,14,7,1,Matches
Amar Dedić,ba BIH,DF,at RB Salzburg,20,2002,6.0,12,4,9,1,2,7,13,53.8,6,10,2,8,6,18,21,0,Matches
Miloš Degenek,au AUS,FW,rs Red Star,29,1994,0.1,0,0,0,0,0,0,0,,0,0,0,0,0,0,1,0,Matches
Ousmane Dembélé,fr FRA,"FW,MF",fr Paris S-G,26,1997,10.6,15,10,3,7,5,6,15,40.0,9,6,0,6,6,21,1,0,Matches
Kerem Demirbay,de GER,MF,tr Galatasaray,30,1993,0.7,2,1,1,0,1,2,4,50.0,2,0,0,0,0,2,0,0,Matches
Thomas van den Belt,nl NED,MF,nl Feyenoord,22,2001,0.4,1,0,0,1,0,0,1,0.0,1,0,0,0,1,2,0,0,Matches
Sergiño Dest,us USA,DF,nl PSV Eindhoven,22,2000,7.2,13,7,6,5,2,9,14,64.3,5,9,0,9,4,17,11,0,Matches

Giovanni Di Lorenzo,it ITA,DF,it Napoli,29,1993,8.0,20,12,13,7,0,15,21,71.4,6,11,2,9,6,26,15,0,Matches
Ángel Di María,ar ARG,FW,pt Benfica,35,1988,4.6,3,3,2,1,0,1,7,14.3,6,4,0,4,1,4,2,0,Matches
Rúben Dias,pt POR,DF,eng Manchester City,26,1997,8.5,11,8,4,6,1,7,11,63.6,4,8,4,4,9,20,20,0,Matches
Brahim Díaz,ma MAR,"MF,FW",es Real Madrid,23,1999,3.6,8,4,2,4,2,1,2,50.0,1,1,1,0,0,8,0,0,Matches
Eric Dier,eng ENG,DF,de Bayern Munich,29,1994,5.0,7,5,4,2,1,3,3,100.0,0,6,4,2,6,13,18,0,Matches
Kevin Diks,nl NED,DF,dk FC Copenhagen,26,1996,7.9,8,5,8,0,0,6,6,100.0,0,8,5,3,7,15,39,0,Matches
Javairô Dilrosun,nl NED,DF,nl Feyenoord,25,1998,0.1,0,0,0,0,0,0,0,,0,0,0,0,0,0,0,0,Matches
Federico Dimarco,it ITA,DF,it Inter,25,1997,4.0,0,0,0,0,0,0,5,0.0,5,6,1,5,3,3,4,0,Matches
Andy Diouf,fr FRA,MF,fr Lens,20,2003,0.4,1,1,1,0,0,1,1,100.0,0,1,0,1,0,1,1,0,Matches
Novatus Dismas,tz TAN,DF,ua Shakhtar,20,2002,1.0,1,0,1,0,0,0,2,0.0,2,0,0,0,3,4,2,0,Matches
Álvaro djaló,es ESP,FW,pt Braga,23,1999,4.5,7,7,1,3,3,0,5,0.0,5,1,0,1,3,10,2,0,Matches
Nasser Djiga,bf BFA,DF,rs Red Star,20,2002,6.0,8,4,7,1,0,7,9,77.8,2,8,6,2,12,20,25,1,Matches
Marko Dmitrović,rs SRB,GK,es Sevilla,31,1992,4.0,0,0,0,0,0,0,0,,0,0,0,0,0,0,3,0,Matches
Danilho Doekhi,nl NED,DF,de Union Berlin,25,1998,2.9,5,2,4,1,0,2,7,28.6,5,4,2,2,1,6,11,0,Matches
Jeremy Doku,be BEL,"FW,MF",eng Manchester City,21,2002,3.4,6,3,0,5,1,3,4,75.0,1,5,0,5,0,6,0,0,Matches
Gianluigi Donnarumma,it ITA,GK,fr Paris S-G,24,1999,12.0,1,1,1,0,0,1,1,100.0,0,0,0,0,0,1,7,3,Matches
Nene Dorgeles,ml MLI,"FW,MF",at RB Salzburg,20,2002,1.5,3,2,0,2,1,1,1,100.0,0,4,0,4,1,4,0,0,Matches
Aleksandar Dragović,at AUT,DF,rs Red Star,32,1991,6.0,6,2,3,3,0,3,8,37.5,5,17,15,2,6,12,34,0,Matches
Martin Dúbravka,sk SVK,GK,eng Newcastle Utd,34,1989,1.0,0,0,0,0,0,0,0,,0,0,0,0,0,0,0,0,Matches
Denzel Dumfries,nl NED,DF,it Inter,27,1996,3.6,3,2,1,2,0,1,1,100.0,0,4,1,3,0,3,3,0,Matches
Ederson,br BRA,GK,eng Manchester City,29,1993,7.3,0,0,0,0,0,0,0,,0,0,0,0,0,0,1,1,Matches
Jorge Eduardo Sánchez,mx MEX,DF,pt Porto,25,1997,2.1,7,4,4,1,2,4,8,50.0,4,0,0,0,1,8,5,0,Matches
Eguinaldo,br BRA,"MF,FW",ua Shakhtar,18,2004,0.2,1,1,0,1,0,0,1,0.0,1,0,0,0,0,1,0,0,Matches
Chidera Ejuke,ng NGA,FW,be Antwerp,25,1998,1.7,2,1,1,1,0,2,4,50.0,2,2,0,2,3,5,0,0,Matches
Jurgen Ekkelenkamp,nl NED,MF,be Antwerp,23,2000,3.0,0,0,0,0,0,0,4,0.0,4,5,0,5,1,1,3,0,Matches

Meschak Elia,cd COD,"FW,MF",ch Young Boys,25,1997,5.5,4,2,2,2,0,1,6,16.7,5,8,0,8,0,4,2,0,Matches
Elif Elmas,mk MKD,MF,de RB Leipzig,23,1999,0.2,1,0,1,0,0,0,0,,0,0,0,0,1,2,0,0,Matches
Elif Elmas,mk MKD,"FW,MF",it Napoli,23,1999,1.6,0,0,0,0,0,0,1,0.0,1,2,0,2,2,2,0,0,Matches
Mohamed Elneny,eg EGY,MF,eng Arsenal,31,1992,0.7,0,0,0,0,0,0,1,0.0,1,1,0,1,0,0,0,0,Matches
Aritz Elustondo,es ESP,DF,es Real Sociedad,29,1994,1.9,7,4,5,1,1,5,6,83.3,1,3,0,3,1,8,7,0,Matches
Mohamed Elyounoussi,no NOR,"FW,MF",dk FC Copenhagen,28,1994,7.6,20,9,14,4,2,9,20,45.0,11,10,2,8,11,31,7,1,Matches
Youssef En-Nesyri,ma MAR,FW,es Sevilla,26,1997,5.7,5,2,2,2,1,2,2,100.0,0,4,1,3,3,8,2,0,Matches
Luis Enrique Palma,hn HON,FW,sct Celtic,23,2000,3.0,5,3,0,3,2,2,7,28.6,5,5,0,5,3,8,1,0,Matches
Christian Eriksen,dk DEN,MF,eng Manchester Utd,31,1992,2.3,0,0,0,0,0,0,3,0.0,3,3,1,2,3,3,3,0,Matches
Stephen Eustáquio,ca CAN,MF,pt Porto,26,1996,5.9,14,5,4,8,2,4,14,28.6,10,13,4,9,10,24,6,0,Matches
Evanilson,br BRA,FW,pt Porto,23,1999,5.4,6,3,1,4,1,3,4,75.0,1,3,0,3,3,9,2,0,Matches
Jonny Evans,nir NIR,DF,eng Manchester Utd,35,1988,0.7,1,1,1,0,0,1,1,100.0,0,2,1,1,0,1,1,0,Matches
Rasmus Falk,dk DEN,MF,dk FC Copenhagen,31,1992,7.0,19,8,11,5,3,14,20,70.0,6,8,2,6,9,28,9,1,Matches
João Félix,pt POR,FW,es Barcelona,23,1999,4.1,4,1,0,3,1,0,6,0.0,6,0,0,0,0,4,1,0,Matches
Bruno Fernandes,pt POR,"MF,FW",eng Manchester Utd,28,1994,6.0,13,6,6,6,1,5,19,26.3,14,7,1,6,3,16,9,0,Matches
Roger Fernandes,gw GNB,FW,pt Braga,17,2005,0.1,0,0,0,0,0,0,0,,0,0,0,0,1,1,0,0,Matches
Carlos Fernández,es ESP,FW,es Real Sociedad,27,1996,0.8,1,1,1,0,0,1,2,50.0,1,1,0,1,1,2,1,0,Matches
Fernando,br BRA,FW,at RB Salzburg,24,1999,0.4,0,0,0,0,0,0,1,0.0,1,0,0,0,0,0,0,0,Matches
Fernando,br BRA,MF,es Sevilla,36,1987,3.6,13,8,8,5,0,7,11,63.6,4,6,3,3,4,17,8,0,Matches
Alessandro Florenzi,it ITA,DF,it Milan,32,1991,1.8,8,7,6,2,0,4,7,57.1,3,3,1,2,2,10,6,0,Matches
Phil Foden,eng ENG,"FW,MF",eng Manchester City,23,2000,7.6,1,1,0,0,1,0,2,0.0,2,5,0,5,2,3,3,0,Matches
Diogo Fonseca,pt POR,DF,pt Braga,21,2002,0.2,0,0,0,0,0,0,0,,0,0,0,0,0,0,0,0,Matches
José Fonte,pt POR,DF,pt Braga,39,1983,4.0,4,1,3,1,0,1,6,16.7,5,6,4,2,1,5,16,1,Matches
James Forrest,sct SCO,FW,sct Celtic,32,1991,1.0,2,0,0,1,1,1,1,100.0,0,0,0,0,0,2,0,0,Matches
Emil Forsberg,se SWE,"MF,FW",de RB Leipzig,31,1991,4.5,8,4,4,1,3,3,8,37.5,5,4,1,3,4,12,2,0,Matches

Amankwah Forson,gh GHA,"MF,FW",at RB Salzburg,20,2002,0.8,3,2,3,0,0,1,2,50.0,1,3,1,2,0,3,0,0,Matches
Héctor Fort,es ESP,DF,es Barcelona,16,2006,0.7,0,0,0,0,0,0,3,0.0,3,0,0,0,0,0,4,0,Matches
Mitchel Frame,sct SCO,FW,sct Celtic,17,2006,0.2,2,1,1,1,0,0,0,,0,0,0,0,0,2,0,0,Matches
André Franco,pt POR,"MF,FW",pt Porto,25,1998,2.6,5,3,3,1,1,2,5,40.0,3,2,0,2,1,6,7,0,Matches
Przemysław Frankowski,pl POL,DF,fr Lens,28,1995,5.9,20,16,9,10,1,10,20,50.0,10,2,0,2,6,26,13,0,Matches
Davide Frattesi,it ITA,MF,it Inter,23,1999,5.0,10,7,5,5,0,4,11,36.4,7,4,1,3,3,13,8,0,Matches
Victor Froholdt,dk DEN,MF,dk FC Copenhagen,17,2006,0.6,2,2,0,2,0,0,2,0.0,2,2,0,2,3,5,1,0,Matches
Angelo Fulgini,fr FRA,MF,fr Lens,26,1996,3.2,6,3,2,3,1,5,9,55.6,4,2,0,2,1,7,1,0,Matches
Niclas Füllkrug,de GER,FW,de Dortmund,30,1993,11.5,2,1,0,2,0,0,3,0.0,3,10,1,9,1,3,10,0,Matches
Kyogo Furuhashi,jp JPN,FW,sct Celtic,28,1995,5.0,0,0,0,0,0,0,1,0.0,1,3,0,3,1,1,3,0,Matches
Gianluca Gaetano,it ITA,MF,it Napoli,23,2000,0.2,0,0,0,0,0,0,1,0.0,1,1,0,1,0,0,0,0,Matches
Javi Galán,es ESP,DF,es Atlético Madrid,28,1994,0.8,3,2,3,0,0,1,3,33.3,2,3,0,3,4,7,3,0,Matches
Javi Galán,es ESP,DF,es Real Sociedad,28,1994,2.0,6,4,2,3,1,2,6,33.3,4,5,1,4,6,12,0,0,Matches
Galeno,br BRA,"MF,FW",pt Porto,25,1997,7.2,7,5,4,1,2,3,5,60.0,2,4,0,4,8,15,7,0,Matches
Silvère Ganvoula M'Boussy,cg CGO,FW,ch Young Boys,27,1996,1.3,0,0,0,0,0,0,0,,0,1,0,1,0,0,3,0,Matches
Fran Garcia,es ESP,DF,es Real Madrid,23,1999,2.1,1,1,1,0,0,1,4,25.0,3,1,0,1,1,2,6,0,Matches
Ulisses Garcia,ch SUI,DF,ch Young Boys,27,1996,5.6,14,9,10,2,2,7,15,46.7,8,11,2,9,4,18,7,0,Matches
Alejandro Garnacho,ar ARG,"FW,MF",eng Manchester Utd,19,2004,3.3,4,4,0,4,0,2,4,50.0,2,6,0,6,5,9,0,0,Matches
Gavi,es ESP,MF,es Barcelona,18,2004,2.5,3,2,2,1,0,1,4,25.0,3,2,0,2,1,4,5,0,Matches
Lutsharel Geertruida,nl NED,DF,nl Feyenoord,23,2000,6.0,14,9,12,1,1,9,13,69.2,4,2,2,0,5,19,5,1,Matches
Mario Gila,es ESP,DF,it Lazio,22,2000,3.9,8,8,8,0,0,4,7,57.1,3,7,6,1,4,12,12,0,Matches
Santiago Giménez,mx MEX,FW,nl Feyenoord,22,2001,3.9,0,0,0,0,0,0,2,0.0,2,2,0,2,1,1,4,0,Matches
Olivier Giroud,fr FRA,FW,it Milan,36,1986,5.7,3,1,3,0,0,1,8,12.5,7,3,0,3,0,3,10,1,Matches
Jamie Gittens,eng ENG,FW,de Dortmund,18,2004,2.3,2,1,1,0,1,1,3,33.3,2,2,0,2,1,3,2,0,Matches
Omri Glazer,il ISR,GK,rs Red Star,27,1996,6.0,0,0,0,0,0,0,1,0.0,1,0,0,0,0,0,3,3,Matches

Oscar Gloukh,il ISR,"MF,FW",at RB Salzburg,19,2004,5.3,6,3,1,4,1,2,14,14.3,12,2,0,2,2,8,0,0,Matches
Serge Gnabry,de GER,FW,de Bayern Munich,28,1995,2.2,4,1,2,0,2,2,4,50.0,2,7,0,7,0,4,3,0,Matches
Giorgi Gocholeishvili,ge GEO,DF,ua Shakhtar,22,2001,3.2,12,6,6,3,3,5,9,55.6,4,2,0,2,1,13,6,0,Matches
Sergio Gómez,es ESP,"DF,FW",eng Manchester City,22,2000,2.2,3,2,1,1,1,1,2,50.0,1,1,0,1,1,4,2,0,Matches
Victor Gomez,es ESP,DF,pt Braga,23,2000,3.5,10,6,6,4,0,10,15,66.7,5,3,1,2,3,13,9,0,Matches
Diogo Gonçalves,pt POR,MF,dk FC Copenhagen,26,1997,5.9,9,7,4,4,1,5,11,45.5,6,4,0,4,6,15,6,0,Matches
Nicolás González,es ESP,MF,pt Porto,21,2002,2.5,4,4,4,0,0,1,5,20.0,4,1,0,1,2,6,4,0,Matches
Anthony Gordon,eng ENG,FW,eng Newcastle Utd,22,2001,4.9,10,8,5,2,3,6,13,46.2,7,8,0,8,2,12,2,0,Matches
Leon Goretzka,de GER,"MF,DF",de Bayern Munich,28,1995,8.5,13,9,6,5,2,8,18,44.4,10,15,6,9,19,32,20,0,Matches
Robin Gosens,de GER,"DF,MF",de Union Berlin,29,1994,4.9,6,3,3,3,0,1,5,20.0,4,5,1,4,3,9,12,0,Matches
Lucas Gourna-Douath,fr FRA,MF,at RB Salzburg,19,2003,4.4,10,8,4,4,2,4,12,33.3,8,7,3,4,12,22,6,0,Matches
Tiago Gouveia,pt POR,FW,pt Benfica,22,2001,0.3,0,0,0,0,0,0,1,0.0,1,0,0,0,0,0,0,0,Matches
Kamil Grabara,pl POL,GK,dk FC Copenhagen,24,1999,8.0,0,0,0,0,0,0,0,,0,0,0,0,0,0,0,1,Matches
Jonathan Gradit,fr FRA,DF,fr Lens,30,1992,5.7,18,12,10,7,1,10,14,71.4,4,8,5,3,8,26,16,0,Matches
Jack Grealish,eng ENG,"FW,MF",eng Manchester City,27,1995,5.9,3,2,0,2,1,1,7,14.3,6,5,0,5,2,5,1,0,Matches
Antoine Griezmann,fr FRA,"FW,MF",es Atlético Madrid,32,1991,9.1,12,9,5,6,1,2,13,15.4,11,9,1,8,6,18,11,0,Matches
Marko Grujić,rs SRB,MF,pt Porto,27,1996,0.6,2,1,1,0,1,1,1,100.0,0,1,0,1,0,2,1,0,Matches
Nemanja Gudelj,rs SRB,DF,es Sevilla,31,1991,6.0,12,7,7,5,0,7,13,53.8,6,4,2,2,4,16,17,0,Matches
Gonçalo Guedes,pt POR,FW,pt Benfica,26,1996,0.3,0,0,0,0,0,0,1,0.0,1,1,0,1,0,0,0,0,Matches
Mattéo Guendouzi,fr FRA,MF,it Lazio,24,1999,5.5,6,6,1,3,2,2,5,40.0,3,3,1,2,5,11,6,0,Matches
Raphaël Guerreiro,pt POR,"DF,FW",de Bayern Munich,29,1993,4.3,5,2,2,3,0,1,5,20.0,4,3,0,3,4,9,4,0,Matches
Morgan Guilavogui,gn GUI,"FW,MF",fr Lens,25,1998,0.8,0,0,0,0,0,0,1,0.0,1,4,2,2,0,0,1,0,Matches
Bruno Guimarães,br BRA,MF,eng Newcastle Utd,25,1997,6.0,13,11,9,2,2,6,14,42.9,8,10,4,6,6,19,8,0,Matches
Marc Guiu,es ESP,FW,es Barcelona,17,2006,0.4,1,0,0,1,0,1,1,100.0,0,1,0,1,0,1,3,0,Matches
Péter Gulácsi,hu HUN,GK,de RB Leipzig,33,1990,3.0,0,0,0,0,0,0,0,,0,0,0,0,0,0,1,0,Matches

İlkay Gündoğan,de GER,MF,es Barcelona,32,1990,9.3,5,5,1,1,3,4,11,36.4,7,13,3,10,6,11,3,1,Matches
Joško Gvardiol,hr CRO,DF,eng Manchester City,21,2002,6.3,7,6,4,2,1,2,5,40.0,3,5,1,4,8,15,10,1,Matches
Erling Haaland,no NOR,FW,eng Manchester City,23,2000,8.6,5,2,0,4,1,2,3,66.7,1,1,0,1,0,5,3,0,Matches
Janik Haberer,de GER,MF,de Union Berlin,29,1994,4.0,5,2,1,4,0,3,11,27.3,8,4,1,3,1,6,5,0,Matches
Amadou Haidara,ml MLI,"MF,DF",de RB Leipzig,25,1998,3.0,7,3,7,0,0,7,12,58.3,5,6,1,5,2,9,4,0,Matches
Massadio Haïdara,ml MLI,DF,fr Lens,30,1992,1.3,2,2,2,0,0,1,2,50.0,1,3,2,1,2,4,3,0,Matches
Achraf Hakimi,ma MAR,DF,fr Paris S-G,24,1998,10.9,20,14,8,7,5,13,25,52.0,12,10,0,10,12,32,16,2,Matches
Lewis Hall,eng ENG,DF,eng Newcastle Utd,18,2004,0.5,1,1,1,0,0,1,1,100.0,0,0,0,0,0,1,3,0,Matches
Sébastien Haller,ci CIV,"FW,MF",de Dortmund,29,1994,0.7,0,0,0,0,0,0,0,,0,2,1,1,1,1,1,0,Matches
Micah Hamilton,eng ENG,FW,eng Manchester City,19,2003,1.2,1,1,0,0,1,1,2,50.0,1,1,0,1,1,2,0,0,Matches
Dávid Hancko,sk SVK,DF,nl Feyenoord,25,1997,6.0,3,2,2,1,0,3,3,100.0,0,4,3,1,5,8,11,0,Matches
Joe Hart,eng ENG,GK,sct Celtic,36,1987,6.0,0,0,0,0,0,0,0,,0,0,0,0,0,0,5,0,Matches
Quilindschy Hartman,nl NED,DF,nl Feyenoord,21,2001,6.0,15,14,6,5,4,5,9,55.6,4,14,4,10,7,22,10,0,Matches
Reo Hatate,jp JPN,MF,sct Celtic,25,1997,1.5,0,0,0,0,0,0,2,0.0,2,1,0,1,0,0,1,0,Matches
Kai Havertz,de GER,"MF,FW",eng Arsenal,24,1999,9.2,16,5,0,12,4,8,15,53.3,7,10,0,10,3,19,6,0,Matches
Benjamin Henrichs,de GER,"DF,MF",de RB Leipzig,26,1997,5.5,22,14,13,6,3,10,18,55.6,8,10,2,8,3,25,11,0,Matches
Mario Hermoso,es ESP,DF,es Atlético Madrid,28,1995,9.1,7,6,4,2,1,3,12,25.0,9,9,3,6,6,13,25,1,Matches
Lucas Hernández,fr FRA,DF,fr Paris S-G,27,1996,9.3,15,10,7,7,1,11,15,73.3,4,6,0,6,3,18,20,1,Matches
Theo Hernández,fr FRA,DF,it Milan,25,1997,6.0,7,5,5,2,0,4,5,80.0,1,4,2,2,5,12,16,0,Matches
André Horta,pt POR,MF,pt Braga,26,1996,0.4,3,3,1,0,2,3,6,50.0,3,0,0,0,0,3,0,0,Matches
Ricardo Horta,pt POR,"FW,MF",pt Braga,28,1994,5.6,7,4,2,3,2,2,9,22.2,7,2,0,2,3,10,2,0,Matches
Mats Hummels,de GER,DF,de Dortmund,34,1988,13.0,53,29,43,10,0,34,48,70.8,14,20,8,12,25,78,69,2,Matches
Oh Hyeon-gyu,kr KOR,"FW,MF",sct Celtic,22,2001,1.2,1,0,0,0,1,0,2,0.0,2,0,0,0,0,1,1,0,Matches
Elseid Hysaj,al ALB,DF,it Lazio,29,1994,3.8,8,3,4,4,0,2,5,40.0,3,3,0,3,2,10,6,0,Matches
Yang Hyunjun,kr KOR,FW,sct Celtic,21,2002,2.3,4,3,2,0,2,2,6,33.3,4,4,1,3,3,7,1,0,Matches

Oscar Højlund,dk DEN,MF,dk FC Copenhagen,18,2005,0.5,3,2,1,2,0,2,2,100.0,0,1,0,1,0,3,1,0,Matches
Rasmus Højlund,dk DEN,FW,eng Manchester Utd,20,2003,5.4,0,0,0,0,0,0,0,,0,3,0,3,1,1,0,0,Matches
Mauro Icardi,ar ARG,FW,tr Galatasaray,30,1993,5.8,2,2,1,1,0,1,1,100.0,0,0,0,0,0,2,3,0,Matches
George Ilenikhena,fr FRA,FW,be Antwerp,16,2006,1.7,1,0,1,0,0,1,1,100.0,0,0,0,0,0,1,1,0,Matches
Ciro Immobile,it ITA,FW,it Lazio,33,1990,5.6,2,1,0,2,0,1,4,25.0,3,5,1,4,1,3,6,0,Matches
Hwang In-beom,kr KOR,MF,rs Red Star,26,1996,5.9,19,10,8,7,4,6,14,42.9,8,5,1,4,5,24,4,0,Matches
Alexander Isak,se SWE,FW,eng Newcastle Utd,23,1999,3.5,1,0,0,1,0,1,1,100.0,0,3,2,1,0,1,2,0,Matches
Gustav Isaksen,dk DEN,FW,it Lazio,22,2001,2.7,0,0,0,0,0,0,4,0.0,4,1,0,1,2,2,1,0,Matches
Cedric Itten,ch SUI,FW,ch Young Boys,26,1996,3.1,2,2,1,1,0,1,2,50.0,1,3,0,3,0,2,3,0,Matches
Mirko Ivanić,me MNE,MF,rs Red Star,29,1993,4.1,7,2,3,3,1,5,11,45.5,6,9,2,7,7,14,8,0,Matches
Luka Ivanušec,hr CRO,"FW,MF",nl Feyenoord,24,1998,2.3,3,2,1,1,1,2,6,33.3,4,2,0,2,1,4,1,0,Matches
Tomoki Iwata,jp JPN,"MF,FW",sct Celtic,26,1997,0.7,3,3,1,2,0,3,4,75.0,1,0,0,0,0,3,2,0,Matches
Paul Jaeckel,de GER,DF,de Union Berlin,25,1998,1.9,2,1,2,0,0,2,3,66.7,1,5,5,0,4,6,7,0,Matches
Alireza Jahanbakhsh,ir IRN,"FW,DF",nl Feyenoord,29,1993,0.8,6,1,0,4,2,2,2,100.0,0,0,0,0,1,7,0,0,Matches
Ivan Jaime Pajuelo,es ESP,MF,pt Porto,22,2000,1.0,6,3,0,4,2,2,2,100.0,0,0,0,0,0,6,1,0,Matches
Saidy Janko,gm GAM,DF,ch Young Boys,27,1995,3.6,4,2,2,1,1,3,7,42.9,4,8,2,6,1,5,7,0,Matches
Vincent Janssen,nl NED,FW,be Antwerp,29,1994,4.5,4,3,0,2,2,3,8,37.5,5,4,0,4,0,4,7,0,Matches
Elias Jelert,dk DEN,DF,dk FC Copenhagen,20,2003,6.5,11,8,9,0,2,7,12,58.3,5,11,4,7,4,15,19,0,Matches
Gabriel Jesus,br BRA,FW,eng Arsenal,26,1997,4.5,8,4,1,6,1,1,5,20.0,4,7,0,7,1,9,3,0,Matches
Juan Jesus,br BRA,DF,it Napoli,32,1991,4.8,11,4,3,7,1,4,6,66.7,2,6,3,3,4,15,17,0,Matches
Joelinton,br BRA,"MF,FW",eng Newcastle Utd,26,1996,3.7,5,3,3,2,0,1,6,16.7,5,6,2,4,4,9,7,0,Matches
Alistair Johnston,ca CAN,DF,sct Celtic,24,1998,6.0,15,7,11,4,0,9,13,69.2,4,9,4,5,4,19,13,0,Matches
Michael Johnston,ie IRL,FW,sct Celtic,24,1999,1.1,3,3,0,1,2,1,2,50.0,1,4,1,3,1,4,2,0,Matches
Frenkie de Jong,nl NED,MF,es Barcelona,26,1997,4.4,9,3,1,6,2,3,6,50.0,3,2,1,1,3,12,5,0,Matches
Luuk de Jong,nl NED,FW,nl PSV Eindhoven,32,1990,7.0,5,5,1,3,1,2,2,100.0,0,7,2,5,1,6,4,0,Matches

Joan Jordán,es ESP,MF,es Sevilla,29,1994,0.9,5,2,3,2,0,3,4,75.0,1,0,0,0,0,5,0,0,Matches
Jorginho,it ITA,MF,eng Arsenal,31,1991,5.9,16,8,4,8,4,5,9,55.6,4,6,2,4,9,25,4,0,Matches
Joselu,es ESP,FW,es Real Madrid,33,1990,3.1,1,0,1,0,0,0,0,,0,0,0,0,0,1,4,0,Matches
Luka Jović,rs SRB,"FW,MF",it Milan,25,1997,0.4,0,0,0,0,0,0,0,,0,1,0,1,0,0,0,0,Matches
Mauro Júnior,br BRA,"MF,DF",nl PSV Eindhoven,24,1999,2.0,2,1,1,1,0,1,3,33.3,2,2,0,2,4,6,2,0,Matches
Hamed Junior Traorè,ci CIV,MF,it Napoli,23,2000,1.1,0,0,0,0,0,0,0,,0,3,0,3,2,2,0,0,Matches
Vinicius Júnior,br BRA,FW,es Real Madrid,23,2000,10.0,8,5,5,3,0,1,3,33.3,2,7,1,6,1,9,1,0,Matches
Josip Juranović,hr CRO,DF,de Union Berlin,27,1995,4.6,6,1,5,1,0,4,8,50.0,4,7,3,4,2,8,11,1,Matches
David Jurásek,cz CZE,"MF,DF",pt Benfica,22,2000,1.4,6,2,3,1,2,4,11,36.4,7,2,0,2,1,7,4,0,Matches
Uroš Kabić,rs SRB,DF,rs Red Star,19,2004,0.1,1,0,1,0,0,1,1,100.0,0,0,0,0,0,1,0,0,Matches
Pierre Kalulu,fr FRA,DF,it Milan,23,2000,1.0,0,0,0,0,0,0,1,0.0,1,1,0,1,2,2,2,0,Matches
Daichi Kamada,jp JPN,MF,it Lazio,26,1996,2.9,7,3,1,4,2,4,5,80.0,1,4,1,3,1,8,2,0,Matches
Dijon Kameri,at AUT,MF,at RB Salzburg,19,2004,0.1,0,0,0,0,0,0,0,,0,1,0,1,0,0,1,0,Matches
Kevin Kampl,si SVN,MF,de RB Leipzig,32,1990,3.1,8,7,2,6,0,4,6,66.7,2,4,1,3,4,12,6,0,Matches
Harry Kane,eng ENG,FW,de Bayern Munich,30,1993,11.8,9,7,3,5,1,3,4,75.0,1,9,2,7,1,10,7,0,Matches
Lee Kang-in,kr KOR,"MF,FW",fr Paris S-G,22,2001,3.8,7,4,2,3,2,5,11,45.5,6,5,0,5,2,9,2,0,Matches
Guélor Kanga,ga GAB,MF,rs Red Star,32,1990,1.6,4,2,1,3,0,2,8,25.0,6,1,0,1,0,4,0,0,Matches
Kings Kangwa,zm ZAM,MF,rs Red Star,24,1999,0.1,1,0,0,1,0,1,2,50.0,1,0,0,0,0,1,0,0,Matches
Kazımcan Karataş,tr TUR,DF,tr Galatasaray,20,2003,0.8,4,4,2,1,1,2,3,66.7,1,0,0,0,1,5,2,1,Matches
Oleksii Kashchuk,ua UKR,FW,ua Shakhtar,23,2000,0.3,0,0,0,0,0,0,0,,0,1,0,1,0,0,0,0,Matches
Aleksandar Katai,rs SRB,"MF,FW",rs Red Star,32,1991,0.9,2,1,1,1,0,1,1,100.0,0,0,0,0,0,2,1,0,Matches
Mandela Keita,be BEL,MF,be Antwerp,21,2002,2.9,8,7,6,2,0,5,8,62.5,3,2,0,2,2,10,4,0,Matches
Kevin Kelsy,ve VEN,FW,ua Shakhtar,19,2004,1.5,2,0,1,1,0,1,3,33.3,2,1,0,1,0,2,1,0,Matches
Aljoscha Kemlein,de GER,MF,de Union Berlin,18,2004,0.1,0,0,0,0,0,0,0,,0,1,1,0,0,0,1,0,Matches
Gyrano Kerk,sr SUR,FW,be Antwerp,27,1995,2.3,3,3,0,3,0,1,6,16.7,5,3,0,3,0,3,1,0,Matches

Rani Khedira,de GER,MF,de Union Berlin,29,1994,3.2,6,4,2,3,1,1,5,20.0,4,5,1,4,2,8,3,0,Matches
Abdukodir Khusanov,uz UZB,DF,fr Lens,19,2004,0.3,2,1,2,0,0,2,3,66.7,1,1,0,1,0,2,0,0,Matches
Joshua Kimmich,de GER,"MF,DF",de Bayern Munich,28,1995,12.0,23,16,12,10,1,15,39,38.5,24,9,0,9,11,34,16,1,Matches
Jakub Kiwior,pl POL,DF,eng Arsenal,23,2000,4.2,8,4,3,4,1,4,13,30.8,9,1,1,0,2,10,4,0,Matches
Simon Kjær,dk DEN,DF,it Milan,34,1989,0.0,0,0,0,0,0,0,0,,0,0,0,0,0,0,0,0,Matches
Maurits Kjærgaard,dk DEN,"MF,FW",at RB Salzburg,20,2003,2.3,2,1,0,1,1,1,4,25.0,3,4,1,3,1,3,2,0,Matches
Davy Klaassen,nl NED,"MF,FW",it Inter,30,1993,0.9,1,1,0,0,1,0,2,0.0,2,0,0,0,0,1,0,0,Matches
Lukas Klostermann,de GER,DF,de RB Leipzig,27,1996,4.0,6,3,4,2,0,5,8,62.5,3,4,2,2,4,10,23,0,Matches
Robin Knoche,de GER,DF,de Union Berlin,31,1992,3.0,6,2,5,1,0,3,8,37.5,5,4,4,0,3,9,10,1,Matches
Gregor Kobel,ch SUI,GK,de Dortmund,25,1997,12.0,0,0,0,0,0,0,1,0.0,1,0,0,0,0,0,9,0,Matches
Sekou Koita,ml MLI,FW,at RB Salzburg,23,1999,0.8,2,2,0,1,1,1,1,100.0,0,2,0,2,0,2,3,0,Matches
Orkun Kökçü,tr TUR,MF,pt Benfica,22,2000,2.9,6,2,3,2,1,3,9,33.3,6,3,1,2,0,6,2,0,Matches
Koke,es ESP,MF,es Atlético Madrid,31,1992,8.6,15,11,6,4,5,10,18,55.6,8,6,2,4,3,18,12,0,Matches
Randal Kolo Muani,fr FRA,"FW,MF",fr Paris S-G,24,1998,5.2,7,3,4,2,1,0,1,0.0,1,5,1,4,1,8,4,0,Matches
Karim Konaté,ci CIV,"FW,MF",at RB Salzburg,19,2004,2.6,2,2,1,1,0,1,3,33.3,2,1,0,1,3,5,4,0,Matches
Yukhym Konoplia,ua UKR,DF,ua Shakhtar,23,1999,2.8,8,5,4,4,0,6,8,75.0,2,3,0,3,6,14,3,0,Matches
Ilias Kostis,gr GRE,FW,es Atlético Madrid,20,2003,0.0,0,0,0,0,0,0,0,,0,0,0,0,0,0,0,0,Matches
Jules Koundé,fr FRA,DF,es Barcelona,24,1998,8.0,11,7,6,2,3,4,9,44.4,5,12,6,6,10,21,32,0,Matches
Mateo Kovačić,hr CRO,MF,eng Manchester City,29,1994,4.8,7,2,2,5,0,2,8,25.0,6,3,1,2,5,12,3,0,Matches
Alex Král,cz CZE,MF,de Union Berlin,25,1998,2.8,7,4,4,2,1,3,6,50.0,3,3,1,2,2,9,2,0,Matches
Jean-Philippe Krasso,ci CIV,"FW,MF",rs Red Star,26,1997,1.2,3,2,0,2,1,0,1,0.0,1,1,0,1,1,4,0,0,Matches
Frans Krätzig,de GER,DF,de Bayern Munich,20,2003,0.1,0,0,0,0,0,0,0,,0,1,1,0,0,0,1,0,Matches
Toni Kroos,de GER,MF,es Real Madrid,33,1990,9.5,21,12,10,9,2,10,24,41.7,14,4,0,4,12,33,9,0,Matches
Rade Krunić,ba BIH,"MF,DF",it Milan,29,1993,2.3,4,2,3,0,1,1,5,20.0,4,0,0,0,3,7,4,0,Matches
Dmytro Kryskiv,ua UKR,"MF,FW",ua Shakhtar,22,2000,4.3,7,3,4,3,0,1,10,10.0,9,6,0,6,1,8,3,0,Matches

Takefusa Kubo,jp JPN,"FW,MF",es Real Sociedad,22,2001,6.2,4,3,0,3,1,0,7,0.0,7,4,1,3,2,6,4,0,Matches
Khvicha Kvaratskhelia,ge GEO,FW,it Napoli,22,2001,7.4,8,5,1,4,3,3,7,42.9,4,8,0,8,4,12,2,0,Matches
Gustaf Lagerbielke,se SWE,DF,sct Celtic,23,2000,0.9,2,0,2,0,0,1,1,100.0,0,3,2,1,2,4,1,0,Matches
Aïssa Laïdouni,tn TUN,MF,de Union Berlin,26,1996,3.1,5,5,1,2,2,0,3,0.0,3,3,1,2,1,6,5,0,Matches
Konrad Laimer,at AUT,"MF,DF",de Bayern Munich,26,1997,8.6,32,22,19,8,5,14,34,41.2,20,14,3,11,8,40,13,0,Matches
Érik Lamela,ar ARG,"FW,MF",es Sevilla,31,1992,2.1,7,3,3,2,2,3,4,75.0,1,4,0,4,2,9,0,0,Matches
Senne Lammens,be BEL,GK,be Antwerp,21,2002,1.0,0,0,0,0,0,0,0,,0,0,0,0,0,0,0,1,Matches
Noa Lang,nl NED,FW,nl PSV Eindhoven,24,1999,1.8,2,0,0,1,1,0,3,0.0,3,1,0,1,1,3,0,0,Matches
Jordan Larsson,se SWE,"FW,MF",dk FC Copenhagen,26,1997,1.2,0,0,0,0,0,0,3,0.0,3,0,0,0,1,1,0,0,Matches
Jamaal Lascelles,eng ENG,DF,eng Newcastle Utd,29,1993,5.0,5,5,3,1,1,3,3,100.0,0,6,3,3,0,5,16,0,Matches
Sandro Lauper,ch SUI,MF,ch Young Boys,26,1996,3.1,4,2,0,1,3,1,9,11.1,8,7,2,5,2,6,1,0,Matches
Manuel Lazzari,it ITA,DF,it Lazio,29,1993,4.7,10,7,3,7,0,6,15,40.0,9,13,3,10,5,15,6,0,Matches
Robin Le Normand,es ESP,DF,es Real Sociedad,26,1996,6.4,8,5,6,1,1,4,9,44.4,5,2,1,1,11,19,16,0,Matches
Rafael Leão,pt POR,FW,it Milan,24,1999,4.9,8,1,5,1,2,2,5,40.0,3,2,0,2,2,10,1,0,Matches
Diogo Leite,pt POR,DF,de Union Berlin,24,1999,6.0,11,5,9,2,0,7,16,43.8,9,15,9,6,5,16,30,0,Matches
Stav Lemkin,il ISR,DF,ua Shakhtar,20,2003,0.7,1,0,1,0,0,0,1,0.0,1,0,0,0,0,1,1,0,Matches
Christopher Lenz,de GER,DF,de RB Leipzig,28,1994,1.0,6,6,5,1,0,4,8,50.0,4,4,0,4,0,6,1,0,Matches
Lukas Lerager,dk DEN,MF,dk FC Copenhagen,30,1993,6.0,17,8,9,6,2,10,18,55.6,8,9,1,8,8,25,13,0,Matches
Robert Lewandowski,pl POL,FW,es Barcelona,34,1988,8.2,7,5,0,4,3,5,7,71.4,2,7,1,6,0,7,8,0,Matches
Rico Lewis,eng ENG,"MF,DF",eng Manchester City,18,2004,6.1,8,5,4,1,3,3,5,60.0,2,8,2,6,3,11,4,0,Matches
Matthijs de Ligt,nl NED,DF,de Bayern Munich,23,1999,5.2,8,6,5,3,0,6,8,75.0,2,7,5,2,3,11,24,0,Matches
Victor Lindelöf,se SWE,DF,eng Manchester Utd,29,1994,3.3,0,0,0,0,0,0,1,0.0,1,6,2,4,1,1,11,0,Matches
Jesper Lindstrøm,dk DEN,FW,it Napoli,23,2000,0.7,6,3,1,3,2,3,4,75.0,1,1,0,1,0,6,0,0,Matches
Ondřej Lingr,cz CZE,"FW,MF",nl Feyenoord,24,1998,0.8,0,0,0,0,0,0,3,0.0,3,0,0,0,0,0,1,0,Matches
Samuel Lino,br BRA,DF,es Atlético Madrid,23,1999,5.6,12,10,8,2,2,7,18,38.9,11,14,0,14,2,14,4,0,Matches

Valentino Livramento,eng ENG,"DF,FW",eng Newcastle Utd,20,2002,3.0,9,6,3,5,1,4,5,80.0,1,5,1,4,1,10,9,1,Matches
Marcos Llorente,es ESP,"MF,DF",es Atlético Madrid,28,1995,7.2,10,9,7,2,1,6,12,50.0,6,10,2,8,3,13,8,0,Matches
Danny Loader,eng ENG,"MF,FW",pt Porto,22,2000,0.2,0,0,0,0,0,0,0,,0,0,0,0,0,0,0,0,Matches
Stanislav Lobotka,sk SVK,MF,it Napoli,28,1994,7.5,11,5,6,5,0,6,15,40.0,9,7,2,5,10,21,7,1,Matches
Ruben Loftus-Cheek,eng ENG,MF,it Milan,27,1996,3.6,3,3,1,1,1,1,2,50.0,1,1,0,1,0,3,2,0,Matches
Sean Longstaff,eng ENG,MF,eng Newcastle Utd,25,1997,3.9,7,3,3,4,0,2,5,40.0,3,7,1,6,2,9,2,0,Matches
Rony Lopes,pt POR,FW,pt Braga,27,1995,0.0,0,0,0,0,0,0,0,,0,1,0,1,0,0,0,0,Matches
Fermin López,es ESP,MF,es Barcelona,20,2003,3.1,10,7,2,8,0,4,11,36.4,7,3,0,3,2,12,0,0,Matches
Marcos López,pe PER,DF,nl Feyenoord,23,1999,0.5,0,0,0,0,0,0,0,,0,0,0,0,1,1,1,0,Matches
Hirving Lozano,mx MEX,FW,nl PSV Eindhoven,28,1995,4.2,5,4,2,3,0,2,8,25.0,6,5,0,5,2,7,4,0,Matches
Vladimir Lučić,rs SRB,"DF,FW",rs Red Star,21,2002,2.3,2,2,1,0,1,1,5,20.0,4,3,0,3,1,3,1,0,Matches
Florentino Luís,pt POR,MF,pt Benfica,23,1999,1.2,3,2,0,2,1,1,3,33.3,2,1,0,1,3,6,1,1,Matches
Castello Lukeba,fr FRA,DF,de RB Leipzig,20,2002,6.9,7,3,6,1,0,6,10,60.0,4,7,3,4,16,23,16,2,Matches
Dodi Lukebakio,be BEL,FW,es Sevilla,25,1997,2.7,2,2,0,2,0,1,4,25.0,3,1,0,1,1,3,0,0,Matches
Valdemar Lund,dk DEN,DF,dk FC Copenhagen,20,2003,0.3,0,0,0,0,0,0,0,,0,1,0,1,0,0,0,0,Matches
Andriy Lunin,ua UKR,GK,es Real Madrid,24,1999,8.3,0,0,0,0,0,0,1,0.0,1,0,0,0,0,0,6,1,Matches
Fabian Lustenberger,ch SUI,DF,ch Young Boys,35,1988,1.0,2,1,1,1,0,1,1,100.0,0,2,1,1,3,5,2,0,Matches
Ian Maatsen,nl NED,DF,de Dortmund,21,2002,7.0,15,11,8,7,0,8,17,47.1,9,12,2,10,12,27,31,2,Matches
Deiver Machado,co COL,DF,fr Lens,29,1993,4.1,10,7,5,5,0,5,6,83.3,1,5,0,5,2,12,10,0,Matches
Daizen Maeda,jp JPN,FW,sct Celtic,25,1997,3.1,2,1,0,2,0,2,7,28.6,5,2,0,2,3,5,3,0,Matches
Gabriel Magalhães,br BRA,DF,eng Arsenal,25,1997,10.3,9,7,3,5,1,3,4,75.0,1,8,6,2,3,12,35,0,Matches
Harry Maguire,eng ENG,DF,eng Manchester Utd,30,1993,3.4,1,1,1,0,0,1,1,100.0,0,6,3,3,4,5,13,0,Matches
Jon Magunacelaya,es ESP,MF,es Real Sociedad,23,2000,0.2,0,0,0,0,0,0,0,,0,0,0,0,0,0,1,0,Matches
Mike Maignan,fr FRA,GK,it Milan,28,1995,5.9,0,0,0,0,0,0,0,,0,0,0,0,0,0,4,0,Matches
Kobbie Mainoo,eng ENG,MF,eng Manchester Utd,18,2005,0.5,2,1,1,1,0,0,0,,0,1,1,0,0,2,2,0,Matches

Donyell Malen,nl NED,FW,de Dortmund,24,1999,5.1,3,1,0,3,0,0,0,,0,4,0,4,0,3,5,0,Matches
Darian Males,ch SUI,MF,ch Young Boys,22,2001,1.9,3,2,1,2,0,1,1,100.0,0,3,0,3,1,4,1,0,Matches
Reinildo Mandava,mz MOZ,DF,es Atlético Madrid,29,1994,0.3,1,0,1,0,0,0,0,,0,2,2,0,2,3,2,1,Matches
José María Giménez,uy URU,DF,es Atlético Madrid,28,1995,5.3,1,1,1,0,0,0,3,0.0,3,8,6,2,5,6,34,0,Matches
Mariano,do DOM,"MF,FW",es Sevilla,29,1993,0.7,1,1,0,1,0,0,0,,0,1,0,1,0,1,0,0,Matches
Adrián Marín,es ESP,DF,pt Braga,26,1997,0.3,0,0,0,0,0,0,1,0.0,1,1,0,1,0,0,1,0,Matches
João Mário,pt POR,"FW,MF",pt Benfica,30,1993,3.6,2,1,1,0,1,2,8,25.0,6,2,0,2,2,4,3,0,Matches
João Mário Lopes,pt POR,DF,pt Porto,23,2000,6.6,21,15,14,6,1,14,26,53.8,12,8,0,8,2,23,11,0,Matches
Marquinhos,br BRA,DF,fr Paris S-G,29,1994,10.0,17,7,14,2,1,11,17,64.7,6,12,9,3,12,29,29,1,Matches
Anthony Martial,fr FRA,"FW,DF",eng Manchester Utd,27,1995,0.6,0,0,0,0,0,0,0,,0,0,0,0,1,1,1,0,Matches
Gabriel Martinelli,br BRA,FW,eng Arsenal,22,2001,5.3,4,2,2,0,2,3,4,75.0,1,8,0,8,2,6,1,0,Matches
Iñigo Martínez,es ESP,DF,es Barcelona,32,1991,3.5,2,1,1,0,1,2,4,50.0,2,3,2,1,3,5,13,0,Matches
Lautaro Martínez,ar ARG,FW,it Inter,25,1997,5.9,5,1,1,3,1,1,5,20.0,4,6,0,6,1,6,3,0,Matches
Lisandro Martínez,ar ARG,DF,eng Manchester Utd,25,1998,1.0,0,0,0,0,0,0,0,,0,4,2,2,2,2,1,1,Matches
Toni Martínez,es ESP,FW,pt Porto,26,1997,0.1,0,0,0,0,0,0,0,,0,0,0,0,0,0,2,0,Matches
Adam Marušić,me MNE,DF,it Lazio,30,1992,5.7,9,8,2,7,0,5,7,71.4,2,6,5,1,8,17,10,0,Matches
Matheus,br BRA,GK,pt Braga,31,1992,6.0,0,0,0,0,0,0,0,,0,0,0,0,0,0,1,0,Matches
Magnus Mattsson,dk DEN,MF,dk FC Copenhagen,24,1999,1.3,6,4,1,3,2,3,4,75.0,1,1,0,1,0,6,2,0,Matches
Mykola Matviyenko,ua UKR,DF,ua Shakhtar,27,1996,5.0,11,5,7,3,1,6,15,40.0,9,10,5,5,2,13,29,2,Matches
Eric Maxim Choupo-Moting,cm CMR,"FW,MF",de Bayern Munich,34,1989,0.5,1,1,0,1,0,0,0,,0,0,0,0,0,1,2,0,Matches
Noussair Mazraoui,ma MAR,DF,de Bayern Munich,25,1997,7.2,17,11,8,7,2,8,15,53.3,7,8,3,5,7,24,8,0,Matches
Kylian Mbappé,fr FRA,FW,fr Paris S-G,24,1998,12.0,2,1,1,0,1,2,4,50.0,2,3,0,3,4,6,0,0,Matches
Callum McGregor,sct SCO,MF,sct Celtic,30,1993,5.8,4,4,1,2,1,2,7,28.6,5,12,6,6,6,10,17,0,Matches
Scott McKenna,sct SCO,DF,dk FC Copenhagen,26,1996,2.0,2,2,1,0,1,1,1,100.0,0,6,6,0,2,4,6,0,Matches
Scott McTominay,sct SCO,MF,eng Manchester Utd,26,1996,4.2,2,1,1,1,0,1,7,14.3,6,5,3,2,1,3,6,0,Matches

Facundo Medina,ar ARG,DF,fr Lens,24,1999,5.5,9,6,5,4,0,6,7,85.7,1,10,0,10,5,14,13,0,Matches
Hannibal Mejbri,tn TUN,"MF,FW",eng Manchester Utd,20,2003,0.7,2,1,1,1,0,1,2,50.0,1,0,0,0,0,2,0,0,Matches
Birger Meling,no NOR,DF,dk FC Copenhagen,28,1994,2.1,7,5,4,2,1,3,6,50.0,3,2,0,2,0,7,5,0,Matches
Memphis,nl NED,FW,es Atlético Madrid,29,1994,1.2,0,0,0,0,0,0,1,0.0,1,1,1,0,1,1,0,0,Matches
Joe Mendes,se SWE,DF,pt Braga,20,2002,2.3,3,1,2,0,1,2,3,66.7,1,3,1,2,2,5,4,0,Matches
Nuno Mendes,pt POR,DF,fr Paris S-G,21,2002,4.7,11,8,6,4,1,6,18,33.3,12,8,2,6,9,20,11,0,Matches
Brais Méndez,es ESP,MF,es Real Sociedad,26,1997,5.8,13,8,0,8,5,6,10,60.0,4,7,1,6,3,16,8,0,Matches
Ferland Mendy,fr FRA,DF,es Real Madrid,28,1995,9.7,14,9,10,3,1,10,14,71.4,4,10,1,9,6,20,16,0,Matches
Nampalys Mendy,sn SEN,MF,fr Lens,31,1992,4.1,8,4,4,2,2,4,8,50.0,4,0,0,0,7,15,7,0,Matches
Alex Meret,it ITA,GK,it Napoli,26,1997,8.0,0,0,0,0,0,0,0,,0,0,0,0,0,0,4,0,Matches
Mikel Merino,es ESP,MF,es Real Sociedad,27,1996,7.0,15,8,8,4,3,6,13,46.2,7,8,1,7,4,19,15,0,Matches
Dries Mertens,be BEL,MF,tr Galatasaray,36,1987,2.2,0,0,0,0,0,0,1,0.0,1,6,0,6,2,2,2,0,Matches
Alexander Meyer,de GER,GK,de Dortmund,32,1991,1.0,0,0,0,0,0,0,0,,0,0,0,0,0,0,0,0,Matches
Srđan Mijailović,rs SRB,"DF,MF",rs Red Star,29,1993,5.4,14,5,3,9,2,7,17,41.2,10,14,9,5,6,20,9,0,Matches
Jovan Mijatović,rs SRB,"FW,MF",rs Red Star,18,2005,1.3,0,0,0,0,0,0,1,0.0,1,1,0,1,0,0,0,0,Matches
Antoni Milambo,nl NED,"DF,MF",nl Feyenoord,18,2005,0.4,0,0,0,0,0,0,0,,0,0,0,0,1,1,0,0,Matches
Lewis Miley,eng ENG,MF,eng Newcastle Utd,17,2006,1.9,3,1,1,2,0,2,8,25.0,6,5,3,2,2,5,8,0,Matches
Éder Militão,br BRA,DF,es Real Madrid,25,1998,0.1,1,1,1,0,0,0,0,,0,0,0,0,0,1,4,0,Matches
Kim Min-jae,kr KOR,DF,de Bayern Munich,26,1996,7.3,10,5,7,3,0,2,6,33.3,4,13,8,5,17,27,24,0,Matches
Yankuba Minteh,gm GAM,FW,nl Feyenoord,19,2004,2.2,9,8,3,4,2,6,10,60.0,4,1,0,1,1,10,0,0,Matches
Rafa Mir,es ESP,FW,es Sevilla,26,1997,0.4,0,0,0,0,0,0,0,,0,0,0,0,1,1,0,0,Matches
Stefan Mitrović,rs SRB,"DF,FW",rs Red Star,20,2002,2.3,0,0,0,0,0,0,1,0.0,1,5,3,2,1,1,1,0,Matches
Henrikh Mkhitaryan,am ARM,MF,it Inter,34,1989,5.7,10,5,5,5,0,3,8,37.5,5,10,3,7,8,18,10,0,Matches
Luka Modrić,hr CRO,MF,es Real Madrid,37,1985,4.7,6,6,3,2,1,4,6,66.7,2,0,0,0,5,11,6,1,Matches
Nahuel Molina,ar ARG,DF,es Atlético Madrid,25,1998,8.7,24,15,15,7,2,18,30,60.0,12,20,2,18,7,31,16,0,Matches

Joel Monteiro,ch SUI,"FW,MF",ch Young Boys,23,1999,2.9,8,4,1,6,1,4,8,50.0,4,1,0,1,3,11,3,0,Matches
Álvaro Morata,es ESP,FW,es Atlético Madrid,30,1992,7.4,5,3,2,1,2,2,4,50.0,2,6,1,5,0,5,9,0,Matches
Morato,br BRA,DF,pt Benfica,22,2001,4.8,15,10,9,6,0,13,19,68.4,6,8,3,5,6,21,17,0,Matches
Leandro Morgalla,de GER,DF,at RB Salzburg,18,2004,0.5,0,0,0,0,0,0,0,,0,3,1,2,0,0,0,0,Matches
Youssoufa Moukoko,de GER,FW,de Dortmund,18,2004,0.2,1,0,0,0,1,0,0,,0,1,0,1,0,1,1,0,Matches
Mason Mount,eng ENG,"MF,FW",eng Manchester Utd,24,1999,1.0,2,1,1,0,1,0,0,,0,0,0,0,1,3,0,0,Matches
João Moutinho,pt POR,MF,pt Braga,36,1986,3.2,8,4,2,5,1,4,10,40.0,6,4,1,3,7,15,1,0,Matches
Arbnor Muja,al ALB,FW,be Antwerp,24,1998,4.0,5,3,3,0,2,1,6,16.7,5,4,0,4,0,5,1,0,Matches
Nordi Mukiele,fr FRA,DF,fr Paris S-G,25,1997,0.6,0,0,0,0,0,0,0,,0,2,1,1,0,0,1,0,Matches
Thomas Müller,de GER,MF,de Bayern Munich,33,1989,4.7,5,4,2,2,1,3,9,33.3,6,6,0,6,1,6,4,0,Matches
Aihen Muñoz,es ESP,DF,es Real Sociedad,25,1997,5.3,13,9,7,4,2,7,10,70.0,3,7,3,4,3,16,16,0,Matches
Jacob Murphy,eng ENG,FW,eng Newcastle Utd,28,1995,1.0,2,2,1,0,1,1,2,50.0,1,1,1,0,0,2,1,0,Matches
Petar Musa,hr CRO,"FW,MF",pt Benfica,25,1998,2.6,6,3,1,5,0,1,3,33.3,2,2,0,2,1,7,2,0,Matches
Yunus Musah,us USA,MF,it Milan,20,2002,3.9,6,3,2,3,1,2,2,100.0,0,4,2,2,2,8,3,0,Matches
Jamal Musiala,de GER,"MF,FW",de Bayern Munich,20,2003,9.7,12,10,4,7,1,8,17,47.1,9,11,1,10,12,24,0,0,Matches
Fernando Muslera,uy URU,GK,tr Galatasaray,37,1986,6.0,2,0,2,0,0,2,2,100.0,0,0,0,0,0,2,9,0,Matches
Almoatasem Al Musrati,ly LBY,MF,pt Braga,27,1996,3.4,9,7,4,4,1,3,8,37.5,5,2,0,2,8,17,6,0,Matches
Nacho,es ESP,DF,es Real Madrid,33,1990,10.9,10,8,6,4,0,3,8,37.5,5,4,3,1,10,20,32,0,Matches
Natan,br BRA,DF,it Napoli,22,2001,5.0,10,6,7,2,1,6,9,66.7,3,14,11,3,5,15,20,0,Matches
Fran Navarro,es ESP,FW,pt Porto,25,1998,0.1,0,0,0,0,0,0,0,,0,1,0,1,0,0,0,0,Matches
Jesús Navas,es ESP,DF,es Sevilla,37,1985,2.4,8,7,4,3,1,2,2,100.0,0,3,1,2,2,10,9,0,Matches
Yehor Nazaryna,ua UKR,MF,ua Shakhtar,26,1997,2.3,4,3,1,2,1,3,6,50.0,3,3,1,2,2,6,5,0,Matches
Cherif Ndiaye,sn SEN,FW,rs Red Star,27,1996,4.0,4,2,1,1,2,1,2,50.0,1,2,0,2,1,5,6,0,Matches
Tanguy Ndombele,fr FRA,MF,tr Galatasaray,26,1996,1.0,3,3,0,3,0,1,2,50.0,1,1,0,1,0,3,1,0,Matches
Kosta Nedeljković,rs SRB,DF,rs Red Star,17,2005,2.6,4,2,2,1,1,1,5,20.0,4,5,1,4,1,5,2,0,Matches

Reiss Nelson,eng ENG,FW,eng Arsenal,23,1999,2.0,6,3,0,3,3,4,6,66.7,2,1,0,1,1,7,0,0,Matches
Victor Nelsson,dk DEN,DF,tr Galatasaray,24,1998,1.1,3,1,3,0,0,3,3,100.0,0,1,1,0,0,3,6,1,Matches
David Neres,br BRA,FW,pt Benfica,26,1997,2.0,2,2,1,1,0,0,3,0.0,3,3,0,3,1,3,2,0,Matches
Manuel Neuer,de GER,GK,de Bayern Munich,37,1986,9.0,0,0,0,0,0,0,0,,0,0,0,0,0,0,4,1,Matches
João Neves,pt POR,MF,pt Benfica,18,2004,6.0,24,18,14,7,3,12,20,60.0,8,8,2,6,10,34,10,0,Matches
Newerton,br BRA,"MF,FW",ua Shakhtar,18,2005,2.4,5,3,1,0,4,3,10,30.0,7,3,1,2,0,5,2,0,Matches
Cyril Ngonge,be BEL,FW,it Napoli,23,2000,0.0,0,0,0,0,0,0,0,,0,0,0,0,0,0,0,0,Matches
Sikou Niakaté,ml MLI,DF,pt Braga,24,1999,4.3,6,3,5,1,0,4,6,66.7,2,8,8,0,5,11,22,0,Matches
Tanguy Nianzou,fr FRA,DF,es Sevilla,21,2002,0.4,0,0,0,0,0,0,0,,0,0,0,0,1,1,1,0,Matches
Cheikh Niasse,sn SEN,MF,ch Young Boys,23,2000,5.9,6,5,1,2,3,1,7,14.3,6,15,6,9,17,23,4,0,Matches
Bart Nieuwkoop,nl NED,DF,nl Feyenoord,27,1996,0.9,3,2,1,1,1,3,6,50.0,3,1,0,1,0,3,0,1,Matches
Saúl Ñíguez,es ESP,MF,es Atlético Madrid,28,1994,4.8,8,5,6,1,1,6,9,66.7,3,10,2,8,6,14,11,0,Matches
Eddie Nketiah,eng ENG,FW,eng Arsenal,24,1999,1.6,0,0,0,0,0,0,0,,0,0,0,0,0,0,1,0,Matches
Felix Nmecha,de GER,MF,de Dortmund,22,2000,3.9,8,3,3,4,1,1,7,14.3,6,2,0,2,5,13,6,0,Matches
Jean-Pierre Nsame,cm CMR,FW,ch Young Boys,30,1993,1.8,3,2,0,2,1,2,2,100.0,0,1,0,1,0,3,2,0,Matches
Matheus Nunes,pt POR,"MF,FW",eng Manchester City,24,1998,4.7,4,2,0,3,1,3,5,60.0,2,2,0,2,3,7,2,0,Matches
Ørjan Nyland,no NOR,GK,es Sevilla,32,1990,2.0,0,0,0,0,0,0,1,0.0,1,0,0,0,0,0,0,0,Matches
Matt O'Riley,dk DEN,MF,sct Celtic,22,2000,5.4,14,8,7,6,1,9,19,47.4,10,8,1,7,7,21,10,0,Matches
Armando Obispo,nl NED,DF,nl PSV Eindhoven,24,1999,1.0,0,0,0,0,0,0,2,0.0,2,1,1,0,2,2,1,0,Matches
Jan Oblak,si SVN,GK,es Atlético Madrid,30,1993,10.3,0,0,0,0,0,0,0,,0,0,0,0,0,0,1,1,Matches
Lucas Ocampos,ar ARG,FW,es Sevilla,29,1994,3.8,5,2,1,4,0,2,6,33.3,4,4,0,4,4,9,2,0,Matches
Álvaro Odriozola,es ESP,"DF,FW",es Real Sociedad,27,1995,1.1,1,1,1,0,0,1,1,100.0,0,1,0,1,1,2,0,0,Matches
Noah Okafor,ch SUI,FW,it Milan,23,2000,0.4,0,0,0,0,0,0,1,0.0,1,0,0,0,0,0,0,0,Matches
Olasagasti,es ESP,MF,es Real Sociedad,22,2000,0.1,0,0,0,0,0,0,0,,0,0,0,0,0,0,0,0,Matches
Peter Olayinka,ng NGA,"DF,FW",rs Red Star,27,1995,1.9,6,4,1,3,2,1,1,100.0,0,0,0,0,1,7,2,0,Matches

Sérgio Oliveira,pt POR,MF,tr Galatasaray,31,1992,1.4,4,3,1,2,1,1,4,25.0,3,5,0,5,0,4,2,1,Matches
Mathías Olivera,uy URU,DF,it Napoli,25,1997,3.6,13,8,9,4,0,6,9,66.7,3,4,1,3,7,20,7,0,Matches
Dani Olmo,es ESP,MF,de RB Leipzig,25,1998,2.0,4,1,2,2,0,1,4,25.0,3,1,0,1,0,4,2,0,Matches
André Onana,cm CMR,GK,eng Manchester Utd,27,1996,6.0,0,0,0,0,0,0,0,,0,0,0,0,1,1,2,4,Matches
Loïs Openda,be BEL,FW,de RB Leipzig,23,2000,6.1,2,1,1,1,0,0,7,0.0,7,3,0,3,0,2,2,0,Matches
Fredrik Oppegard,no NOR,FW,nl PSV Eindhoven,20,2002,0.0,1,1,1,0,0,1,1,100.0,0,0,0,0,1,2,0,0,Matches
Willi Orban,hu HUN,DF,de RB Leipzig,30,1992,2.0,4,3,2,2,0,4,6,66.7,2,9,6,3,1,5,9,1,Matches
Stefan Ortega,de GER,GK,eng Manchester City,30,1992,3.0,0,0,0,0,0,0,0,,0,0,0,0,0,0,1,0,Matches
Victor Osimhen,ng NGA,FW,it Napoli,24,1998,5.1,0,0,0,0,0,0,1,0.0,1,2,2,0,3,3,10,0,Matches
Nicolás Otamendi,ar ARG,DF,pt Benfica,35,1988,6.0,12,4,9,3,0,9,18,50.0,9,11,6,5,11,23,24,1,Matches
Mikel Oyarzabal,es ESP,"FW,MF",es Real Sociedad,26,1997,6.5,8,5,2,3,3,1,4,25.0,3,4,1,3,0,8,0,0,Matches
Salih Özcan,tr TUR,MF,de Dortmund,25,1998,4.9,10,5,5,4,1,4,10,40.0,6,8,2,6,7,17,6,0,Matches
Jon Pacheco,es ESP,DF,es Real Sociedad,22,2001,1.4,2,1,2,0,0,0,1,0.0,1,0,0,0,0,2,6,0,Matches
Igor Paixão,br BRA,FW,nl Feyenoord,23,2000,4.4,4,1,2,1,1,2,4,50.0,2,9,2,7,4,8,2,0,Matches
Thomas Partey,gh GHA,MF,eng Arsenal,30,1993,0.1,0,0,0,0,0,0,0,,0,0,0,0,0,0,0,0,Matches
Patric,es ESP,DF,it Lazio,30,1993,4.1,3,3,3,0,0,3,4,75.0,1,3,2,1,5,8,17,0,Matches
Benjamin Pavard,fr FRA,DF,it Inter,27,1996,5.3,7,3,4,3,0,3,5,60.0,2,6,3,3,9,16,25,1,Matches
Aleksandar Pavlovic,de GER,MF,de Bayern Munich,19,2004,2.3,1,0,0,1,0,0,3,0.0,3,5,2,3,3,4,5,0,Matches
Strahinja Pavlović,rs SRB,DF,at RB Salzburg,22,2001,5.5,12,6,7,5,0,7,12,58.3,5,7,4,3,5,17,26,1,Matches
Nicolás Paz,ar ARG,MF,es Real Madrid,18,2004,0.5,2,2,1,1,0,1,2,50.0,1,4,0,4,0,2,1,0,Matches
Pedri,es ESP,"MF,FW",es Barcelona,20,2002,3.7,10,8,3,4,3,6,13,46.2,7,5,1,4,2,12,10,0,Matches
Pedro,es ESP,FW,it Lazio,36,1987,2.1,2,1,0,2,0,0,2,0.0,2,1,1,0,0,2,1,0,Matches
Adrià Pedrosa,es ESP,"DF,FW",es Sevilla,25,1998,3.6,6,6,3,3,0,4,11,36.4,7,1,1,0,2,8,4,0,Matches
Luca Pellegrini,it ITA,DF,it Lazio,24,1999,1.8,2,1,1,1,0,1,3,33.3,2,4,1,3,3,5,5,0,Matches
Facundo Pellistri,uy URU,FW,eng Manchester Utd,21,2001,1.2,3,2,1,1,1,0,2,0.0,2,0,0,0,1,4,0,0,Matches

Iñaki Peña ,es ESP,GK,es Barcelona,24,1999,2.0,0,0,0,0,0,0,0,,0,0,0,0,0,0,2,0,Matches
Pepe,pt POR,DF,pt Porto,40,1983,7.3,10,8,9,1,0,6,11,54.5,5,6,5,1,8,18,20,0,Matches
Pepê,br BRA,"MF,FW",pt Porto,26,1997,7.1,10,7,8,2,0,1,6,16.7,5,3,0,3,3,13,1,1,Matches
Ricardo Pepi,us USA,"FW,MF",nl PSV Eindhoven,20,2003,1.5,1,0,0,1,0,0,0,,0,1,0,1,0,1,0,0,Matches
Danilo Pereira,pt POR,DF,fr Paris S-G,31,1991,1.8,4,4,3,1,0,1,1,100.0,0,2,2,0,1,5,3,0,Matches
Noah Persson,se SWE,"DF,MF",ch Young Boys,20,2003,0.4,0,0,0,0,0,0,2,0.0,2,0,0,0,0,0,2,0,Matches
Kalvin Phillips,eng ENG,MF,eng Manchester City,27,1995,1.4,2,2,2,0,0,0,1,0.0,1,0,0,0,0,2,1,0,Matches
Nathaniel Phillips,eng ENG,DF,sct Celtic,26,1997,1.0,0,0,0,0,0,0,0,,0,2,1,1,2,2,3,0,Matches
Kamil Piątkowski,pl POL,DF,at RB Salzburg,23,2000,2.0,5,4,3,2,0,3,4,75.0,1,2,0,2,4,9,14,0,Matches
Pizzi,pt POR,MF,pt Braga,33,1989,0.6,0,0,0,0,0,0,0,,0,0,0,0,0,0,0,0,Matches
Tommaso Pobega,it ITA,MF,it Milan,24,1999,1.7,3,1,2,1,0,2,4,50.0,2,2,1,1,1,4,3,0,Matches
Matteo Politano,it ITA,FW,it Napoli,29,1993,6.4,3,1,2,1,0,2,12,16.7,10,2,0,2,1,4,2,0,Matches
Nick Pope,eng ENG,GK,eng Newcastle Utd,31,1992,5.0,0,0,0,0,0,0,0,,0,0,0,0,0,0,2,0,Matches
Yussuf Poulsen,dk DEN,"FW,MF",de RB Leipzig,29,1994,3.7,1,0,0,0,1,0,4,0.0,4,2,0,2,1,2,0,1,Matches
Ivan Provedel,it ITA,GK,it Lazio,29,1994,8.0,0,0,0,0,0,0,0,,0,0,0,0,0,0,1,0,Matches
Christian Pulisic,us USA,FW,it Milan,24,1998,4.9,6,4,1,4,1,2,2,100.0,0,7,1,6,0,6,2,0,Matches
Anthony Racioppi,ch SUI,GK,ch Young Boys,24,1998,5.0,0,0,0,0,0,0,0,,0,0,0,0,0,0,2,2,Matches
Ivan Rakitić,hr CRO,MF,es Sevilla,35,1988,5.1,11,4,2,9,0,3,10,30.0,7,6,2,4,3,14,3,0,Matches
Yaroslav Rakitskiy,ua UKR,DF,ua Shakhtar,33,1989,3.8,3,2,3,0,0,2,4,50.0,2,6,4,2,6,9,22,0,Matches
André Ramalho,br BRA,DF,nl PSV Eindhoven,31,1992,4.7,8,5,5,3,0,5,5,100.0,0,10,6,4,4,12,15,0,Matches
Gonçalo Ramos,pt POR,FW,fr Paris S-G,22,2001,2.4,4,3,2,2,0,2,4,50.0,2,1,0,1,0,4,2,0,Matches
Sergio Ramos,es ESP,DF,es Sevilla,37,1986,5.0,2,2,1,1,0,2,4,50.0,2,12,9,3,4,6,16,0,Matches
Aaron Ramsdale,eng ENG,GK,eng Arsenal,25,1998,1.0,0,0,0,0,0,0,0,,0,0,0,0,0,0,0,0,Matches
Raphinha,br BRA,FW,es Barcelona,26,1996,5.2,8,6,6,2,0,4,7,57.1,3,6,0,6,1,9,2,0,Matches
Marcus Rashford,eng ENG,FW,eng Manchester Utd,25,1997,3.2,3,3,1,2,0,1,3,33.3,2,2,0,2,1,4,2,0,Matches

Giacomo Raspadori,it ITA,"FW,MF",it Napoli,23,2000,2.8,3,0,0,3,0,1,3,33.3,2,2,0,2,1,4,2,0,Matches
Petar Ratkov,rs SRB,FW,at RB Salzburg,19,2003,2.4,1,0,0,1,0,1,1,100.0,0,2,0,2,0,1,3,0,Matches
David Raum,de GER,DF,de RB Leipzig,25,1998,7.0,17,12,8,5,4,11,17,64.7,6,11,7,4,10,27,15,0,Matches
David Raya,es ESP,GK,eng Arsenal,27,1995,9.3,0,0,0,0,0,0,0,,0,0,0,0,0,0,4,1,Matches
Sergio Reguilón,es ESP,DF,eng Manchester Utd,26,1996,1.7,2,0,2,0,0,0,5,0.0,5,3,0,3,3,5,2,0,Matches
Tijjani Reijnders,nl NED,MF,it Milan,25,1998,5.3,11,4,4,5,2,6,11,54.5,5,7,0,7,5,16,4,0,Matches
Álex Remiro,es ESP,GK,es Real Sociedad,28,1995,8.0,0,0,0,0,0,0,0,,0,0,0,0,0,0,3,0,Matches
Marco Reus,de GER,"MF,FW",de Dortmund,34,1989,5.4,12,4,7,2,3,5,12,41.7,7,8,3,5,3,15,8,0,Matches
Gio Reyna,us USA,"FW,MF",de Dortmund,20,2002,0.2,1,0,0,1,0,1,1,100.0,0,1,1,0,0,1,1,0,Matches
Declan Rice,eng ENG,MF,eng Arsenal,24,1999,9.3,14,10,2,9,3,9,16,56.3,7,11,7,4,13,27,15,0,Matches
Rodrigo Riquelme,es ESP,DF,es Atlético Madrid,23,2000,3.5,10,6,8,1,1,9,21,42.9,12,3,0,3,2,12,4,0,Matches
Dmytro Riznyk,ua UKR,GK,ua Shakhtar,24,1999,6.0,1,1,1,0,0,1,1,100.0,0,0,0,0,0,1,3,1,Matches
Sergi Roberto,es ESP,MF,es Barcelona,31,1992,2.3,3,3,1,1,1,1,6,16.7,5,2,0,2,1,4,2,0,Matches
Milan Rodić,rs SRB,DF,rs Red Star,32,1991,4.6,9,5,6,2,1,6,10,60.0,4,7,4,3,4,13,13,0,Matches
Rodri,es ESP,MF,eng Manchester City,27,1996,7.7,14,11,6,7,1,9,13,69.2,4,2,0,2,6,20,6,1,Matches
Rodrygo,br BRA,FW,es Real Madrid,22,2001,11.2,8,5,3,2,3,2,12,16.7,10,13,1,12,2,10,2,0,Matches
Alessio Romagnoli,it ITA,DF,it Lazio,28,1995,6.0,7,4,4,3,0,4,5,80.0,1,7,5,2,2,9,21,0,Matches
Oriol Romeu,es ESP,MF,es Barcelona,31,1991,3.8,7,4,2,4,1,3,8,37.5,5,5,1,4,1,8,1,3,Matches
Jérôme Roussillon,fr FRA,DF,de Union Berlin,30,1993,2.9,8,5,3,4,1,3,4,75.0,1,3,3,0,0,8,10,0,Matches
Nicolò Rovella,it ITA,MF,it Lazio,21,2001,1.5,5,4,2,2,1,2,4,50.0,2,1,0,1,3,8,0,0,Matches
Amir Rrahmani,xk KVX,DF,it Napoli,29,1994,6.1,5,3,2,1,2,2,4,50.0,2,4,1,3,11,16,33,0,Matches
Donat Rrudhani,xk KVX,MF,ch Young Boys,24,1999,0.1,0,0,0,0,0,0,0,,0,1,0,1,0,0,0,0,Matches
Antonio Rüdiger,de GER,DF,es Real Madrid,30,1993,11.6,11,6,9,2,0,7,9,77.8,2,21,19,2,4,15,35,0,Matches
Mário Rui,pt POR,DF,it Napoli,32,1991,2.4,3,1,1,2,0,3,10,30.0,7,3,0,3,2,5,5,0,Matches
Abel Ruiz,es ESP,"FW,MF",pt Braga,23,2000,2.4,1,0,0,0,1,0,0,,0,1,0,1,0,1,0,0,Matches

Fabián Ruiz Peña,es ESP,MF,fr Paris S-G,27,1996,6.9,14,8,7,6,1,8,14,57.1,6,10,0,10,7,21,4,0,Matches
Julian Ryerson,no NOR,DF,de Dortmund,25,1997,10.0,27,17,17,10,0,14,38,36.8,24,14,5,9,4,31,18,0,Matches
Frederik Rønnow,dk DEN,GK,de Union Berlin,30,1992,6.0,0,0,0,0,0,0,0,,0,0,0,0,0,0,2,0,Matches
Serdar Saatçı,tr TUR,DF,pt Braga,20,2003,3.6,7,2,6,1,0,3,5,60.0,2,5,1,4,5,12,8,0,Matches
Marcel Sabitzer,at AUT,MF,de Dortmund,29,1994,10.3,12,7,6,4,2,8,14,57.1,6,9,3,6,7,19,22,0,Matches
Umar Sadiq,ng NGA,FW,es Real Sociedad,26,1997,1.1,2,1,0,2,0,0,0,,0,0,0,0,0,2,1,0,Matches
Ismael Saibari,ma MAR,MF,nl PSV Eindhoven,22,2001,3.5,4,3,2,2,0,2,6,33.3,4,2,0,2,3,7,3,0,Matches
Wesley Saïd,fr FRA,"FW,MF",fr Lens,28,1995,0.6,1,0,0,1,0,1,2,50.0,1,0,0,0,0,1,0,0,Matches
Bukayo Saka,eng ENG,FW,eng Arsenal,21,2001,8.0,16,12,3,8,5,6,15,40.0,9,10,1,9,2,18,3,0,Matches
Kike Salas,es ESP,DF,es Sevilla,21,2002,1.8,4,2,1,3,0,2,2,100.0,0,2,0,2,5,9,7,0,Matches
William Saliba,fr FRA,DF,eng Arsenal,22,2001,10.0,10,4,4,4,2,5,9,55.6,4,8,3,5,7,17,26,0,Matches
Brice Samba,fr FRA,GK,fr Lens,29,1994,6.0,0,0,0,0,0,0,0,,0,1,0,1,0,0,1,1,Matches
Alexis Sánchez,cl CHI,FW,it Inter,34,1988,3.7,5,4,1,4,0,3,5,60.0,2,0,0,0,2,7,0,0,Matches
Davinson Sánchez,co COL,DF,tr Galatasaray,27,1996,4.0,8,7,4,2,2,5,12,41.7,7,9,3,6,5,13,12,1,Matches
Juanlu Sánchez,es ESP,DF,es Sevilla,19,2003,3.6,15,8,10,4,1,9,24,37.5,15,6,1,5,2,17,5,0,Matches
Jadon Sancho,eng ENG,FW,de Dortmund,23,2000,6.2,9,7,2,5,2,4,6,66.7,2,10,0,10,2,11,2,0,Matches
Leroy Sané,de GER,FW,de Bayern Munich,27,1996,10.2,13,9,3,4,6,3,13,23.1,10,7,0,7,2,15,1,0,Matches
Zaidu Sanusi,ng NGA,DF,pt Porto,26,1997,3.4,7,4,5,2,0,3,5,60.0,2,2,0,2,4,11,6,0,Matches
Bouna Sarr,sn SEN,DF,de Bayern Munich,31,1992,0.1,0,0,0,0,0,0,0,,0,0,0,0,1,1,0,0,Matches
Leo Sauer,sk SVK,"MF,FW",nl Feyenoord,17,2005,0.2,0,0,0,0,0,0,1,0.0,1,1,0,1,0,0,0,0,Matches
Stefan Savić,me MNE,DF,es Atlético Madrid,32,1991,4.6,5,2,3,1,1,3,3,100.0,0,4,1,3,11,16,15,0,Matches
Liam Scales,ie IRL,DF,sct Celtic,24,1998,6.0,8,5,7,1,0,6,8,75.0,2,8,7,1,0,8,29,0,Matches
Fabian Schär,ch SUI,DF,eng Newcastle Utd,31,1991,6.0,7,7,4,3,0,4,9,44.4,5,7,5,2,6,13,28,0,Matches
Alexander Schlager,at AUT,GK,at RB Salzburg,27,1996,6.0,0,0,0,0,0,0,0,,0,0,0,0,1,1,2,0,Matches
Xaver Schlager,at AUT,MF,de RB Leipzig,25,1997,6.9,21,15,10,10,1,4,13,30.8,9,9,3,6,5,26,7,2,Matches

Nico Schlotterbeck,de GER,DF,de Dortmund,23,1999,10.8,26,15,17,9,0,18,21,85.7,3,20,12,8,11,37,38,1,Matches
Jerdy Schouten,nl NED,"MF,DF",nl PSV Eindhoven,26,1997,6.9,13,9,4,6,3,6,9,66.7,3,6,2,4,5,18,7,0,Matches
Nicolas Seiwald,at AUT,MF,de RB Leipzig,22,2001,3.0,9,5,3,5,1,4,8,50.0,4,5,1,4,5,14,4,0,Matches
Benjamin Šeško,si SVN,FW,de RB Leipzig,20,2003,4.5,4,1,0,2,2,3,10,30.0,7,5,0,5,1,5,3,0,Matches
Luke Shaw,eng ENG,DF,eng Manchester Utd,28,1995,1.5,2,2,0,2,0,1,2,50.0,1,2,1,1,3,5,0,0,Matches
Maryan Shved,ua UKR,FW,ua Shakhtar,26,1997,0.1,0,0,0,0,0,0,0,,0,0,0,0,0,0,0,0,Matches
Danylo Sikan,ua UKR,FW,ua Shakhtar,22,2001,5.3,6,5,2,3,1,2,5,40.0,3,7,1,6,1,7,11,1,Matches
André Silva,pt POR,FW,es Real Sociedad,27,1995,1.0,2,1,2,0,0,1,1,100.0,0,1,1,0,0,2,1,0,Matches
António Silva,pt POR,DF,pt Benfica,19,2003,3.1,8,6,7,1,0,6,7,85.7,1,3,2,1,1,9,16,0,Matches
Bernardo Silva,pt POR,"FW,MF",eng Manchester City,28,1994,5.9,11,6,4,4,3,6,13,46.2,7,6,1,5,2,13,6,0,Matches
Rafa Silva,pt POR,"MF,FW",pt Benfica,30,1993,5.6,7,4,2,2,3,1,6,16.7,5,2,0,2,3,10,0,0,Matches
Mohamed Simakan,fr FRA,DF,de RB Leipzig,23,2000,6.6,12,7,12,0,0,7,15,46.7,8,7,4,3,10,22,23,0,Matches
Giovanni Simeone,ar ARG,FW,it Napoli,28,1995,1.1,3,2,2,1,0,0,0,,0,0,0,0,1,4,1,0,Matches
Roko Simic,hr CRO,FW,at RB Salzburg,19,2003,3.8,2,1,1,1,0,1,1,100.0,0,1,0,1,2,4,3,0,Matches
Xavi Simons,nl NED,"MF,FW",de RB Leipzig,20,2003,6.6,5,2,3,2,0,1,7,14.3,6,7,0,7,4,9,1,0,Matches
Leo Skiri Østigård,no NOR,DF,it Napoli,23,1999,2.1,4,3,3,1,0,0,1,0.0,1,4,3,1,2,6,13,0,Matches
Milan Škriniar,sk SVK,DF,fr Paris S-G,28,1995,6.0,12,7,9,3,0,8,8,100.0,0,5,3,2,5,17,12,0,Matches
Emile Smith Rowe,eng ENG,MF,eng Arsenal,23,2000,0.5,1,1,1,0,0,1,2,50.0,1,0,0,0,1,2,0,0,Matches
Cédric Soares,pt POR,DF,eng Arsenal,31,1991,0.7,0,0,0,0,0,0,2,0.0,2,2,0,2,0,0,2,0,Matches
Carlos Soler,es ESP,"MF,FW",fr Paris S-G,26,1997,0.1,0,0,0,0,0,0,0,,0,0,0,0,0,0,0,0,Matches
Oumar Solet,fr FRA,DF,at RB Salzburg,23,2000,1.7,3,3,3,0,0,2,3,66.7,1,2,1,1,2,5,4,0,Matches
Yann Sommer,ch SUI,GK,it Inter,34,1988,7.3,0,0,0,0,0,0,0,,0,0,0,0,0,0,2,0,Matches
Florian Sotoca,fr FRA,MF,fr Lens,32,1990,5.2,10,7,6,3,1,7,12,58.3,5,7,1,6,5,15,8,0,Matches
Boubakary Soumaré,fr FRA,MF,es Sevilla,24,1999,2.4,5,5,2,3,0,2,3,66.7,1,3,1,2,3,8,2,0,Matches
Djibril Sow,ch SUI,MF,es Sevilla,26,1997,4.1,5,3,2,3,0,1,3,33.3,2,3,1,2,1,6,3,0,Matches

Çağlar Söyüncü,tr TUR,DF,es Atlético Madrid,27,1996,0.7,0,0,0,0,0,0,0,,0,0,0,0,0,0,1,0,Matches
Uroš Spajić,rs SRB,DF,rs Red Star,30,1993,0.7,0,0,0,0,0,0,1,0.0,1,1,1,0,0,0,0,0,Matches
Marco Sportiello,it ITA,GK,it Milan,31,1992,0.1,0,0,0,0,0,0,0,,0,0,0,0,0,0,1,0,Matches
Marko Stamenic,nz NZL,MF,rs Red Star,21,2002,3.3,5,1,3,0,2,4,10,40.0,6,8,3,5,2,7,11,0,Matches
Orri Steinn Óskarsson,is ISL,FW,dk FC Copenhagen,18,2004,1.6,2,0,1,1,0,1,1,100.0,0,1,0,1,0,2,0,0,Matches
Calvin Stengs,nl NED,"FW,MF",nl Feyenoord,24,1998,5.2,8,7,1,5,2,2,6,33.3,4,2,1,1,2,10,1,0,Matches
Taras Stepanenko,ua UKR,MF,ua Shakhtar,33,1989,5.5,14,7,12,2,0,8,9,88.9,1,5,2,3,6,20,19,0,Matches
John Stones,eng ENG,"DF,MF",eng Manchester City,29,1994,3.8,2,1,1,1,0,0,0,,0,4,2,2,2,4,7,0,Matches
Luka Sučić,hr CRO,"FW,MF",at RB Salzburg,20,2002,4.4,6,5,2,4,0,3,9,33.3,6,9,0,9,5,11,7,0,Matches
Heorhiy Sudakov,ua UKR,MF,ua Shakhtar,20,2002,6.0,4,2,2,2,0,2,8,25.0,6,3,0,3,6,10,6,0,Matches
Niklas Süle,de GER,DF,de Dortmund,27,1995,4.4,12,9,9,3,0,10,18,55.6,8,4,2,2,2,14,14,0,Matches
Suso,es ESP,MF,es Sevilla,29,1993,0.9,1,1,1,0,0,1,4,25.0,3,0,0,0,0,1,0,0,Matches
Mahamadou Susoho,es ESP,MF,eng Manchester City,18,2005,0.2,0,0,0,0,0,0,0,,0,0,0,0,0,0,0,0,Matches
Christian Sørensen,dk DEN,DF,dk FC Copenhagen,30,1992,0.5,0,0,0,0,0,0,3,0.0,3,1,0,1,0,0,1,0,Matches
Mehdi Taremi,ir IRN,FW,pt Porto,31,1992,6.1,17,8,3,8,6,3,9,33.3,6,10,0,10,0,17,8,0,Matches
Matt Targett,eng ENG,DF,eng Newcastle Utd,27,1995,0.2,0,0,0,0,0,0,0,,0,0,0,0,0,0,0,0,Matches
Greg Taylor,sct SCO,DF,sct Celtic,25,1997,6.0,11,8,6,5,0,7,11,63.6,4,6,2,4,4,15,12,0,Matches
Aurélien Tchouaméni,fr FRA,"MF,DF",es Real Madrid,23,2000,6.7,9,4,6,3,0,2,8,25.0,6,9,6,3,9,18,12,0,Matches
Mathys Tel,fr FRA,"FW,MF",de Bayern Munich,18,2005,1.6,1,1,0,1,0,1,4,25.0,3,4,0,4,2,3,0,0,Matches
Casper Tengstedt,dk DEN,FW,pt Benfica,23,2000,1.5,1,0,0,1,0,1,1,100.0,0,1,0,1,0,1,0,0,Matches
Marc-André ter Stegen,de GER,GK,es Barcelona,31,1992,8.0,0,0,0,0,0,0,0,,0,0,0,0,0,0,1,0,Matches
Aleksa Terzić,rs SRB,DF,at RB Salzburg,23,1999,2.0,3,1,2,1,0,2,6,33.3,4,0,0,0,2,5,3,0,Matches
Tetê,br BRA,FW,tr Galatasaray,23,2000,2.5,7,2,3,2,2,4,10,40.0,6,2,0,2,2,9,3,0,Matches
Jordan Teze,nl NED,DF,nl PSV Eindhoven,23,1999,8.0,15,9,11,4,0,8,15,53.3,7,8,4,4,7,22,8,0,Matches
Odin Thiago Holm,no NOR,MF,sct Celtic,20,2003,0.6,0,0,0,0,0,0,1,0.0,1,1,0,1,0,0,2,0,Matches

Malick Thiaw,de GER,DF,it Milan,21,2001,4.1,8,3,4,4,0,3,4,75.0,1,7,4,3,4,12,19,0,Matches
Adrien Thomasson,fr FRA,MF,fr Lens,29,1993,2.5,0,0,0,0,0,0,1,0.0,1,5,0,5,0,0,2,1,Matches
Marcus Thuram,fr FRA,FW,it Inter,25,1997,5.1,4,3,1,1,2,1,1,100.0,0,2,0,2,1,5,3,0,Matches
Kieran Tierney,sct SCO,DF,es Real Sociedad,26,1997,0.7,2,2,0,1,1,2,2,100.0,0,3,0,3,2,4,2,0,Matches
Guus Til,nl NED,MF,nl PSV Eindhoven,25,1997,2.0,2,2,2,0,0,1,2,50.0,1,3,0,3,0,2,1,0,Matches
Malik Tillman,us USA,MF,nl PSV Eindhoven,21,2002,5.6,13,11,0,10,3,2,4,50.0,2,13,2,11,8,21,5,0,Matches
Quinten Timber,nl NED,MF,nl Feyenoord,22,2001,5.1,6,5,0,5,1,2,4,50.0,2,9,0,9,3,9,1,0,Matches
Takehiro Tomiyasu,jp JPN,DF,eng Arsenal,24,1998,4.3,4,3,2,0,2,3,6,50.0,3,4,0,4,2,6,5,0,Matches
Fikayo Tomori,eng ENG,DF,it Milan,25,1997,6.0,16,9,7,8,1,6,7,85.7,1,13,6,7,10,26,15,0,Matches
Sandro Tonali,it ITA,MF,eng Newcastle Utd,23,2000,1.8,1,1,1,0,0,1,1,100.0,0,1,0,1,2,3,2,0,Matches
Lucas Torreira,uy URU,MF,tr Galatasaray,27,1996,5.5,11,7,5,6,0,2,7,28.6,5,6,0,6,8,19,10,1,Matches
Ferrán Torres,es ESP,FW,es Barcelona,23,2000,4.2,4,3,2,1,1,1,2,50.0,1,2,0,2,0,4,3,0,Matches
Óliver Torres,es ESP,"FW,MF",es Sevilla,28,1994,1.1,1,0,0,1,0,1,1,100.0,0,2,0,2,0,1,0,0,Matches
Lucas Tousart,fr FRA,MF,de Union Berlin,26,1997,2.6,10,5,9,1,0,5,7,71.4,2,3,0,3,4,14,4,0,Matches
Chaka Traorè,ci CIV,MF,it Milan,18,2004,0.2,0,0,0,0,0,0,1,0.0,1,0,0,0,0,0,0,0,Matches
Hamari Traoré,ml MLI,DF,es Real Sociedad,31,1992,5.9,7,3,2,2,3,3,7,42.9,4,6,2,4,12,19,11,0,Matches
Gernot Trauner,at AUT,DF,nl Feyenoord,31,1992,3.1,5,3,3,2,0,2,3,66.7,1,6,4,2,2,7,8,0,Matches
Christopher Trimmel,at AUT,"FW,DF",de Union Berlin,36,1987,1.4,4,4,2,2,0,3,4,75.0,1,2,0,2,1,5,3,0,Matches
Kieran Trippier,eng ENG,DF,eng Newcastle Utd,32,1990,5.7,11,6,7,3,1,7,16,43.8,9,8,2,6,5,16,13,0,Matches
Leandro Trossard,be BEL,FW,eng Arsenal,28,1994,5.9,4,1,1,1,2,2,9,22.2,7,4,0,4,3,7,5,0,Matches
Anatolii Trubin,ua UKR,GK,pt Benfica,21,2001,6.0,0,0,0,0,0,0,1,0.0,1,0,0,0,0,0,2,0,Matches
David Turnbull,sct SCO,"MF,FW",sct Celtic,24,1999,0.4,1,0,1,0,0,1,3,33.3,2,1,0,1,0,1,1,0,Matches
Beñat Turrientes,es ESP,MF,es Real Sociedad,21,2002,2.1,4,3,1,2,1,0,4,0.0,4,4,2,2,1,5,1,1,Matches
Ayase Ueda,jp JPN,FW,nl Feyenoord,24,1998,1.7,1,1,0,0,1,0,0,,0,0,0,0,0,1,0,0,Matches
Manuel Ugarte Ribeiro,uy URU,MF,fr Paris S-G,22,2001,4.3,8,3,3,4,1,4,22,18.2,18,2,1,1,8,16,5,0,Matches

Filip Ugrinic,ch SUI,MF,ch Young Boys,24,1999,5.7,14,9,7,4,3,3,12,25.0,9,16,3,13,5,19,3,0,Matches
Andreas Ulmer,at AUT,DF,at RB Salzburg,37,1985,2.4,7,5,4,1,2,3,4,75.0,1,6,2,4,1,8,5,0,Matches
Sven Ulreich,de GER,GK,de Bayern Munich,34,1988,3.0,0,0,0,0,0,0,0,,0,0,0,0,0,0,2,1,Matches
Dayot Upamecano,fr FRA,DF,de Bayern Munich,24,1998,5.5,16,11,11,5,0,7,9,77.8,2,2,1,1,5,21,13,0,Matches
Anthony Valencia,ec ECU,"MF,FW",be Antwerp,20,2003,0.4,0,0,0,0,0,0,0,,0,0,0,0,0,0,0,0,Matches
Federico Valverde,uy URU,"MF,FW",es Real Madrid,25,1998,11.9,21,13,12,6,3,10,20,50.0,10,13,4,9,13,34,18,0,Matches
Zeno Van den Bosch,be BEL,DF,be Antwerp,20,2003,1.0,1,0,1,0,0,0,0,,0,2,0,2,1,2,5,0,Matches
Raphaël Varane,fr FRA,DF,eng Manchester Utd,30,1993,3.7,4,3,2,2,0,1,1,100.0,0,6,3,3,4,8,13,0,Matches
Alan Varela,ar ARG,MF,pt Porto,22,2001,7.8,15,6,6,8,1,6,11,54.5,5,5,1,4,8,23,12,1,Matches
Denis Vavro,sk SVK,DF,dk FC Copenhagen,27,1996,7.9,6,2,5,1,0,5,10,50.0,5,14,12,2,6,12,53,0,Matches
Lucas Vázquez,es ESP,DF,es Real Madrid,32,1991,4.2,5,5,2,3,0,1,6,16.7,5,2,0,2,1,6,3,0,Matches
Matías Vecino,uy URU,MF,it Lazio,31,1991,5.2,9,5,3,4,2,5,18,27.8,13,8,3,5,6,15,13,0,Matches
Joey Veerman,nl NED,MF,nl PSV Eindhoven,24,1998,6.4,13,7,5,6,2,7,20,35.0,13,8,0,8,6,19,11,0,Matches
Arthur Vermeeren,be BEL,MF,be Antwerp,18,2005,6.0,19,8,8,9,2,10,16,62.5,6,13,4,9,7,26,6,1,Matches
Yorbe Vertessen,be BEL,FW,nl PSV Eindhoven,22,2001,1.8,1,1,1,0,0,0,1,0.0,1,1,0,1,0,1,0,0,Matches
Fabio Vieira,pt POR,FW,eng Arsenal,23,2000,1.0,0,0,0,0,0,0,0,,0,0,0,0,0,0,1,0,Matches
Vitinha,pt POR,MF,fr Paris S-G,23,2000,10.2,15,11,5,8,2,3,12,25.0,9,8,0,8,13,28,14,0,Matches
Kevin Volland,de GER,"FW,MF",de Union Berlin,31,1992,2.6,5,3,1,3,1,0,4,0.0,4,3,0,3,0,5,0,1,Matches
Stefan de Vrij,nl NED,DF,it Inter,31,1992,5.5,9,5,6,3,0,4,8,50.0,4,6,3,3,5,14,34,0,Matches
Elye Wahi,fr FRA,FW,fr Lens,20,2003,5.1,2,2,0,1,1,0,0,,0,0,0,0,0,2,0,0,Matches
Kyle Walker,eng ENG,DF,eng Manchester City,33,1990,5.6,7,3,2,4,1,6,7,85.7,1,1,0,1,4,11,4,0,Matches
Aaron Wan-Bissaka,eng ENG,DF,eng Manchester Utd,25,1997,2.4,7,5,3,4,0,1,1,100.0,0,1,0,1,10,17,9,0,Matches
Timon Wellenreuther,de GER,GK,nl Feyenoord,27,1995,2.0,0,0,0,0,0,0,0,,0,0,0,0,0,0,0,0,Matches
Stephen Welsh,sct SCO,DF,sct Celtic,23,2000,0.8,3,1,2,1,0,1,1,100.0,0,1,1,0,0,3,3,0,Matches
Wendell,br BRA,DF,pt Porto,30,1993,4.3,16,7,12,4,0,4,8,50.0,4,5,2,3,9,25,10,0,Matches

Timo Werner,de GER,"FW,MF",de RB Leipzig,27,1996,0.6,1,1,1,0,0,1,1,100.0,0,1,0,1,0,1,1,0,Matches
Ben White,eng ENG,DF,eng Arsenal,25,1997,8.4,9,5,1,5,3,5,15,33.3,10,10,1,9,9,18,10,0,Matches
Mats Wieffer,nl NED,MF,nl Feyenoord,23,1999,5.2,9,5,3,4,2,6,9,66.7,3,5,0,5,10,19,5,0,Matches
Owen Wijndal,nl NED,DF,be Antwerp,23,1999,5.0,13,6,9,3,1,6,14,42.9,8,9,3,6,3,16,10,0,Matches
Joe Willock,eng ENG,MF,eng Newcastle Utd,23,1999,1.1,2,2,1,1,0,2,3,66.7,1,1,1,0,0,2,0,0,Matches
Callum Wilson,eng ENG,FW,eng Newcastle Utd,31,1992,2.7,0,0,0,0,0,0,1,0.0,1,1,0,1,0,0,0,0,Matches
Axel Witsel,be BEL,"DF,MF",es Atlético Madrid,34,1989,9.8,7,4,4,2,1,3,4,75.0,1,15,8,7,11,18,26,0,Matches
Marius Wolf,de GER,"DF,FW",de Dortmund,28,1995,3.2,13,8,9,2,2,6,8,75.0,2,4,1,3,4,17,14,0,Matches
Jacob Wright,eng ENG,FW,eng Manchester City,17,2005,0.0,0,0,0,0,0,0,0,,0,0,0,0,0,0,0,0,Matches
Lamine Yamal,es ESP,FW,es Barcelona,16,2007,6.4,9,7,2,3,4,1,11,9.1,10,15,0,15,7,16,1,0,Matches
Alhassan Yusuf,ng NGA,MF,be Antwerp,23,2000,4.2,9,6,1,6,2,4,11,36.4,7,8,4,4,3,12,5,1,Matches
Mattia Zaccagni,it ITA,FW,it Lazio,28,1995,5.1,8,5,2,6,0,4,7,57.1,3,8,1,7,5,13,2,0,Matches
Wilfried Zaha,ci CIV,FW,tr Galatasaray,30,1992,4.4,9,7,2,6,1,3,4,75.0,1,5,0,5,1,10,1,0,Matches
Warren Zaïre-Emery,fr FRA,MF,fr Paris S-G,17,2006,10.0,15,8,5,6,4,6,16,37.5,10,14,1,13,7,22,10,0,Matches
Arsen Zakharyan,ru RUS,"FW,MF",es Real Sociedad,20,2003,2.4,4,1,2,2,0,1,1,100.0,0,7,0,7,1,5,1,0,Matches
Rodrigo Zalazar,uy URU,MF,pt Braga,23,1999,4.4,18,9,9,8,1,11,18,61.1,7,7,1,6,2,20,2,0,Matches
Andre-Frank Zambo Anguissa,cm CMR,MF,it Napoli,27,1995,7.0,11,6,3,8,0,5,17,29.4,12,11,1,10,8,19,9,0,Matches
Alessandro Zanoli,it ITA,DF,it Napoli,22,2000,0.0,0,0,0,0,0,0,0,,0,0,0,0,0,0,1,0,Matches
Ramiz Zerrouki,dz ALG,MF,nl Feyenoord,25,1998,3.9,10,6,6,3,1,6,8,75.0,2,5,1,4,5,15,3,0,Matches
Piotr Zieliński,pl POL,MF,it Napoli,29,1994,5.2,2,1,0,1,1,0,2,0.0,2,1,0,1,4,6,2,0,Matches
Oleksandr Zinchenko,ua UKR,DF,eng Arsenal,26,1996,3.1,6,3,5,1,0,4,8,50.0,4,3,0,3,4,10,2,0,Matches
Hakim Ziyech,ma MAR,FW,tr Galatasaray,30,1993,2.8,4,2,1,1,2,2,6,33.3,4,6,2,4,4,8,0,0,Matches
Igor Zubeldia,es ESP,DF,es Real Sociedad,26,1997,7.7,14,12,9,4,1,8,9,88.9,1,12,7,5,8,22,23,0,Matches
Martín Zubimendi,es ESP,MF,es Real Sociedad,24,1999,7.9,18,7,5,12,1,5,10,50.0,5,9,1,8,7,25,12,0,Matches
Oleksandr Zubkov,ua UKR,"FW,MF",ua Shakhtar,26,1996,5.9,11,6,5,4,2,7,14,50.0,7,2,0,2,2,13,7,0,Matches

Martin Ødegaard,no NOR,MF,eng Arsenal,24,1998,8.3,11,5,2,7,2,4,11,36.4,7,6,0,6,7,18,0,0,Matches
Łukasz Łakomy,pl POL,MF,ch Young Boys,22,2001,0.2,1,1,0,1,0,1,1,100.0,0,0,0,0,0,1,0,0,Matches
