player,nation,position,squad,age,year_of_birth,90s_played,tackles,tackles_won,tackles_(def_3rd),tackles_(mid_3rd),tackles_(att_3rd),dribblers_tackled,dribbles_challenged,%_of_dribblers_tackled,challenges_lost,blocks,shots_blocked,passes_blocked,interceptions,tkl+int,clearances,errors,league,season
Brenden Aaronson,USA,"MF,FW",Leeds United,21,2000,26.4,45,18,16,22,7,15,46,32.6,31,43,3,40,5,50,6,1,Premier_League,2022_2023
George Abbott,ENG,MF,Tottenham,16,2005,0.0,0,0,0,0,0,0,0,,0,0,0,0,1,1,0,0,Premier_League,2022_2023
Che Adams,SCO,FW,Southampton,26,1996,22.1,17,13,7,8,2,7,12,58.3,5,13,4,9,4,21,22,0,Premier_League,2022_2023
Tyler Adams,USA,MF,Leeds United,23,1999,24.0,89,46,44,35,10,50,77,64.9,27,48,8,40,35,124,29,0,Premier_League,2022_2023
Tosin Adarabioyo,ENG,DF,Fulham,24,1997,23.2,30,13,22,6,2,16,23,69.6,7,20,15,5,26,56,140,1,Premier_League,2022_2023
Nayef Aguerd,MAR,DF,West Ham,26,1996,17.7,27,18,18,8,1,13,20,65.0,7,26,24,2,18,45,79,2,Premier_League,2022_2023
Naouirou Ahamada,FRA,"MF,FW",Crystal Palace,20,2002,1.0,3,2,3,0,0,1,3,33.3,2,2,0,2,0,3,0,0,Premier_League,2022_2023
Rayan Aït-Nouri,ALG,DF,Wolves,21,2001,12.0,33,20,25,7,1,9,16,56.3,7,3,0,3,9,42,28,0,Premier_League,2022_2023
Kristoffer Ajer,NOR,DF,Brentford,24,1998,8.5,11,8,5,4,2,9,16,56.3,7,6,5,1,7,18,22,0,Premier_League,2022_2023
Manuel Akanji,SUI,DF,Manchester City,27,1995,25.4,36,25,15,18,3,23,36,63.9,13,27,9,18,16,52,33,1,Premier_League,2022_2023
Nathan Aké,NED,DF,Manchester City,27,1995,20.8,26,12,15,9,2,11,15,73.3,4,20,10,10,20,46,48,0,Premier_League,2022_2023
Marc Albrighton,ENG,"FW,MF",Leicester City,32,1989,2.6,4,1,0,2,2,1,8,12.5,7,6,2,4,1,5,5,0,Premier_League,2022_2023
Thiago Alcántara,ESP,MF,Liverpool,31,1991,13.9,43,24,20,21,2,14,23,60.9,9,15,3,12,21,64,13,2,Premier_League,2022_2023
Carlos Alcaraz,ARG,"MF,FW",Southampton,19,2002,11.4,10,5,2,7,1,6,22,27.3,16,14,5,9,1,11,11,0,Premier_League,2022_2023
Trent Alexander-Arnold,ENG,DF,Liverpool,23,1998,32.5,57,40,32,16,9,42,80,52.5,38,25,7,18,43,100,41,2,Premier_League,2022_2023
Alisson,BRA,GK,Liverpool,29,1992,37.0,0,0,0,0,0,0,3,0.0,3,3,0,3,0,0,20,0,Premier_League,2022_2023
Dele Alli,ENG,MF,Everton,26,1996,0.4,0,0,0,0,0,0,0,,0,0,0,0,0,0,0,0,Premier_League,2022_2023
Miguel Almirón,PAR,FW,Newcastle Utd,28,1994,27.7,46,30,16,19,11,18,42,42.9,24,25,2,23,10,56,17,0,Premier_League,2022_2023
Julián Álvarez,ARG,"FW,MF",Manchester City,22,2000,16.3,26,16,3,13,10,9,30,30.0,21,13,0,13,2,28,6,0,Premier_League,2022_2023
Daniel Amartey,GHA,DF,Leicester City,27,1994,17.9,19,8,13,5,1,12,14,85.7,2,24,17,7,8,27,71,0,Premier_League,2022_2023
Samuel Amo-Ameyaw,ENG,MF,Southampton,16,2006,0.0,0,0,0,0,0,0,1,0.0,1,0,0,0,0,0,0,0,Premier_League,2022_2023
Joachim Andersen,DEN,DF,Crystal Palace,26,1996,30.9,42,22,30,12,0,16,32,50.0,16,28,13,15,24,66,188,1,Premier_League,2022_2023
Elliot Anderson,ENG,"MF,FW",Newcastle Utd,19,2002,4.6,11,5,5,3,3,6,12,50.0,6,11,2,9,6,17,2,0,Premier_League,2022_2023
Jaidon Anthony,ENG,"MF,FW",Bournemouth,22,1999,14.0,30,17,15,9,6,8,24,33.3,16,30,3,27,10,40,19,0,Premier_League,2022_2023
Michail Antonio,JAM,FW,West Ham,32,1990,20.3,14,7,1,8,5,3,12,25.0,9,13,5,8,5,19,9,0,Premier_League,2022_2023
Antony,BRA,FW,Manchester Utd,22,2000,20.0,22,9,9,9,4,8,28,28.6,20,18,0,18,11,33,6,0,Premier_League,2022_2023
Cameron Archer,ENG,"FW,MF",Aston Villa,21,2001,0.5,0,0,0,0,0,0,0,,0,0,0,0,0,0,0,0,Premier_League,2022_2023
Alphonse Areola,FRA,GK,West Ham,29,1993,3.4,0,0,0,0,0,0,0,,0,0,0,0,0,0,0,0,Premier_League,2022_2023
Joe Aribo,NGA,"MF,FW",Southampton,26,1996,13.6,31,20,15,12,4,11,20,55.0,9,14,1,13,10,41,11,0,Premier_League,2022_2023
Adam Armstrong,ENG,"FW,MF",Southampton,25,1997,14.8,14,9,6,5,3,3,10,30.0,7,15,3,12,5,19,6,0,Premier_League,2022_2023
Stuart Armstrong,SCO,"MF,FW",Southampton,30,1992,15.6,32,21,15,13,4,14,39,35.9,25,18,0,18,10,42,9,2,Premier_League,2022_2023
Kepa Arrizabalaga,ESP,GK,Chelsea,27,1994,28.5,2,2,2,0,0,2,3,66.7,1,0,0,0,1,3,16,2,Premier_League,2022_2023
Pierre-Emerick Aubameyang,GAB,FW,Chelsea,33,1989,6.2,1,0,1,0,0,0,1,0.0,1,2,0,2,2,3,4,2,Premier_League,2022_2023
Ludwig Augustinsson,SWE,DF,Aston Villa,28,1994,0.9,1,1,1,0,0,0,0,,0,0,0,0,0,1,1,0,Premier_League,2022_2023
Serge Aurier,CIV,DF,Nott'ham Forest,29,1992,21.6,64,41,41,18,5,23,33,69.7,10,34,11,23,29,93,75,0,Premier_League,2022_2023
Taiwo Awoniyi,NGA,FW,Nott'ham Forest,24,1997,15.6,17,10,2,10,5,6,12,50.0,6,18,4,14,4,21,20,0,Premier_League,2022_2023
Yasin Ayari,SWE,MF,Brighton,18,2003,0.7,2,2,1,1,0,0,4,0.0,4,1,0,1,0,2,0,0,Premier_League,2022_2023
André Ayew,GHA,"FW,MF",Nott'ham Forest,32,1989,3.5,5,3,0,4,1,2,4,50.0,2,6,1,5,0,5,7,0,Premier_League,2022_2023
Jordan Ayew,GHA,"FW,MF",Crystal Palace,30,1991,30.2,66,41,23,20,23,21,53,39.6,32,35,4,31,15,81,31,0,Premier_League,2022_2023
Luke Ayling,ENG,DF,Leeds United,30,1991,22.8,66,37,42,15,9,42,85,49.4,43,34,11,23,26,92,52,2,Premier_League,2022_2023
César Azpilicueta,ESP,DF,Chelsea,32,1989,17.0,43,25,23,15,5,22,37,59.5,15,26,5,21,19,62,54,1,Premier_League,2022_2023
Benoît Badiashile,FRA,DF,Chelsea,21,2001,10.1,14,8,10,4,0,9,14,64.3,5,5,2,3,16,30,34,1,Premier_League,2022_2023
Leon Bailey,JAM,"FW,MF",Aston Villa,24,1997,21.9,14,6,6,7,1,5,20,25.0,15,13,0,13,6,20,12,0,Premier_League,2022_2023
Stefan Bajcetic,ESP,MF,Liverpool,17,2004,5.8,9,6,5,3,1,8,27,29.6,19,7,0,7,9,18,4,0,Premier_League,2022_2023
Dominic Ballard,ENG,"FW,MF",Southampton,17,2005,0.3,0,0,0,0,0,0,0,,0,0,0,0,1,1,0,0,Premier_League,2022_2023
Patrick Bamford,ENG,FW,Leeds United,28,1993,16.8,9,6,0,6,3,4,20,20.0,16,12,5,7,5,14,13,0,Premier_League,2022_2023
Shandon Baptiste,GRN,MF,Brentford,24,1998,6.9,15,9,6,6,3,7,17,41.2,10,10,2,8,7,22,10,0,Premier_League,2022_2023
Harvey Barnes,ENG,"FW,MF",Leicester City,24,1997,30.1,26,14,8,14,4,14,42,33.3,28,32,1,31,8,34,12,0,Premier_League,2022_2023
Gavin Bazunu,IRL,GK,Southampton,20,2002,32.0,1,0,1,0,0,1,1,100.0,0,0,0,0,1,2,24,2,Premier_League,2022_2023
Mads Bech Sørensen,DEN,"DF,MF",Brentford,23,1999,0.2,0,0,0,0,0,0,0,,0,0,0,0,1,1,1,0,Premier_League,2022_2023
Jan Bednarek,POL,DF,Southampton,26,1996,18.6,27,21,20,7,0,12,16,75.0,4,38,27,11,49,76,87,0,Premier_League,2022_2023
Jan Bednarek,POL,DF,Aston Villa,26,1996,1.1,3,3,0,3,0,1,1,100.0,0,3,1,2,2,5,5,0,Premier_League,2022_2023
Donny van de Beek,NED,MF,Manchester Utd,25,1997,1.9,0,0,0,0,0,0,1,0.0,1,2,1,1,1,1,1,0,Premier_League,2022_2023
Asmir Begović,BIH,GK,Everton,35,1987,1.0,0,0,0,0,0,0,0,,0,0,0,0,0,0,1,0,Premier_League,2022_2023
Armel Bella Kotchap,GER,DF,Southampton,20,2001,20.9,37,17,28,9,0,15,20,75.0,5,29,12,17,44,81,110,0,Premier_League,2022_2023
Saïd Benrahma,ALG,"FW,MF",West Ham,26,1995,23.0,25,15,11,7,7,11,27,40.7,16,23,1,22,9,34,13,0,Premier_League,2022_2023
Rodrigo Bentancur,URU,MF,Tottenham,25,1997,16.7,45,28,15,21,9,16,28,57.1,12,28,15,13,20,65,22,0,Premier_League,2022_2023
Daniel Bentley,ENG,GK,Wolves,29,1993,2.0,1,1,1,0,0,1,1,100.0,0,0,0,0,0,1,0,1,Premier_League,2022_2023
Victor Bernth Kristiansen,DEN,DF,Leicester City,19,2002,9.9,38,23,18,16,4,22,30,73.3,8,16,4,12,3,41,26,1,Premier_League,2022_2023
Owen Bevan,WAL,DF,Bournemouth,18,2003,0.1,0,0,0,0,0,0,0,,0,0,0,0,0,0,0,0,Premier_League,2022_2023
Giulian Biancone,FRA,DF,Nott'ham Forest,22,2000,0.2,2,1,2,0,0,1,1,100.0,0,0,0,0,1,3,0,0,Premier_League,2022_2023
Philip Billing,DEN,"MF,FW",Bournemouth,26,1996,30.7,63,36,21,33,9,11,42,26.2,31,48,8,40,31,94,58,1,Premier_League,2022_2023
Yves Bissouma,MLI,MF,Tottenham,25,1996,11.2,16,13,6,6,4,2,7,28.6,5,15,6,9,12,28,10,0,Premier_League,2022_2023
Willy Boly,CIV,DF,Nott'ham Forest,31,1991,7.6,13,6,8,3,2,8,13,61.5,5,13,4,9,12,25,45,0,Premier_League,2022_2023
Sven Botman,NED,DF,Newcastle Utd,22,2000,34.7,38,24,31,7,0,22,28,78.6,6,44,24,20,34,72,126,2,Premier_League,2022_2023
Jarrod Bowen,ENG,"FW,MF",West Ham,25,1996,35.9,39,16,14,11,14,16,58,27.6,42,47,9,38,36,75,25,0,Premier_League,2022_2023
James Bree,ENG,DF,Southampton,24,1997,4.1,5,3,4,1,0,3,4,75.0,1,3,1,2,6,11,11,0,Premier_League,2022_2023
Armando Broja,ALB,FW,Chelsea,20,2001,3.3,4,1,0,3,1,1,1,100.0,0,10,1,9,1,5,1,0,Premier_League,2022_2023
David Brooks,WAL,"FW,MF",Bournemouth,25,1997,1.9,1,0,1,0,0,0,1,0.0,1,2,0,2,2,3,5,0,Premier_League,2022_2023
Lewis Brunt,ENG,DF,Leicester City,21,2000,0.3,0,0,0,0,0,0,0,,0,0,0,0,0,0,2,0,Premier_League,2022_2023
Emi Buendía,ARG,"MF,FW",Aston Villa,25,1996,26.8,52,23,20,20,12,21,74,28.4,53,20,2,18,20,72,17,0,Premier_League,2022_2023
Hugo Bueno,ESP,DF,Wolves,19,2002,14.6,33,16,23,6,4,17,33,51.5,16,14,1,13,10,43,36,0,Premier_League,2022_2023
Facundo Buonanotte,ARG,"FW,MF",Brighton,17,2004,6.3,2,1,1,1,0,1,22,4.5,21,5,2,3,4,6,3,0,Premier_League,2022_2023
Dan Burn,ENG,DF,Newcastle Utd,30,1992,34.6,60,38,29,23,8,34,67,50.7,33,42,16,26,32,92,120,2,Premier_League,2022_2023
Cafú,POR,MF,Nott'ham Forest,29,1993,0.1,0,0,0,0,0,0,0,,0,0,0,0,0,0,1,0,Premier_League,2022_2023
Moisés Caicedo,ECU,MF,Brighton,20,2001,34.9,100,50,41,47,12,40,68,58.8,28,43,7,36,56,156,31,3,Premier_League,2022_2023
Tom Cairney,SCO,MF,Fulham,31,1991,11.0,17,6,4,8,5,7,10,70.0,3,18,3,15,5,22,3,0,Premier_League,2022_2023
Duje Ćaleta-Car,CRO,DF,Southampton,25,1996,10.5,14,10,9,4,1,6,9,66.7,3,15,11,4,15,29,65,1,Premier_League,2022_2023
Dominic Calvert-Lewin,ENG,FW,Everton,25,1997,12.9,4,2,1,0,3,1,5,20.0,4,5,1,4,3,7,18,0,Premier_League,2022_2023
Chem Campbell,WAL,"FW,MF",Wolves,19,2002,0.8,2,1,1,1,0,0,1,0.0,1,2,0,2,1,3,0,0,Premier_League,2022_2023
João Cancelo,POR,DF,Manchester City,28,1994,14.2,29,21,16,9,4,17,24,70.8,7,7,1,6,19,48,9,1,Premier_League,2022_2023
Thomas Cannon,IRL,FW,Everton,19,2002,0.3,0,0,0,0,0,0,0,,0,0,0,0,0,0,0,0,Premier_League,2022_2023
Sergi Canós,ESP,"FW,DF",Brentford,25,1997,0.9,0,0,0,0,0,0,2,0.0,2,3,1,2,0,0,1,0,Premier_League,2022_2023
Diego Carlos,BRA,DF,Aston Villa,29,1993,2.3,1,0,0,1,0,0,1,0.0,1,2,2,0,1,2,2,0,Premier_League,2022_2023
Fabio Carvalho,POR,"MF,FW",Liverpool,19,2002,3.9,8,8,3,3,2,3,6,50.0,3,6,0,6,6,14,0,0,Premier_League,2022_2023
Casemiro,BRA,MF,Manchester Utd,30,1992,23.6,88,46,43,35,10,47,92,51.1,45,49,11,38,34,122,64,0,Premier_League,2022_2023
Matty Cash,POL,DF,Aston Villa,24,1997,20.2,55,32,36,15,4,26,37,70.3,11,20,5,15,26,81,43,0,Premier_League,2022_2023
Timothy Castagne,BEL,DF,Leicester City,26,1995,36.2,87,44,53,27,7,41,84,48.8,43,50,13,37,43,130,110,0,Premier_League,2022_2023
Jonny Castro,ESP,DF,Wolves,28,1994,14.0,33,15,22,10,1,17,38,44.7,21,26,5,21,14,47,28,2,Premier_League,2022_2023
Nathaniel Chalobah,ENG,MF,Fulham,27,1994,0.1,1,1,1,0,0,1,1,100.0,0,0,0,0,0,1,2,0,Premier_League,2022_2023
Trevoh Chalobah,ENG,DF,Chelsea,23,1999,17.9,31,20,22,6,3,24,35,68.6,11,17,7,10,24,55,56,1,Premier_League,2022_2023
Calum Chambers,ENG,"DF,MF",Aston Villa,27,1995,3.9,9,6,7,2,0,6,8,75.0,2,5,4,1,7,16,10,1,Premier_League,2022_2023
Shea Charles,NIR,DF,Manchester City,18,2003,0.3,4,0,4,0,0,1,1,100.0,0,0,0,0,1,5,2,0,Premier_League,2022_2023
Ben Chilwell,ENG,"DF,MF",Chelsea,25,1996,15.6,21,17,12,8,1,13,25,52.0,12,21,2,19,18,39,26,0,Premier_League,2022_2023
Ryan Christie,SCO,"MF,FW",Bournemouth,27,1995,20.4,34,22,10,23,1,14,50,28.0,36,16,4,12,26,60,20,0,Premier_League,2022_2023
Carney Chukwuemeka,ENG,"MF,FW",Chelsea,18,2003,3.9,13,7,7,6,0,3,5,60.0,2,7,0,7,6,19,1,0,Premier_League,2022_2023
Bobby Clark,ENG,MF,Liverpool,17,2005,0.1,0,0,0,0,0,0,0,,0,2,0,2,0,0,0,0,Premier_League,2022_2023
Nathaniel Clyne,ENG,DF,Crystal Palace,31,1991,18.2,27,16,13,9,5,14,23,60.9,9,22,4,18,19,46,34,0,Premier_League,2022_2023
Conor Coady,ENG,DF,Everton,29,1993,23.3,14,9,8,6,0,7,15,46.7,8,21,17,4,14,28,88,3,Premier_League,2022_2023
Jack Colback,ENG,MF,Nott'ham Forest,32,1989,5.5,18,13,12,6,0,5,8,62.5,3,3,0,3,3,21,9,0,Premier_League,2022_2023
Séamus Coleman,IRL,DF,Everton,33,1988,18.4,35,26,21,10,4,19,29,65.5,10,14,7,7,22,57,58,2,Premier_League,2022_2023
Nathan Collins,IRL,DF,Wolves,21,2001,20.2,27,15,19,8,0,15,24,62.5,9,35,28,7,21,48,84,0,Premier_League,2022_2023
Levi Colwill,ENG,DF,Brighton,19,2003,13.6,8,7,4,4,0,4,9,44.4,5,5,3,2,15,23,37,1,Premier_League,2022_2023
Lewis Cook,ENG,MF,Bournemouth,25,1997,19.1,37,22,10,22,5,18,44,40.9,26,29,10,19,23,60,31,0,Premier_League,2022_2023
Steve Cook,ENG,DF,Nott'ham Forest,31,1991,10.6,8,4,4,4,0,5,7,71.4,2,16,11,5,12,20,51,0,Premier_League,2022_2023
Liam Cooper,SCO,DF,Leeds United,30,1991,15.8,38,23,27,9,2,23,36,63.9,13,16,8,8,34,72,57,3,Premier_League,2022_2023
Maxwel Cornet,CIV,FW,West Ham,25,1996,2.7,7,3,5,0,2,4,6,66.7,2,6,0,6,2,9,3,0,Premier_League,2022_2023
Diego Costa,ESP,FW,Wolves,33,1988,13.8,3,1,3,0,0,2,9,22.2,7,6,1,5,2,5,17,0,Premier_League,2022_2023
Vladimír Coufal,CZE,DF,West Ham,29,1992,23.7,58,31,37,15,6,36,51,70.6,15,24,6,18,38,96,70,0,Premier_League,2022_2023
Philippe Coutinho,BRA,"MF,FW",Aston Villa,30,1992,8.8,19,14,8,8,3,9,15,60.0,6,11,1,10,4,23,2,0,Premier_League,2022_2023
Conor Coventry,IRL,"MF,FW",West Ham,22,2000,0.0,0,0,0,0,0,0,0,,0,0,0,0,0,0,0,0,Premier_League,2022_2023
Matthew Craig,SCO,MF,Tottenham,19,2003,0.2,4,1,2,2,0,0,0,,0,0,0,0,0,4,0,0,Premier_League,2022_2023
Aaron Cresswell,ENG,DF,West Ham,32,1989,24.8,21,11,12,7,2,12,31,38.7,19,21,11,10,27,48,56,0,Premier_League,2022_2023
Marc Cucurella,ESP,DF,Chelsea,24,1998,18.6,66,33,40,15,11,30,60,50.0,30,28,8,20,16,82,48,1,Premier_League,2022_2023
Matheus Cunha,BRA,FW,Wolves,23,1999,10.7,7,4,0,5,2,2,10,20.0,8,15,3,12,9,16,11,0,Premier_League,2022_2023
Patson Daka,ZAM,FW,Leicester City,23,1998,13.2,14,8,6,8,0,3,13,23.1,10,14,2,12,7,21,7,0,Premier_League,2022_2023
Diogo Dalot,POR,DF,Manchester Utd,23,1999,23.9,54,41,40,13,1,33,45,73.3,12,25,7,18,37,91,55,2,Premier_League,2022_2023
Mikkel Damsgaard,DEN,"MF,FW",Brentford,22,2000,11.0,31,21,13,13,5,15,42,35.7,27,20,2,18,10,41,14,0,Premier_League,2022_2023
Danilo,BRA,MF,Nott'ham Forest,21,2001,10.8,18,7,7,9,2,6,25,24.0,19,26,6,20,9,27,19,0,Premier_League,2022_2023
Arnaut Danjuma,NED,"FW,MF",Tottenham,25,1997,1.9,2,0,1,1,0,0,0,,0,1,0,1,0,2,0,0,Premier_League,2022_2023
Josh Dasilva,ENG,MF,Brentford,23,1998,15.4,18,9,6,6,6,6,16,37.5,10,22,6,16,5,23,7,1,Premier_League,2022_2023
David Datro Fofana,CIV,FW,Chelsea,19,2002,0.8,3,1,1,1,1,1,1,100.0,0,1,0,1,0,3,0,0,Premier_League,2022_2023
Ben Davies,WAL,DF,Tottenham,29,1993,25.4,28,11,13,13,2,14,26,53.8,12,17,8,9,18,46,72,0,Premier_League,2022_2023
Tom Davies,ENG,MF,Everton,24,1998,6.0,15,9,5,9,1,7,14,50.0,7,10,1,9,4,19,7,1,Premier_League,2022_2023
Craig Dawson,ENG,DF,West Ham,32,1990,8.0,11,7,9,2,0,5,7,71.4,2,9,6,3,6,17,26,0,Premier_League,2022_2023
Craig Dawson,ENG,DF,Wolves,32,1990,15.7,9,6,6,3,0,4,7,57.1,3,31,23,8,12,21,74,2,Premier_League,2022_2023
Kevin De Bruyne,BEL,MF,Manchester City,31,1991,26.9,28,12,3,12,13,14,39,35.9,25,27,2,25,9,37,10,0,Premier_League,2022_2023
Siriki Dembélé,CIV,"FW,MF",Bournemouth,25,1996,1.2,3,1,2,1,0,0,1,0.0,1,1,0,1,1,4,1,0,Premier_League,2022_2023
Leander Dendoncker,BEL,MF,Aston Villa,27,1995,7.7,19,9,11,6,2,11,22,50.0,11,19,4,15,10,29,12,0,Premier_League,2022_2023
Leander Dendoncker,BEL,MF,Wolves,27,1995,2.4,4,2,0,3,1,2,3,66.7,1,2,0,2,9,13,4,0,Premier_League,2022_2023
Emmanuel Dennis,NGA,"FW,MF",Nott'ham Forest,24,1997,8.0,17,11,5,5,7,8,18,44.4,10,13,1,12,2,19,6,0,Premier_League,2022_2023
Halil Dervişoğlu,TUR,MF,Brentford,22,1999,0.1,0,0,0,0,0,0,1,0.0,1,0,0,0,0,0,0,0,Premier_League,2022_2023
Kiernan Dewsbury-Hall,ENG,MF,Leicester City,23,1998,25.6,53,29,14,34,5,19,47,40.4,28,55,13,42,28,81,21,0,Premier_League,2022_2023
Ibrahima Diallo,FRA,MF,Southampton,23,1999,9.1,25,15,14,10,1,8,14,57.1,6,11,1,10,6,31,11,0,Premier_League,2022_2023
Rúben Dias,POR,DF,Manchester City,25,1997,22.2,21,13,10,10,1,11,18,61.1,7,21,13,8,18,39,56,1,Premier_League,2022_2023
Luis Díaz,COL,FW,Liverpool,25,1997,11.1,17,11,4,8,5,8,15,53.3,7,8,0,8,6,23,2,0,Premier_League,2022_2023
Eric Dier,ENG,DF,Tottenham,28,1994,31.3,30,19,16,12,2,9,19,47.4,10,41,24,17,35,65,112,2,Premier_League,2022_2023
Lucas Digne,FRA,DF,Aston Villa,29,1993,16.7,30,12,20,9,1,20,33,60.6,13,18,5,13,18,48,45,0,Premier_League,2022_2023
Issa Diop,FRA,DF,Fulham,25,1997,22.4,28,19,18,9,1,17,32,53.1,15,24,17,7,35,63,86,0,Premier_League,2022_2023
Moussa Djenepo,MLI,"DF,FW",Southampton,24,1998,7.9,19,11,13,5,1,11,27,40.7,16,19,2,17,11,30,7,0,Premier_League,2022_2023
Ben Doak,SCO,FW,Liverpool,16,2005,0.3,3,2,1,2,0,1,1,100.0,0,1,0,1,0,3,0,0,Premier_League,2022_2023
Matt Doherty,IRL,"DF,MF",Tottenham,30,1992,7.4,16,10,12,3,1,8,10,80.0,2,11,6,5,8,24,14,1,Premier_League,2022_2023
Abdoulaye Doucouré,MLI,MF,Everton,29,1993,17.0,31,20,9,15,7,12,37,32.4,25,26,3,23,13,44,11,0,Premier_League,2022_2023
Cheick Doucouré,MLI,MF,Crystal Palace,22,2000,30.8,77,46,40,33,4,29,52,55.8,23,47,13,34,56,133,48,0,Premier_League,2022_2023
Flynn Downes,ENG,MF,West Ham,23,1999,8.5,16,9,4,10,2,6,12,50.0,6,15,2,13,7,23,6,0,Premier_League,2022_2023
Kami Doyle,ENG,MF,Southampton,16,2005,0.1,0,0,0,0,0,0,0,,0,0,0,0,0,0,0,0,Premier_League,2022_2023
Cody Drameh,ENG,DF,Leeds United,20,2001,0.8,5,4,0,4,1,2,3,66.7,1,0,0,0,1,6,1,0,Premier_League,2022_2023
Martin Dúbravka,SVK,GK,Newcastle Utd,33,1989,1.7,0,0,0,0,0,0,1,0.0,1,0,0,0,0,0,1,0,Premier_League,2022_2023
Shane Duffy,IRL,"DF,FW",Fulham,30,1992,0.2,0,0,0,0,0,0,0,,0,0,0,0,0,0,0,1,Premier_League,2022_2023
Lewis Dunk,ENG,DF,Brighton,30,1991,36.0,30,19,19,9,2,18,41,43.9,23,37,27,10,34,64,81,1,Premier_League,2022_2023
Jhon Durán,COL,"FW,MF",Aston Villa,18,2003,1.5,2,2,0,1,1,1,4,25.0,3,0,0,0,2,4,2,0,Premier_League,2022_2023
Malcolm Ebiowei,ENG,"MF,FW",Crystal Palace,18,2003,0.4,1,1,1,0,0,0,1,0.0,1,2,0,2,0,1,0,0,Premier_League,2022_2023
Ederson,BRA,GK,Manchester City,28,1993,35.0,3,1,3,0,0,1,2,50.0,1,0,0,0,1,4,10,2,Premier_League,2022_2023
Odsonne Édouard,FRA,FW,Crystal Palace,24,1998,20.0,25,13,7,12,6,7,13,53.8,6,17,5,12,3,28,22,0,Premier_League,2022_2023
Samuel Edozie,ENG,"FW,MF",Southampton,19,2003,6.3,17,10,6,10,1,3,8,37.5,5,7,0,7,6,23,6,0,Premier_League,2022_2023
Anthony Elanga,SWE,FW,Manchester Utd,20,2002,4.7,3,0,0,2,1,1,2,50.0,1,4,0,4,2,5,4,0,Premier_League,2022_2023
Harvey Elliott,ENG,"MF,FW",Liverpool,19,2003,17.9,27,18,6,12,9,9,37,24.3,28,26,1,25,15,42,8,0,Premier_League,2022_2023
Mohamed Elneny,EGY,MF,Arsenal,30,1992,1.3,1,1,1,0,0,1,1,100.0,0,0,0,0,0,1,0,0,Premier_League,2022_2023
Mohamed Elyounoussi,NOR,"MF,FW",Southampton,27,1994,24.1,46,28,22,20,4,19,44,43.2,25,40,3,37,27,73,37,0,Premier_League,2022_2023
Emerson,BRA,DF,Tottenham,23,1999,19.3,54,33,38,12,4,27,40,67.5,13,17,3,14,18,72,75,0,Premier_League,2022_2023
Julio Enciso,PAR,"FW,MF",Brighton,18,2004,9.0,13,4,3,6,4,8,13,61.5,5,9,0,9,4,17,2,0,Premier_League,2022_2023
Christian Eriksen,DEN,MF,Manchester Utd,30,1992,22.8,22,18,10,7,5,10,33,30.3,23,23,9,14,11,33,20,1,Premier_League,2022_2023
Pervis Estupiñán,ECU,DF,Brighton,24,1998,29.7,61,31,36,19,6,35,60,58.3,25,30,8,22,37,98,37,1,Premier_League,2022_2023
Jonny Evans,NIR,DF,Leicester City,34,1988,11.7,13,5,12,1,0,7,11,63.6,4,15,11,4,18,31,51,0,Premier_League,2022_2023
Eberechi Eze,ENG,"MF,FW",Crystal Palace,24,1998,29.3,42,24,17,18,7,18,38,47.4,20,22,0,22,13,55,10,0,Premier_League,2022_2023
Łukasz Fabiański,POL,GK,West Ham,37,1985,34.6,2,0,2,0,0,1,2,50.0,1,1,0,1,0,2,10,1,Premier_League,2022_2023
Fabinho,BRA,MF,Liverpool,28,1993,29.7,65,38,18,40,7,24,62,38.7,38,38,11,27,37,102,40,0,Premier_League,2022_2023
Wout Faes,BEL,DF,Leicester City,24,1998,31.0,56,33,28,26,2,28,44,63.6,16,53,37,16,41,97,113,2,Premier_League,2022_2023
Felipe,BRA,DF,Nott'ham Forest,33,1989,15.8,42,23,29,13,0,24,41,58.5,17,34,13,21,36,78,90,0,Premier_League,2022_2023
João Félix,POR,"FW,MF",Chelsea,22,1999,10.5,14,7,5,6,3,4,12,33.3,8,3,0,3,1,15,1,1,Premier_League,2022_2023
Evan Ferguson,IRL,FW,Brighton,17,2004,10.6,6,3,1,3,2,1,7,14.3,6,11,1,10,2,8,6,0,Premier_League,2022_2023
Bruno Fernandes,POR,"MF,FW",Manchester Utd,27,1994,36.8,68,42,24,25,19,30,71,42.3,41,37,5,32,25,93,40,1,Premier_League,2022_2023
Enzo Fernández,ARG,MF,Chelsea,21,2001,17.2,45,27,25,17,3,21,56,37.5,35,32,2,30,16,61,12,1,Premier_League,2022_2023
Roberto Firmino,BRA,"FW,MF",Liverpool,30,1991,13.5,17,12,2,12,3,4,22,18.2,18,16,1,15,7,24,2,0,Premier_League,2022_2023
Junior Firpo,DOM,DF,Leeds United,25,1996,15.2,47,25,27,15,5,24,46,52.2,22,23,7,16,24,71,40,0,Premier_League,2022_2023
Phil Foden,ENG,FW,Manchester City,22,2000,20.5,16,10,9,5,2,8,19,42.1,11,25,2,23,5,21,12,0,Premier_League,2022_2023
Wesley Fofana,FRA,DF,Leicester City,21,2000,2.0,4,2,1,2,1,1,3,33.3,2,1,1,0,9,13,5,0,Premier_League,2022_2023
Wesley Fofana,FRA,DF,Chelsea,21,2000,13.1,30,18,19,7,4,13,26,50.0,13,17,10,7,20,50,33,2,Premier_League,2022_2023
Pablo Fornals,ESP,"FW,MF",West Ham,26,1996,16.7,30,15,9,12,9,13,34,38.2,21,16,2,14,14,44,9,0,Premier_League,2022_2023
Adam Forshaw,ENG,MF,Leeds United,30,1991,5.3,12,9,5,7,0,7,17,41.2,10,9,1,8,4,16,2,0,Premier_League,2022_2023
Fraser Forster,ENG,GK,Tottenham,34,1988,13.5,1,0,1,0,0,0,0,,0,1,0,1,0,1,3,1,Premier_League,2022_2023
Tyrese Francois,AUS,FW,Fulham,22,2000,0.0,0,0,0,0,0,0,1,0.0,1,0,0,0,0,0,1,0,Premier_League,2022_2023
Ryan Fraser,SCO,FW,Newcastle Utd,28,1994,3.5,2,2,0,0,2,2,5,40.0,3,3,1,2,0,2,3,0,Premier_League,2022_2023
Fred,BRA,MF,Manchester Utd,29,1993,13.9,47,30,24,20,3,15,38,39.5,23,38,2,36,19,66,19,0,Premier_League,2022_2023
Ryan Fredericks,ENG,DF,Bournemouth,29,1992,5.9,3,2,2,0,1,1,4,25.0,3,7,2,5,1,4,27,0,Premier_League,2022_2023
Remo Freuler,SUI,MF,Nott'ham Forest,30,1992,24.0,43,23,23,15,5,19,43,44.2,24,36,9,27,29,72,45,0,Premier_League,2022_2023
Cody Gakpo,NED,"FW,MF",Liverpool,23,1999,16.2,26,15,4,13,9,13,38,34.2,25,13,1,12,4,30,2,0,Premier_League,2022_2023
Conor Gallagher,ENG,MF,Chelsea,22,2000,18.0,46,33,17,19,10,10,37,27.0,27,41,10,31,23,69,18,1,Premier_League,2022_2023
Idrissa Gana Gueye,SEN,MF,Everton,32,1989,28.6,97,57,49,35,13,31,62,50.0,31,50,12,38,56,153,34,3,Premier_League,2022_2023
Alejandro Garnacho,ARG,"FW,MF",Manchester Utd,18,2004,6.3,5,2,2,0,3,1,11,9.1,10,5,0,5,5,10,3,0,Premier_League,2022_2023
James Garner,ENG,"MF,DF",Everton,21,2001,8.9,16,13,4,8,4,9,19,47.4,10,9,1,8,12,28,13,0,Premier_League,2022_2023
David de Gea,ESP,GK,Manchester Utd,31,1990,38.0,0,0,0,0,0,0,1,0.0,1,0,0,0,1,1,15,3,Premier_League,2022_2023
Joe Gelhardt,ENG,FW,Leeds United,20,2002,2.4,6,2,1,3,2,3,5,60.0,2,5,0,5,0,6,4,0,Premier_League,2022_2023
Saman Ghoddos,IRN,"MF,FW",Brentford,28,1993,1.5,2,1,0,1,1,1,3,33.3,2,5,1,4,4,6,2,0,Premier_League,2022_2023
Morgan Gibbs-White,ENG,"FW,MF",Wolves,22,2000,2.0,3,1,3,0,0,2,4,50.0,2,2,0,2,1,4,3,0,Premier_League,2022_2023
Morgan Gibbs-White,ENG,"MF,FW",Nott'ham Forest,22,2000,33.0,26,14,7,7,12,11,33,33.3,22,23,4,19,14,40,15,0,Premier_League,2022_2023
Bryan Gil,ESP,"MF,FW",Tottenham,21,2001,1.6,3,1,3,0,0,0,3,0.0,3,3,0,3,1,4,1,0,Premier_League,2022_2023
Billy Gilmour,SCO,MF,Brighton,21,2001,5.6,5,2,2,2,1,2,8,25.0,6,5,2,3,6,11,5,0,Premier_League,2022_2023
Wilfried Gnonto,ITA,"FW,MF",Leeds United,18,2003,15.0,27,17,7,15,5,10,30,33.3,20,24,1,23,5,32,7,0,Premier_League,2022_2023
Ben Godfrey,ENG,DF,Everton,24,1998,8.9,20,11,13,5,2,11,29,37.9,18,12,6,6,8,28,33,1,Premier_League,2022_2023
João Gomes,BRA,MF,Wolves,21,2001,7.3,29,13,14,14,1,13,23,56.5,10,12,3,9,4,33,11,0,Premier_League,2022_2023
Toti Gomes,POR,DF,Wolves,23,1999,10.9,15,9,11,4,0,9,13,69.2,4,16,8,8,11,26,51,0,Premier_League,2022_2023
Joe Gomez,ENG,DF,Liverpool,25,1997,16.3,28,21,15,11,2,11,19,57.9,8,17,11,6,24,52,51,2,Premier_League,2022_2023
Sergio Gómez,ESP,"DF,MF",Manchester City,21,2000,3.9,9,4,6,1,2,5,8,62.5,3,5,3,2,2,11,9,1,Premier_League,2022_2023
Anthony Gordon,ENG,"FW,MF",Newcastle Utd,21,2001,5.4,14,12,5,7,2,9,20,45.0,11,9,1,8,2,16,1,1,Premier_League,2022_2023
Anthony Gordon,ENG,FW,Everton,21,2001,12.2,34,22,17,10,7,8,24,33.3,16,19,0,19,4,38,11,0,Premier_League,2022_2023
Demarai Gray,JAM,"FW,MF",Everton,26,1996,27.9,33,24,9,14,10,17,31,54.8,14,23,3,20,13,46,18,0,Premier_League,2022_2023
Jack Grealish,ENG,FW,Manchester City,26,1995,22.8,25,16,10,12,3,13,23,56.5,10,17,3,14,7,32,9,0,Premier_League,2022_2023
Sam Greenwood,ENG,"MF,FW",Leeds United,20,2002,4.7,15,7,7,8,0,8,21,38.1,13,10,2,8,1,16,1,0,Premier_League,2022_2023
Pascal Groß,GER,"MF,DF",Brighton,31,1991,36.0,59,38,23,27,9,25,55,45.5,30,32,10,22,13,72,21,1,Premier_League,2022_2023
Vicente Guaita,ESP,GK,Crystal Palace,35,1987,27.0,0,0,0,0,0,0,0,,0,0,0,0,0,0,9,1,Premier_League,2022_2023
Gonçalo Guedes,POR,"FW,MF",Wolves,25,1996,7.9,8,6,4,3,1,5,8,62.5,3,4,0,4,1,9,2,0,Premier_League,2022_2023
Marc Guéhi,ENG,DF,Crystal Palace,22,2000,37.0,52,27,39,11,2,26,42,61.9,16,45,24,21,45,97,134,3,Premier_League,2022_2023
Bruno Guimarães,BRA,MF,Newcastle Utd,24,1997,30.3,78,40,27,46,5,38,65,58.5,27,28,4,24,36,114,22,1,Premier_League,2022_2023
İlkay Gündoğan,GER,MF,Manchester City,31,1990,26.1,30,18,7,13,10,12,34,35.3,22,18,3,15,20,50,13,0,Premier_League,2022_2023
Darko Gyabi,ENG,FW,Leeds United,18,2004,0.1,2,2,1,1,0,0,0,,0,2,0,2,0,2,0,0,Premier_League,2022_2023
Erling Haaland,NOR,FW,Manchester City,22,2000,30.8,3,2,0,2,1,1,5,20.0,4,12,4,8,3,6,14,0,Premier_League,2022_2023
Lewis Hall,ENG,DF,Chelsea,17,2004,7.3,23,12,19,4,0,15,22,68.2,7,8,0,8,11,34,11,1,Premier_League,2022_2023
Luke Harris,WAL,"MF,FW",Fulham,17,2005,0.1,0,0,0,0,0,0,0,,0,0,0,0,0,0,0,0,Premier_League,2022_2023
Jack Harrison,ENG,"FW,MF",Leeds United,25,1996,30.1,41,17,5,15,21,12,52,23.1,40,47,2,45,22,63,25,0,Premier_League,2022_2023
Kai Havertz,GER,"FW,MF",Chelsea,23,1999,28.5,34,16,4,20,10,10,30,33.3,20,28,0,28,7,41,41,0,Premier_League,2022_2023
Jan Paul van Hecke,NED,DF,Brighton,22,2000,3.3,8,6,3,4,1,5,5,100.0,0,8,5,3,6,14,9,0,Premier_League,2022_2023
Hwang Hee-chan,KOR,"FW,MF",Wolves,26,1996,12.6,20,9,7,8,5,6,20,30.0,14,18,2,16,5,25,5,0,Premier_League,2022_2023
Dean Henderson,ENG,GK,Nott'ham Forest,25,1997,18.0,0,0,0,0,0,0,0,,0,0,0,0,0,0,12,1,Premier_League,2022_2023
Jordan Henderson,ENG,MF,Liverpool,32,1990,23.0,32,23,10,18,4,15,36,41.7,21,21,3,18,21,53,16,1,Premier_League,2022_2023
Wayne Hennessey,WAL,GK,Nott'ham Forest,35,1987,3.0,1,0,1,0,0,1,1,100.0,0,0,0,0,0,1,2,0,Premier_League,2022_2023
Rico Henry,ENG,DF,Brentford,25,1997,36.0,57,31,20,28,9,22,41,53.7,19,29,8,21,30,87,84,1,Premier_League,2022_2023
Son Heung-min,KOR,"MF,FW",Tottenham,30,1992,32.1,24,12,7,8,9,9,30,30.0,21,23,2,21,13,37,6,0,Premier_League,2022_2023
Aaron Hickey,SCO,DF,Brentford,20,2002,21.3,38,26,27,11,0,18,32,56.3,14,18,7,11,17,55,32,1,Premier_League,2022_2023
Jack Hinshelwood,ENG,FW,Brighton,17,2005,0.0,1,0,1,0,0,0,0,,0,0,0,0,0,1,0,0,Premier_League,2022_2023
Joseph Hodge,IRL,MF,Wolves,19,2002,1.9,5,2,1,3,1,3,4,75.0,1,5,0,5,0,5,2,1,Premier_League,2022_2023
Rob Holding,ENG,DF,Arsenal,26,1995,6.3,8,5,4,4,0,3,6,50.0,3,6,5,1,3,11,27,1,Premier_League,2022_2023
Mason Holgate,ENG,DF,Everton,25,1996,5.6,11,7,8,3,0,3,11,27.3,8,7,3,4,7,18,28,0,Premier_League,2022_2023
Will Hughes,ENG,MF,Crystal Palace,27,1995,9.4,29,16,11,16,2,11,20,55.0,9,16,7,9,16,45,9,0,Premier_League,2022_2023
Omari Hutchinson,ENG,FW,Chelsea,18,2003,0.3,0,0,0,0,0,0,0,,0,0,0,0,1,1,0,0,Premier_League,2022_2023
Pierre Højbjerg,DEN,MF,Tottenham,26,1995,34.8,56,30,28,22,6,26,67,38.8,41,46,17,29,49,105,64,1,Premier_League,2022_2023
Kelechi Iheanacho,NGA,"FW,MF",Leicester City,25,1996,12.5,7,2,0,3,4,3,10,30.0,7,9,1,8,0,7,8,0,Premier_League,2022_2023
Danny Ings,ENG,FW,West Ham,30,1992,8.6,9,8,0,4,5,5,14,35.7,9,8,2,6,3,12,5,0,Premier_League,2022_2023
Danny Ings,ENG,FW,Aston Villa,30,1992,9.2,10,5,1,6,3,1,6,16.7,5,12,1,11,1,11,11,0,Premier_League,2022_2023
Alexander Isak,SWE,FW,Newcastle Utd,22,1999,16.9,18,8,4,7,7,10,28,35.7,18,21,2,19,4,22,8,0,Premier_League,2022_2023
Daniel Iversen,DEN,GK,Leicester City,25,1997,12.0,0,0,0,0,0,0,0,,0,0,0,0,0,0,6,1,Premier_League,2022_2023
Alex Iwobi,NGA,"MF,FW",Everton,26,1996,37.5,69,37,37,28,4,33,65,50.8,32,41,2,39,25,94,29,0,Premier_League,2022_2023
Daniel James,WAL,FW,Leeds United,24,1997,2.2,6,2,1,3,2,3,6,50.0,3,4,0,4,2,8,2,0,Premier_League,2022_2023
Daniel James,WAL,FW,Fulham,24,1997,6.9,10,6,4,5,1,4,9,44.4,5,5,1,4,1,11,5,0,Premier_League,2022_2023
Reece James,ENG,"DF,MF",Chelsea,22,1999,13.8,31,20,10,18,3,15,19,78.9,4,17,2,15,12,43,23,0,Premier_League,2022_2023
Vitaly Janelt,GER,"MF,DF",Brentford,24,1998,24.5,54,27,20,24,10,21,49,42.9,28,29,9,20,29,83,26,0,Premier_League,2022_2023
Pontus Jansson,SWE,DF,Brentford,31,1991,8.0,5,3,4,1,0,3,5,60.0,2,13,9,4,9,14,38,0,Premier_League,2022_2023
Mathias Jensen,DEN,MF,Brentford,26,1996,31.1,71,36,29,30,12,34,97,35.1,63,54,5,49,32,103,24,1,Premier_League,2022_2023
Gabriel Jesus,BRA,FW,Arsenal,25,1997,22.9,33,25,16,8,9,15,31,48.4,16,27,3,24,11,44,15,1,Premier_League,2022_2023
Raúl Jiménez,MEX,FW,Wolves,31,1991,9.4,9,6,3,5,1,3,6,50.0,3,9,0,9,0,9,8,0,Premier_League,2022_2023
Joelinton,BRA,"MF,FW",Newcastle Utd,25,1996,29.6,70,49,36,26,8,26,62,41.9,36,52,7,45,48,118,39,0,Premier_League,2022_2023
Ben Johnson,ENG,DF,West Ham,22,2000,9.6,20,14,12,4,4,12,18,66.7,6,12,4,8,9,29,28,1,Premier_League,2022_2023
Brennan Johnson,WAL,"FW,MF",Nott'ham Forest,21,2001,32.6,34,20,18,8,8,8,29,27.6,21,30,1,29,5,39,7,1,Premier_League,2022_2023
Sam Johnstone,ENG,GK,Crystal Palace,29,1993,9.0,0,0,0,0,0,0,0,,0,0,0,0,0,0,5,0,Premier_League,2022_2023
Curtis Jones,ENG,MF,Liverpool,21,2001,11.5,34,17,8,12,14,18,31,58.1,13,12,2,10,3,37,9,0,Premier_League,2022_2023
Jorginho,ITA,MF,Arsenal,30,1991,9.5,18,13,6,10,2,5,24,20.8,19,7,2,5,9,27,8,0,Premier_League,2022_2023
Jorginho,ITA,MF,Chelsea,30,1991,14.2,42,23,22,14,6,22,46,47.8,24,18,3,15,21,63,7,0,Premier_League,2022_2023
Mateo Joseph,ESP,"FW,MF",Leeds United,18,2003,0.3,0,0,0,0,0,0,0,,0,1,0,1,0,0,1,0,Premier_League,2022_2023
Diogo Jota,POR,FW,Liverpool,25,1996,12.6,23,15,8,8,7,12,37,32.4,25,5,0,5,3,26,11,0,Premier_League,2022_2023
Hamed Junior Traorè,CIV,"FW,MF",Bournemouth,22,2000,4.7,17,11,5,9,3,6,18,33.3,12,9,0,9,2,19,1,0,Premier_League,2022_2023
James Justin,ENG,DF,Leicester City,24,1998,13.9,20,18,7,12,1,9,18,50.0,9,24,6,18,15,35,47,0,Premier_League,2022_2023
Mathias Jørgensen,DEN,DF,Brentford,32,1990,12.3,17,8,9,8,0,9,21,42.9,12,19,12,7,16,33,39,1,Premier_League,2022_2023
Sasa Kalajdzic,AUT,FW,Wolves,25,1997,0.5,0,0,0,0,0,0,0,,0,0,0,0,1,1,0,0,Premier_League,2022_2023
Boubacar Kamara,FRA,MF,Aston Villa,22,1999,19.7,58,25,25,23,10,27,56,48.2,29,38,12,26,19,77,24,3,Premier_League,2022_2023
Harry Kane,ENG,FW,Tottenham,29,1993,37.8,15,12,1,6,8,7,21,33.3,14,27,7,20,2,17,18,0,Premier_League,2022_2023
N'Golo Kanté,FRA,MF,Chelsea,31,1991,5.8,16,10,4,10,2,4,8,50.0,4,11,0,11,6,22,2,0,Premier_League,2022_2023
Michael Keane,ENG,DF,Everton,29,1993,10.9,7,4,5,2,0,5,8,62.5,3,12,7,5,14,21,55,1,Premier_League,2022_2023
Neeskens Kebano,COD,FW,Fulham,30,1992,8.5,17,9,8,6,3,9,18,50.0,9,14,0,14,1,18,8,0,Premier_League,2022_2023
Thilo Kehrer,GER,DF,West Ham,25,1996,24.8,43,24,25,14,4,21,45,46.7,24,16,6,10,34,77,76,1,Premier_League,2022_2023
Naby Keïta,GUI,MF,Liverpool,27,1995,3.3,5,4,2,3,0,1,4,25.0,3,1,0,1,2,7,3,0,Premier_League,2022_2023
Caoimhín Kelleher,IRL,GK,Liverpool,23,1998,1.0,0,0,0,0,0,0,0,,0,0,0,0,0,0,0,0,Premier_League,2022_2023
Lloyd Kelly,ENG,DF,Bournemouth,23,1998,22.7,33,18,23,9,1,13,19,68.4,6,26,15,11,26,59,101,1,Premier_League,2022_2023
Max Kilman,ENG,DF,Wolves,25,1997,36.7,36,20,26,9,1,16,30,53.3,14,70,42,28,19,55,164,1,Premier_League,2022_2023
Jakub Kiwior,POL,DF,Arsenal,22,2000,4.7,7,5,6,1,0,5,8,62.5,3,5,3,2,6,13,10,0,Premier_League,2022_2023
Mateusz Klich,POL,"MF,FW",Leeds United,32,1990,3.1,12,8,3,4,5,7,13,53.8,6,4,0,4,0,12,1,0,Premier_League,2022_2023
Robin Koch,GER,DF,Leeds United,26,1996,35.3,53,30,32,16,5,24,56,42.9,32,44,21,23,43,96,152,1,Premier_League,2022_2023
Ibrahima Konaté,FRA,DF,Liverpool,23,1999,17.2,38,26,25,13,0,16,27,59.3,11,12,5,7,26,64,61,4,Premier_League,2022_2023
Ezri Konsa,ENG,DF,Aston Villa,24,1997,36.9,42,20,25,15,2,18,26,69.2,8,41,23,18,26,68,120,3,Premier_League,2022_2023
Kalidou Koulibaly,SEN,DF,Chelsea,31,1991,20.0,45,31,34,8,3,26,40,65.0,14,30,13,17,29,74,77,0,Premier_League,2022_2023
Cheikhou Kouyaté,SEN,MF,Nott'ham Forest,32,1989,9.8,29,21,18,8,3,9,13,69.2,4,14,2,12,10,39,24,0,Premier_League,2022_2023
Mateo Kovačić,CRO,MF,Chelsea,28,1994,19.0,36,24,16,14,6,14,36,38.9,22,10,1,9,19,55,16,0,Premier_League,2022_2023
Emil Krafth,SWE,DF,Newcastle Utd,27,1994,0.0,0,0,0,0,0,0,0,,0,0,0,0,0,0,0,0,Premier_League,2022_2023
Rasmus Kristensen,DEN,DF,Leeds United,25,1997,21.8,62,35,35,21,6,42,76,55.3,34,32,14,18,35,97,61,0,Premier_League,2022_2023
Dejan Kulusevski,SWE,"MF,FW",Tottenham,22,2000,23.0,38,15,23,7,8,16,44,36.4,28,19,0,19,13,51,7,0,Premier_League,2022_2023
Layvin Kurzawa,FRA,DF,Fulham,29,1992,1.5,3,2,1,1,1,3,3,100.0,0,1,1,0,2,5,4,0,Premier_League,2022_2023
Adam Lallana,ENG,"MF,FW",Brighton,34,1988,8.0,9,4,6,2,1,0,7,0.0,7,6,0,6,2,11,1,0,Premier_League,2022_2023
Tariq Lamptey,GHA,DF,Brighton,21,2000,5.0,11,6,6,4,1,5,7,71.4,2,7,3,4,7,18,2,0,Premier_League,2022_2023
Manuel Lanzini,ARG,"MF,FW",West Ham,29,1993,2.8,2,2,1,1,0,2,6,33.3,4,2,0,2,2,4,0,0,Premier_League,2022_2023
Aymeric Laporte,ESP,DF,Manchester City,28,1994,11.0,11,8,6,4,1,7,11,63.6,4,10,4,6,3,14,30,1,Premier_League,2022_2023
Juan Larios,ESP,DF,Southampton,18,2004,1.7,7,6,6,1,0,5,5,100.0,0,2,0,2,3,10,4,0,Premier_League,2022_2023
Jamaal Lascelles,ENG,DF,Newcastle Utd,28,1993,2.4,1,0,1,0,0,1,1,100.0,0,3,2,1,0,1,17,0,Premier_League,2022_2023
Roméo Lavia,BEL,MF,Southampton,18,2004,24.7,60,35,27,29,4,21,53,39.6,32,47,11,36,33,93,23,1,Premier_League,2022_2023
Dexter Lembikisa,JAM,DF,Wolves,18,2003,0.3,0,0,0,0,0,0,0,,0,0,0,0,0,0,0,0,Premier_League,2022_2023
Mario Lemina,GAB,MF,Wolves,28,1993,14.4,38,24,22,13,3,20,38,52.6,18,26,8,18,14,52,24,1,Premier_League,2022_2023
Clément Lenglet,FRA,DF,Tottenham,27,1995,22.4,38,23,18,15,5,16,34,47.1,18,26,11,15,18,56,68,2,Premier_League,2022_2023
Bernd Leno,GER,GK,Fulham,30,1992,36.0,0,0,0,0,0,0,3,0.0,3,0,0,0,0,0,18,1,Premier_League,2022_2023
Jefferson Lerma,COL,MF,Bournemouth,27,1994,36.1,50,30,23,23,4,20,45,44.4,25,32,15,17,47,97,91,2,Premier_League,2022_2023
Jamal Lewis,NIR,"DF,FW",Newcastle Utd,24,1998,0.1,0,0,0,0,0,0,0,,0,0,0,0,0,0,0,0,Premier_League,2022_2023
Rico Lewis,ENG,"DF,MF",Manchester City,17,2004,10.0,16,9,9,5,2,6,11,54.5,5,8,4,4,6,22,13,1,Premier_League,2022_2023
Keane Lewis-Potter,ENG,"FW,MF",Brentford,21,2001,3.6,1,0,0,1,0,0,0,,0,5,1,4,0,1,2,0,Premier_League,2022_2023
Victor Lindelöf,SWE,DF,Manchester Utd,28,1994,15.2,22,17,10,9,3,9,17,52.9,8,18,9,9,21,43,63,1,Premier_League,2022_2023
Jesse Lingard,ENG,"FW,MF",Nott'ham Forest,29,1992,10.3,4,4,2,2,0,1,7,14.3,6,11,0,11,5,9,4,0,Premier_League,2022_2023
Valentino Livramento,ENG,"DF,FW",Southampton,19,2002,0.3,2,1,2,0,0,0,0,,0,0,0,0,2,4,3,0,Premier_League,2022_2023
Diego Llorente,ESP,DF,Leeds United,28,1993,7.2,13,10,8,5,0,4,8,50.0,4,6,2,4,15,28,24,2,Premier_League,2022_2023
Hugo Lloris,FRA,GK,Tottenham,35,1986,24.5,1,1,1,0,0,1,3,33.3,2,0,0,0,1,2,13,5,Premier_League,2022_2023
Renan Lodi,BRA,DF,Nott'ham Forest,24,1998,24.6,52,39,38,8,6,33,66,50.0,33,25,6,19,33,85,74,0,Premier_League,2022_2023
Ruben Loftus-Cheek,ENG,"MF,DF",Chelsea,26,1996,17.1,25,14,8,14,3,12,22,54.5,10,15,2,13,12,37,23,0,Premier_League,2022_2023
Sean Longstaff,ENG,MF,Newcastle Utd,24,1997,28.0,42,21,16,20,6,20,52,38.5,32,35,8,27,16,58,23,0,Premier_League,2022_2023
Jamal Lowe,JAM,"MF,FW",Bournemouth,28,1994,0.1,0,0,0,0,0,0,0,,0,0,0,0,0,0,0,0,Premier_League,2022_2023
Douglas Luiz,BRA,MF,Aston Villa,24,1998,32.5,72,42,31,32,9,29,63,46.0,34,36,7,29,40,112,27,2,Premier_League,2022_2023
Saša Lukić,SRB,MF,Fulham,25,1996,4.6,8,3,1,4,3,3,7,42.9,4,6,2,4,5,13,3,0,Premier_League,2022_2023
Lyanco,BRA,DF,Southampton,25,1997,13.1,24,16,15,9,0,12,18,66.7,6,30,25,5,20,44,65,2,Premier_League,2022_2023
Alexis Mac Allister,ARG,MF,Brighton,23,1998,32.1,70,39,22,40,8,34,71,47.9,37,26,2,24,22,92,10,1,Premier_League,2022_2023
James Maddison,ENG,"MF,FW",Leicester City,25,1996,27.6,51,26,25,19,7,19,50,38.0,31,19,1,18,13,64,6,1,Premier_League,2022_2023
Noni Madueke,ENG,FW,Chelsea,20,2002,7.1,12,8,5,4,3,6,13,46.2,7,13,2,11,4,16,7,0,Premier_League,2022_2023
Gabriel Magalhães,BRA,DF,Arsenal,24,1997,37.9,48,30,29,15,4,18,27,66.7,9,49,26,23,32,80,125,3,Premier_League,2022_2023
Harry Maguire,ENG,DF,Manchester Utd,29,1993,8.5,8,6,6,1,1,4,5,80.0,1,18,11,7,13,21,41,0,Premier_League,2022_2023
Riyad Mahrez,ALG,"FW,MF",Manchester City,31,1991,21.3,30,14,8,13,9,13,39,33.3,26,27,1,26,9,39,5,0,Premier_League,2022_2023
Kobbie Mainoo,ENG,MF,Manchester Utd,17,2005,0.1,0,0,0,0,0,0,0,,0,1,1,0,0,0,0,0,Premier_League,2022_2023
Ainsley Maitland-Niles,ENG,"DF,MF",Southampton,24,1997,15.6,45,24,23,18,4,28,44,63.6,16,28,7,21,22,67,45,1,Premier_League,2022_2023
Tyrell Malacia,NED,DF,Manchester Utd,22,1999,15.5,46,33,33,12,1,14,25,56.0,11,13,3,10,25,71,49,0,Premier_League,2022_2023
Orel Mangala,BEL,MF,Nott'ham Forest,24,1998,17.2,28,20,16,10,2,12,29,41.4,17,21,7,14,23,51,15,0,Premier_League,2022_2023
Javier Manquillo,ESP,DF,Newcastle Utd,28,1994,0.4,3,2,2,1,0,2,2,100.0,0,1,0,1,1,4,1,0,Premier_League,2022_2023
Sekou Mara,FRA,"FW,MF",Southampton,20,2002,6.2,14,10,5,8,1,3,9,33.3,6,11,0,11,1,15,5,0,Premier_League,2022_2023
Solly March,ENG,"FW,DF",Brighton,28,1994,30.2,53,31,16,17,20,8,28,28.6,20,34,3,31,24,77,32,0,Premier_League,2022_2023
Emiliano Marcondes,DEN,MF,Bournemouth,27,1995,0.1,0,0,0,0,0,0,0,,0,0,0,0,0,0,1,0,Premier_League,2022_2023
Marquinhos,BRA,MF,Arsenal,19,2003,0.0,0,0,0,0,0,0,0,,0,0,0,0,0,0,0,0,Premier_League,2022_2023
Anthony Martial,FRA,FW,Manchester Utd,26,1995,10.9,5,3,0,2,3,1,4,25.0,3,11,2,9,1,6,4,0,Premier_League,2022_2023
Gabriel Martinelli,BRA,FW,Arsenal,21,2001,31.0,31,18,13,12,6,9,22,40.9,13,24,1,23,9,40,14,0,Premier_League,2022_2023
Emiliano Martínez,ARG,GK,Aston Villa,29,1992,34.9,0,0,0,0,0,0,2,0.0,2,0,0,0,1,1,23,1,Premier_League,2022_2023
Lisandro Martínez,ARG,DF,Manchester Utd,24,1998,23.5,54,28,33,18,3,30,43,69.8,13,51,27,24,33,87,103,0,Premier_League,2022_2023
Pape Matar Sarr,SEN,"MF,FW",Tottenham,19,2002,2.4,7,6,4,2,1,4,8,50.0,4,3,2,1,6,13,6,0,Premier_League,2022_2023
Jean-Philippe Mateta,FRA,FW,Crystal Palace,25,1997,8.6,7,1,2,4,1,1,3,33.3,2,3,1,2,3,10,18,0,Premier_League,2022_2023
Joël Matip,CMR,DF,Liverpool,30,1991,12.1,14,8,12,2,0,11,23,47.8,12,8,3,5,21,35,45,3,Premier_League,2022_2023
Neal Maupay,FRA,FW,Everton,25,1996,12.4,11,5,3,4,4,2,4,50.0,2,8,0,8,5,16,0,0,Premier_League,2022_2023
Kevin Mbabu,SUI,"DF,FW",Fulham,27,1995,1.6,3,2,2,1,0,1,3,33.3,2,2,0,2,3,6,3,0,Premier_League,2022_2023
Bryan Mbeumo,CMR,FW,Brentford,22,1999,32.3,26,18,5,13,8,8,42,19.0,34,24,1,23,13,39,21,0,Premier_League,2022_2023
James McArthur,SCO,MF,Crystal Palace,34,1987,0.6,1,1,1,0,0,1,1,100.0,0,2,1,1,1,2,2,0,Premier_League,2022_2023
Alex McCarthy,ENG,GK,Southampton,32,1989,6.0,0,0,0,0,0,0,1,0.0,1,0,0,0,1,1,3,1,Premier_League,2022_2023
John McGinn,SCO,"MF,FW",Aston Villa,27,1994,29.9,66,36,27,29,10,34,71,47.9,37,43,4,39,24,90,19,0,Premier_League,2022_2023
Scott McKenna,SCO,DF,Nott'ham Forest,25,1996,17.5,12,7,7,3,2,6,10,60.0,4,20,14,6,12,24,85,1,Premier_League,2022_2023
Weston McKennie,USA,MF,Leeds United,23,1998,16.0,30,13,5,18,7,10,29,34.5,19,22,3,19,22,52,26,0,Premier_League,2022_2023
Dwight McNeil,ENG,"FW,MF",Everton,22,1999,27.8,64,41,35,14,15,27,65,41.5,38,46,7,39,31,95,41,0,Premier_League,2022_2023
Scott McTominay,SCO,MF,Manchester Utd,25,1996,12.9,32,19,16,10,6,13,22,59.1,9,15,6,9,14,46,45,1,Premier_League,2022_2023
Ben Mee,ENG,DF,Brentford,32,1989,36.3,45,24,28,13,4,20,37,54.1,17,54,42,12,48,93,122,2,Premier_League,2022_2023
Edouard Mendy,SEN,GK,Chelsea,30,1992,9.5,0,0,0,0,0,0,0,,0,0,0,0,0,0,3,3,Premier_League,2022_2023
Nampalys Mendy,SEN,MF,Leicester City,30,1992,8.4,13,9,7,6,0,8,15,53.3,7,20,4,16,13,26,2,0,Premier_League,2022_2023
Chris Mepham,WAL,DF,Bournemouth,24,1997,24.4,45,22,37,8,0,19,30,63.3,11,40,27,13,30,75,152,0,Premier_League,2022_2023
Illan Meslier,FRA,GK,Leeds United,22,2000,34.0,2,1,2,0,0,2,4,50.0,2,0,0,0,1,3,30,3,Premier_League,2022_2023
Alex Mighten,ENG,FW,Nott'ham Forest,20,2002,0.1,0,0,0,0,0,0,1,0.0,1,0,0,0,0,0,0,0,Premier_League,2022_2023
Lewis Miley,ENG,MF,Newcastle Utd,16,2006,0.2,0,0,0,0,0,0,0,,0,1,0,1,0,0,0,0,Premier_League,2022_2023
Luka Milivojević,SRB,MF,Crystal Palace,31,1991,5.7,13,7,7,4,2,7,10,70.0,3,13,4,9,12,25,10,1,Premier_League,2022_2023
James Milner,ENG,"MF,DF",Liverpool,36,1986,10.1,26,16,11,11,4,15,34,44.1,19,14,2,12,12,38,15,0,Premier_League,2022_2023
Yerry Mina,COL,DF,Everton,27,1994,6.6,15,8,9,6,0,9,11,81.8,2,7,4,3,6,21,28,0,Premier_League,2022_2023
Tyrone Mings,ENG,DF,Aston Villa,29,1993,35.0,15,7,10,5,0,9,20,45.0,11,40,21,19,54,69,163,2,Premier_League,2022_2023
Tyrick Mitchell,ENG,DF,Crystal Palace,22,1999,32.1,71,49,43,23,5,30,53,56.6,23,48,11,37,42,113,78,0,Premier_League,2022_2023
Kaoru Mitoma,JPN,"FW,MF",Brighton,25,1997,25.8,44,27,15,16,13,20,41,48.8,21,25,0,25,17,61,10,0,Premier_League,2022_2023
Aleksandar Mitrović,SRB,FW,Fulham,27,1994,22.3,14,7,8,4,2,5,12,41.7,7,22,5,17,3,17,20,1,Premier_League,2022_2023
Kieffer Moore,WAL,FW,Bournemouth,29,1992,14.2,14,11,2,9,3,5,16,31.3,11,12,5,7,1,15,26,0,Premier_League,2022_2023
Andrew Moran,IRL,FW,Brighton,18,2003,0.1,0,0,0,0,0,0,0,,0,1,0,1,0,0,0,0,Premier_League,2022_2023
Álex Moreno,ESP,DF,Aston Villa,29,1993,14.8,23,14,15,5,3,13,36,36.1,23,18,3,15,7,30,37,2,Premier_League,2022_2023
Mason Mount,ENG,"MF,FW",Chelsea,23,1999,18.3,33,19,6,16,11,14,27,51.9,13,24,6,18,8,41,9,0,Premier_League,2022_2023
Lucas Moura,BRA,"MF,DF",Tottenham,29,1992,1.7,8,5,1,3,4,1,4,25.0,3,0,0,0,2,10,1,1,Premier_League,2022_2023
João Moutinho,POR,MF,Wolves,35,1986,19.8,51,30,24,21,6,19,46,41.3,27,22,6,16,18,69,20,0,Premier_League,2022_2023
Divin Mubama,ENG,FW,West Ham,17,2004,0.4,1,1,1,0,0,0,0,,0,0,0,0,0,1,0,0,Premier_League,2022_2023
Mykhailo Mudryk,UKR,"FW,MF",Chelsea,21,2001,7.3,11,9,2,4,5,4,13,30.8,9,7,1,6,0,11,3,0,Premier_League,2022_2023
Jacob Murphy,ENG,FW,Newcastle Utd,27,1995,13.9,15,7,3,8,4,8,20,40.0,12,17,0,17,7,22,3,0,Premier_League,2022_2023
Enock Mwepu,ZAM,"FW,MF",Brighton,24,1998,2.4,10,5,1,6,3,3,4,75.0,1,3,1,2,1,11,1,0,Premier_League,2022_2023
Vitaliy Mykolenko,UKR,DF,Everton,23,1999,29.5,58,34,36,19,3,28,51,54.9,23,50,16,34,46,104,99,0,Premier_League,2022_2023
Keylor Navas,CRC,GK,Nott'ham Forest,35,1986,17.0,0,0,0,0,0,0,0,,0,0,0,0,1,1,11,2,Premier_League,2022_2023
Wilfred Ndidi,NGA,MF,Leicester City,25,1996,18.7,61,42,34,24,3,17,43,39.5,26,32,14,18,38,99,48,3,Premier_League,2022_2023
Reiss Nelson,ENG,FW,Arsenal,22,1999,2.4,4,1,2,1,1,2,4,50.0,2,3,0,3,0,4,4,0,Premier_League,2022_2023
Neto,BRA,GK,Bournemouth,33,1989,26.5,3,1,3,0,0,3,3,100.0,0,0,0,0,0,3,10,3,Premier_League,2022_2023
Pedro Neto,POR,"FW,MF",Wolves,22,2000,10.7,11,6,4,2,5,7,17,41.2,10,5,1,4,4,15,4,0,Premier_League,2022_2023
Rúben Neves,POR,MF,Wolves,25,1997,33.5,79,43,31,33,15,32,76,42.1,44,59,22,37,50,129,85,1,Premier_League,2022_2023
Moussa Niakhate,SEN,DF,Nott'ham Forest,26,1996,12.9,18,9,15,3,0,11,22,50.0,11,18,8,10,19,37,60,0,Premier_League,2022_2023
Eddie Nketiah,ENG,FW,Arsenal,23,1999,12.1,13,9,6,2,5,2,10,20.0,8,7,1,6,1,14,7,0,Premier_League,2022_2023
Matheus Nunes,POR,MF,Wolves,23,1998,27.4,67,43,36,22,9,28,61,45.9,33,35,4,31,16,83,35,2,Premier_League,2022_2023
Darwin Núñez,URU,FW,Liverpool,23,1999,18.8,11,5,2,4,5,4,17,23.5,13,10,0,10,3,14,13,0,Premier_League,2022_2023
Ethan Nwaneri,ENG,FW,Arsenal,15,2007,0.0,0,0,0,0,0,0,0,,0,1,0,1,0,0,0,0,Premier_League,2022_2023
Christian Nørgaard,DEN,MF,Brentford,28,1994,19.6,52,30,21,29,2,18,48,37.5,30,32,9,23,34,86,41,2,Premier_League,2022_2023
Lewis O'Brien,ENG,MF,Nott'ham Forest,23,1998,6.5,16,9,4,11,1,6,12,50.0,6,13,2,11,5,21,9,0,Premier_League,2022_2023
Odeluga Offiah,ENG,DF,Brighton,19,2002,0.3,1,1,1,0,0,0,2,0.0,2,0,0,0,0,1,1,0,Premier_League,2022_2023
Angelo Ogbonna,ITA,DF,West Ham,34,1988,13.7,11,4,7,4,0,5,10,50.0,5,11,7,4,17,28,74,1,Premier_League,2022_2023
Michael Olise,FRA,"FW,MF",Crystal Palace,20,2001,30.5,58,34,28,26,4,25,60,41.7,35,46,1,45,26,84,17,0,Premier_League,2022_2023
Robin Olsen,SWE,GK,Aston Villa,32,1990,3.1,0,0,0,0,0,0,2,0.0,2,0,0,0,0,0,1,0,Premier_League,2022_2023
Amadou Onana,BEL,MF,Everton,20,2001,27.6,72,43,24,42,6,30,42,71.4,12,25,6,19,37,109,39,0,Premier_League,2022_2023
Josh Onomah,ENG,MF,Fulham,25,1997,0.2,1,0,1,0,0,0,0,,0,1,0,1,0,1,0,0,Premier_League,2022_2023
Paul Onuachu,NGA,FW,Southampton,28,1994,4.5,3,2,1,1,1,1,3,33.3,2,4,1,3,0,3,4,0,Premier_League,2022_2023
Frank Onyeka,NGA,MF,Brentford,24,1998,9.4,19,14,11,7,1,10,25,40.0,15,16,3,13,10,29,16,0,Premier_League,2022_2023
Mislav Oršić,CRO,MF,Southampton,29,1992,0.1,1,1,1,0,0,0,0,,0,0,0,0,0,1,0,0,Premier_League,2022_2023
Stefan Ortega,GER,GK,Manchester City,29,1992,3.0,0,0,0,0,0,0,0,,0,0,0,0,0,0,0,0,Premier_League,2022_2023
Dango Ouattara,BFA,"MF,FW",Bournemouth,20,2002,13.8,28,15,20,6,2,13,32,40.6,19,20,3,17,13,41,29,1,Premier_League,2022_2023
Alex Oxlade-Chamberlain,ENG,"FW,MF",Liverpool,28,1993,3.7,5,4,1,2,2,1,5,20.0,4,5,2,3,1,6,4,0,Premier_League,2022_2023
David Ozoh,ENG,FW,Crystal Palace,17,2005,0.0,0,0,0,0,0,0,0,,0,0,0,0,0,0,0,0,Premier_League,2022_2023
João Palhinha,POR,MF,Fulham,27,1995,34.5,148,83,59,65,24,71,135,52.6,64,48,5,43,46,194,61,2,Premier_League,2022_2023
Cole Palmer,ENG,"MF,FW",Manchester City,20,2002,4.1,5,1,0,3,2,3,5,60.0,2,2,1,1,1,6,2,0,Premier_League,2022_2023
Emerson Palmieri,ITA,DF,West Ham,27,1994,14.7,26,14,9,15,2,12,24,50.0,12,17,4,13,15,41,36,0,Premier_League,2022_2023
Lucas Paquetá,BRA,MF,West Ham,24,1997,23.9,71,53,23,36,12,27,68,39.7,41,41,4,37,16,87,31,0,Premier_League,2022_2023
Thomas Partey,GHA,MF,Arsenal,29,1993,27.6,70,40,20,35,15,25,52,48.1,27,26,5,21,28,98,41,1,Premier_League,2022_2023
Nathan Patterson,SCO,"DF,MF",Everton,20,2001,14.2,49,24,32,13,4,29,54,53.7,25,24,4,20,15,64,45,0,Premier_League,2022_2023
Ben Pearson,ENG,MF,Bournemouth,27,1995,3.2,7,3,3,3,1,1,3,33.3,2,4,0,4,2,9,6,0,Premier_League,2022_2023
Facundo Pellistri,URU,"FW,MF",Manchester Utd,20,2001,0.7,1,1,0,1,0,0,0,,0,0,0,0,0,1,3,0,Premier_League,2022_2023
Andreas Pereira,BRA,MF,Fulham,26,1996,29.9,18,9,3,6,9,8,34,23.5,26,21,3,18,6,24,8,0,Premier_League,2022_2023
Ricardo Pereira,POR,"DF,MF",Leicester City,28,1993,5.0,11,7,8,3,0,7,17,41.2,10,8,2,6,4,15,20,0,Premier_League,2022_2023
Ayoze Pérez,ESP,"MF,FW",Leicester City,29,1993,4.2,11,8,5,4,2,8,19,42.1,11,6,0,6,2,13,3,0,Premier_League,2022_2023
Ivan Perišić,CRO,"DF,MF",Tottenham,33,1989,23.4,42,24,25,10,7,27,47,57.4,20,29,7,22,22,64,49,1,Premier_League,2022_2023
Romain Perraud,FRA,DF,Southampton,24,1997,20.4,54,33,23,23,8,28,52,53.8,24,24,6,18,20,74,42,0,Premier_League,2022_2023
Máximo Perrone,ARG,MF,Manchester City,19,2003,0.2,0,0,0,0,0,0,0,,0,1,0,1,0,0,0,0,Premier_League,2022_2023
Cameron Peupion,AUS,MF,Brighton,19,2002,0.1,0,0,0,0,0,0,0,,0,0,0,0,0,0,0,0,Premier_League,2022_2023
Kalvin Phillips,ENG,MF,Manchester City,26,1995,3.3,6,4,3,3,0,2,10,20.0,8,7,3,4,5,11,10,0,Premier_League,2022_2023
Nathaniel Phillips,ENG,DF,Liverpool,25,1997,0.7,2,1,0,2,0,2,2,100.0,0,0,0,0,2,4,1,0,Premier_League,2022_2023
Jordan Pickford,ENG,GK,Everton,28,1994,37.0,0,0,0,0,0,0,1,0.0,1,0,0,0,4,4,15,3,Premier_League,2022_2023
Ethan Pinnock,JAM,DF,Brentford,29,1993,30.0,52,28,33,12,7,18,24,75.0,6,41,31,10,35,87,215,2,Premier_League,2022_2023
Daniel Podence,POR,"FW,MF",Wolves,26,1995,19.7,27,17,13,9,5,6,32,18.8,26,19,0,19,7,34,6,0,Premier_League,2022_2023
Nick Pope,ENG,GK,Newcastle Utd,30,1992,36.2,1,0,1,0,0,1,3,33.3,2,0,0,0,0,1,27,2,Premier_League,2022_2023
Pedro Porro,ESP,"DF,MF",Tottenham,22,1999,12.6,25,16,8,15,2,14,39,35.9,25,25,2,23,15,40,24,1,Premier_League,2022_2023
Dennis Praet,BEL,"MF,FW",Leicester City,28,1994,7.2,12,9,5,6,1,6,11,54.5,5,12,2,10,5,17,6,0,Premier_League,2022_2023
Isaac Price,NIR,MF,Everton,18,2003,0.4,0,0,0,0,0,0,1,0.0,1,1,1,0,0,0,0,0,Premier_League,2022_2023
Christian Pulisic,USA,"FW,DF",Chelsea,23,1998,9.1,11,6,3,6,2,3,5,60.0,2,8,1,7,4,15,4,0,Premier_League,2022_2023
Aaron Ramsdale,ENG,GK,Arsenal,24,1998,38.0,1,1,1,0,0,1,1,100.0,0,0,0,0,0,1,20,6,Premier_League,2022_2023
Jacob Ramsey,ENG,"MF,FW",Aston Villa,21,2001,29.3,69,39,23,35,11,32,69,46.4,37,48,8,40,23,92,34,0,Premier_League,2022_2023
Marcus Rashford,ENG,FW,Manchester Utd,24,1997,32.0,20,10,7,8,5,9,24,37.5,15,31,4,27,7,27,14,0,Premier_League,2022_2023
David Raya,ESP,GK,Brentford,26,1995,38.0,0,0,0,0,0,0,2,0.0,2,1,0,1,1,1,10,3,Premier_League,2022_2023
Tim Ream,USA,DF,Fulham,34,1987,32.2,30,16,15,12,3,13,26,50.0,13,45,24,21,41,71,116,3,Premier_League,2022_2023
Nathan Redmond,ENG,DF,Southampton,28,1994,0.0,0,0,0,0,0,0,0,,0,0,0,0,0,0,0,0,Premier_League,2022_2023
Harrison Reed,ENG,MF,Fulham,27,1995,31.8,44,27,17,21,6,16,51,31.4,35,54,12,42,19,63,36,0,Premier_League,2022_2023
Bobby Reid,JAM,"FW,DF",Fulham,29,1993,27.5,42,24,14,14,14,16,36,44.4,20,25,3,22,20,62,28,1,Premier_League,2022_2023
Declan Rice,ENG,MF,West Ham,23,1999,36.4,79,38,44,31,4,31,50,62.0,19,45,15,30,63,142,58,0,Premier_League,2022_2023
Chris Richards,USA,DF,Crystal Palace,22,2000,5.0,9,6,8,1,0,5,7,71.4,2,10,1,9,8,17,31,0,Premier_League,2022_2023
Richarlison,BRA,"MF,FW",Tottenham,25,1997,11.2,21,16,13,5,3,12,27,44.4,15,14,1,13,5,26,10,0,Premier_League,2022_2023
Jaïro Riedewald,NED,"DF,MF",Crystal Palace,25,1996,0.7,2,1,2,0,0,0,1,0.0,1,2,0,2,0,2,4,0,Premier_League,2022_2023
Matt Ritchie,SCO,"FW,MF",Newcastle Utd,32,1989,0.4,1,1,0,1,0,1,3,33.3,2,0,0,0,1,2,0,0,Premier_League,2022_2023
Andrew Robertson,SCO,DF,Liverpool,28,1994,28.7,38,21,12,16,10,21,41,51.2,20,32,5,27,18,56,50,3,Premier_League,2022_2023
Antonee Robinson,USA,DF,Fulham,24,1997,34.3,62,38,43,15,4,44,65,67.7,21,49,13,36,53,115,83,3,Premier_League,2022_2023
Joel Robles,ESP,GK,Leeds United,32,1990,4.0,0,0,0,0,0,0,1,0.0,1,0,0,0,0,0,2,1,Premier_League,2022_2023
Marc Roca,ESP,MF,Leeds United,25,1996,25.7,66,40,27,34,5,20,65,30.8,45,34,10,24,23,89,24,2,Premier_League,2022_2023
Marek Rodák,SVK,GK,Fulham,25,1996,2.0,0,0,0,0,0,0,0,,0,0,0,0,0,0,1,1,Premier_League,2022_2023
Rodri,ESP,MF,Manchester City,26,1996,32.3,67,41,28,28,11,26,53,49.1,27,40,14,26,33,100,43,1,Premier_League,2022_2023
Rodrigo,ESP,"FW,MF",Leeds United,31,1991,21.5,24,10,2,15,7,8,19,42.1,11,16,4,12,6,30,21,1,Premier_League,2022_2023
Mads Roerslev,DEN,DF,Brentford,23,1999,12.3,22,12,19,3,0,16,33,48.5,17,14,5,9,9,31,38,0,Premier_League,2022_2023
Cristian Romero,ARG,DF,Tottenham,24,1998,26.3,68,36,42,24,2,29,46,63.0,17,40,18,22,44,112,102,3,Premier_League,2022_2023
Oriol Romeu,ESP,MF,Southampton,30,1991,0.8,1,0,0,1,0,0,0,,0,1,0,1,1,2,1,0,Premier_League,2022_2023
Cristiano Ronaldo,POR,FW,Manchester Utd,37,1985,5.8,2,2,1,0,1,1,2,50.0,1,0,0,0,1,3,9,0,Premier_League,2022_2023
Connor Ronan,IRL,MF,Wolves,24,1998,0.0,0,0,0,0,0,0,0,,0,0,0,0,0,0,0,0,Premier_League,2022_2023
Salomón Rondón,VEN,FW,Everton,32,1989,1.2,0,0,0,0,0,0,0,,0,1,1,0,0,0,0,0,Premier_League,2022_2023
Joe Rothwell,ENG,MF,Bournemouth,27,1995,11.3,20,13,7,12,1,7,21,33.3,14,14,3,11,9,29,7,0,Premier_League,2022_2023
Georginio Rutter,FRA,"FW,MF",Leeds United,20,2002,3.0,10,9,5,3,2,5,8,62.5,3,5,0,5,3,13,3,0,Premier_League,2022_2023
José Sá,POR,GK,Wolves,29,1993,36.0,1,0,1,0,0,1,1,100.0,0,0,0,0,0,1,10,6,Premier_League,2022_2023
Marcel Sabitzer,AUT,MF,Manchester Utd,28,1994,7.0,12,8,3,8,1,2,11,18.2,9,6,2,4,8,20,11,0,Premier_League,2022_2023
Allan Saint-Maximin,FRA,FW,Newcastle Utd,25,1997,12.4,10,3,3,6,1,2,11,18.2,9,4,0,4,5,15,2,0,Premier_League,2022_2023
Bukayo Saka,ENG,FW,Arsenal,20,2001,35.3,63,34,22,15,26,20,44,45.5,24,38,0,38,14,77,19,0,Premier_League,2022_2023
Mohamed Salah,EGY,FW,Liverpool,30,1992,36.6,21,12,4,5,12,10,26,38.5,16,21,0,21,6,27,4,0,Premier_League,2022_2023
William Saliba,FRA,DF,Arsenal,21,2001,26.8,34,20,23,9,2,15,18,83.3,3,13,10,3,19,53,85,4,Premier_League,2022_2023
Mohammed Salisu,GHA,DF,Southampton,23,1999,21.9,52,29,34,16,2,24,34,70.6,10,56,25,31,30,82,122,1,Premier_League,2022_2023
Albert Sambi Lokonga,BEL,MF,Arsenal,22,1999,2.2,1,1,0,0,1,0,2,0.0,2,1,0,1,5,6,2,0,Premier_League,2022_2023
Albert Sambi Lokonga,BEL,MF,Crystal Palace,22,1999,6.0,13,10,7,4,2,8,12,66.7,4,8,3,5,7,20,10,0,Premier_League,2022_2023
Davinson Sánchez,COL,DF,Tottenham,26,1996,9.5,24,11,17,6,1,14,20,70.0,6,16,10,6,12,36,41,0,Premier_League,2022_2023
Robert Sánchez,ESP,GK,Brighton,24,1997,23.0,1,0,1,0,0,0,0,,0,0,0,0,3,4,9,2,Premier_League,2022_2023
Jadon Sancho,ENG,"FW,MF",Manchester Utd,22,2000,18.7,16,10,7,5,4,8,28,28.6,20,25,2,23,7,23,6,0,Premier_League,2022_2023
Morgan Sanson,FRA,MF,Aston Villa,27,1994,0.1,2,1,1,1,0,1,1,100.0,0,0,0,0,0,2,0,0,Premier_League,2022_2023
Pablo Sarabia,ESP,"FW,MF",Wolves,30,1992,8.5,12,6,4,5,3,6,15,40.0,9,7,0,7,2,14,4,0,Premier_League,2022_2023
Jeremy Sarmiento,ECU,MF,Brighton,20,2002,2.0,6,3,4,1,1,2,5,40.0,3,2,0,2,1,7,0,0,Premier_League,2022_2023
Gianluca Scamacca,ITA,FW,West Ham,23,1999,10.3,10,5,1,3,6,2,2,100.0,0,3,0,3,4,14,5,0,Premier_League,2022_2023
Gustavo Scarpa,BRA,"MF,FW",Nott'ham Forest,28,1994,2.0,5,2,3,1,1,2,5,40.0,3,4,0,4,0,5,3,0,Premier_League,2022_2023
Kevin Schade,GER,FW,Brentford,20,2001,8.1,12,8,7,2,3,5,10,50.0,5,7,0,7,4,16,6,0,Premier_League,2022_2023
Fabian Schär,SUI,DF,Newcastle Utd,30,1991,35.6,47,22,31,13,3,24,39,61.5,15,34,19,15,52,99,139,0,Premier_League,2022_2023
Jeffrey Schlupp,GHA,"MF,FW",Crystal Palace,29,1992,28.1,66,46,28,29,9,22,43,51.2,21,39,8,31,23,89,38,0,Premier_League,2022_2023
Nélson Semedo,POR,DF,Wolves,28,1993,29.2,71,42,48,19,4,33,64,51.6,31,42,15,27,29,100,83,2,Premier_League,2022_2023
Antoine Semenyo,GHA,"FW,MF",Bournemouth,22,2000,2.9,1,0,0,0,1,1,6,16.7,5,10,1,9,2,3,4,0,Premier_League,2022_2023
Marcos Senesi,ARG,DF,Bournemouth,25,1997,27.7,50,35,28,22,0,23,44,52.3,21,38,20,18,43,93,146,2,Premier_League,2022_2023
Ryan Sessegnon,ENG,DF,Tottenham,22,2000,9.0,16,11,9,7,0,6,12,50.0,6,8,1,7,6,22,17,1,Premier_League,2022_2023
Luke Shaw,ENG,DF,Manchester Utd,27,1995,28.4,55,36,31,22,2,32,46,69.6,14,51,17,34,36,91,55,2,Premier_League,2022_2023
Jonjo Shelvey,ENG,MF,Newcastle Utd,30,1992,0.4,1,0,1,0,0,0,1,0.0,1,1,0,1,0,1,0,0,Premier_League,2022_2023
Jonjo Shelvey,ENG,MF,Nott'ham Forest,30,1992,6.0,2,1,0,1,1,1,9,11.1,8,7,2,5,5,7,10,1,Premier_League,2022_2023
Bernardo Silva,POR,"MF,FW",Manchester City,27,1994,24.5,44,23,11,25,8,18,45,40.0,27,23,6,17,16,60,6,0,Premier_League,2022_2023
Thiago Silva,BRA,DF,Chelsea,37,1984,26.1,41,27,24,17,0,21,31,67.7,10,38,29,9,34,75,111,3,Premier_League,2022_2023
Ellis Simms,ENG,FW,Everton,21,2001,2.5,0,0,0,0,0,0,0,,0,0,0,0,0,0,1,0,Premier_League,2022_2023
Luis Sinisterra,COL,FW,Leeds United,23,1999,9.6,21,14,8,9,4,11,18,61.1,7,11,1,10,8,29,2,0,Premier_League,2022_2023
Oliver Skipp,ENG,MF,Tottenham,21,2000,16.6,34,17,18,15,1,16,33,48.5,17,17,8,9,17,51,19,1,Premier_League,2022_2023
Adam Smith,ENG,DF,Bournemouth,31,1991,32.7,49,29,27,19,3,29,60,48.3,31,30,13,17,25,74,81,1,Premier_League,2022_2023
Emile Smith Rowe,ENG,"MF,FW",Arsenal,22,2000,1.9,1,1,1,0,0,1,3,33.3,2,1,0,1,0,1,2,0,Premier_League,2022_2023
Cédric Soares,POR,DF,Arsenal,30,1991,0.3,0,0,0,0,0,0,1,0.0,1,1,0,1,0,0,1,0,Premier_League,2022_2023
Cédric Soares,POR,DF,Fulham,30,1991,2.2,8,5,4,3,1,3,3,100.0,0,3,1,2,1,9,5,0,Premier_League,2022_2023
Dominic Solanke,ENG,"FW,MF",Bournemouth,24,1997,31.8,15,9,8,3,4,5,22,22.7,17,26,7,19,6,21,46,0,Premier_League,2022_2023
Manor Solomon,ISR,FW,Fulham,23,1999,6.4,20,12,12,6,2,9,16,56.3,7,8,0,8,5,25,3,0,Premier_League,2022_2023
Tomáš Souček,CZE,MF,West Ham,27,1995,31.3,77,37,41,29,7,28,58,48.3,30,42,17,25,53,130,71,3,Premier_League,2022_2023
Boubakary Soumaré,FRA,MF,Leicester City,23,1999,18.1,57,34,29,26,2,23,44,52.3,21,15,4,11,33,90,27,1,Premier_League,2022_2023
Harry Souttar,AUS,DF,Leicester City,23,1998,11.0,15,9,10,5,0,7,18,38.9,11,16,12,4,12,27,45,0,Premier_League,2022_2023
Çağlar Söyüncü,TUR,DF,Leicester City,26,1996,5.9,14,9,10,4,0,7,10,70.0,3,9,8,1,7,21,30,0,Premier_League,2022_2023
Djed Spence,ENG,"FW,DF",Tottenham,21,2000,0.1,0,0,0,0,0,0,0,,0,0,0,0,0,0,0,0,Premier_League,2022_2023
Jack Stacey,ENG,DF,Bournemouth,26,1996,3.3,5,4,3,1,1,2,5,40.0,3,3,1,2,5,10,15,0,Premier_League,2022_2023
Junior Stanislas,ENG,MF,Bournemouth,32,1989,0.7,0,0,0,0,0,0,0,,0,2,1,1,0,0,0,0,Premier_League,2022_2023
Jay Stansfield,ENG,FW,Fulham,19,2002,1.0,0,0,0,0,0,0,2,0.0,2,4,1,3,1,1,1,0,Premier_League,2022_2023
Jason Steele,ENG,GK,Brighton,31,1990,15.0,0,0,0,0,0,0,1,0.0,1,0,0,0,0,0,6,1,Premier_League,2022_2023
Jack Stephens,ENG,DF,Southampton,28,1994,0.5,2,2,2,0,0,1,1,100.0,0,1,1,0,1,3,2,0,Premier_League,2022_2023
Jack Stephens,ENG,DF,Bournemouth,28,1994,13.0,15,11,10,4,1,6,10,60.0,4,23,16,7,16,31,53,0,Premier_League,2022_2023
Raheem Sterling,ENG,"FW,MF",Chelsea,27,1994,21.0,18,10,5,4,9,8,14,57.1,6,17,0,17,2,20,5,0,Premier_League,2022_2023
John Stones,ENG,"DF,MF",Manchester City,28,1994,20.5,23,13,11,8,4,7,10,70.0,3,17,10,7,9,32,40,0,Premier_League,2022_2023
Pascal Struijk,NED,DF,Leeds United,22,1999,24.4,84,57,43,31,10,49,75,65.3,26,32,12,20,32,116,70,1,Premier_League,2022_2023
Kamaldeen Sulemana,GHA,"FW,MF",Southampton,20,2002,10.7,15,9,4,7,4,4,14,28.6,10,16,0,16,6,21,6,0,Premier_League,2022_2023
Crysencio Summerville,NED,FW,Leeds United,20,2001,15.8,30,20,14,14,2,11,23,47.8,12,20,2,18,13,43,11,0,Premier_League,2022_2023
Sam Surridge,ENG,FW,Nott'ham Forest,24,1998,3.6,5,0,1,3,1,1,4,25.0,3,5,2,3,0,5,7,0,Premier_League,2022_2023
Japhet Tanganga,ENG,DF,Tottenham,23,1999,1.6,3,2,3,0,0,1,5,20.0,4,1,0,1,2,5,8,0,Premier_League,2022_2023
Matt Targett,ENG,DF,Newcastle Utd,26,1995,6.8,13,10,8,3,2,9,24,37.5,15,8,3,5,9,22,16,0,Premier_League,2022_2023
James Tarkowski,ENG,DF,Everton,29,1992,38.0,51,26,36,13,2,20,39,51.3,19,99,78,21,51,102,201,3,Premier_League,2022_2023
Marcus Tavernier,ENG,"MF,FW",Bournemouth,23,1999,19.4,33,22,19,11,3,11,33,33.3,22,25,4,21,9,42,23,0,Premier_League,2022_2023
Tetê,BRA,FW,Leicester City,22,2000,8.2,14,8,5,7,2,6,21,28.6,15,9,0,9,2,16,3,0,Premier_League,2022_2023
Kenny Tete,NED,DF,Fulham,26,1995,28.5,83,46,41,29,13,38,51,74.5,13,48,17,31,52,135,81,1,Premier_League,2022_2023
Luke Thomas,ENG,DF,Leicester City,21,2001,11.9,23,19,15,5,3,15,32,46.9,17,20,4,16,27,50,35,0,Premier_League,2022_2023
Youri Tielemans,BEL,MF,Leicester City,25,1997,26.0,66,39,27,30,9,23,62,37.1,39,35,8,27,28,94,24,1,Premier_League,2022_2023
Kieran Tierney,SCO,DF,Arsenal,25,1997,8.8,20,11,9,9,2,12,16,75.0,4,8,2,6,11,31,25,0,Premier_League,2022_2023
Harry Toffolo,ENG,DF,Nott'ham Forest,26,1995,10.4,17,8,10,4,3,10,14,71.4,4,16,8,8,10,27,33,0,Premier_League,2022_2023
Takehiro Tomiyasu,JPN,DF,Arsenal,23,1998,7.4,27,18,12,10,5,13,18,72.2,5,7,0,7,14,41,15,1,Premier_League,2022_2023
James Tomkins,ENG,DF,Crystal Palace,33,1989,3.8,4,2,2,1,1,1,3,33.3,2,3,2,1,5,9,19,0,Premier_League,2022_2023
Ivan Toney,ENG,FW,Brentford,26,1996,32.8,23,13,4,9,10,7,23,30.4,16,24,9,15,14,37,36,0,Premier_League,2022_2023
Adama Traoré,ESP,"FW,MF",Wolves,26,1996,16.6,14,7,7,4,3,4,9,44.4,5,8,1,7,3,17,17,0,Premier_League,2022_2023
Bertrand Traoré,BFA,"FW,MF",Aston Villa,26,1995,2.6,1,1,1,0,0,1,4,25.0,3,5,0,5,2,3,0,0,Premier_League,2022_2023
Boubacar Traoré,MLI,MF,Wolves,20,2001,4.6,12,5,4,5,3,3,7,42.9,4,4,2,2,7,19,1,0,Premier_League,2022_2023
Mark Travers,IRL,GK,Bournemouth,23,1999,11.5,0,0,0,0,0,0,0,,0,1,0,1,0,0,6,0,Premier_League,2022_2023
Kieran Trippier,ENG,DF,Newcastle Utd,31,1990,37.1,71,49,36,27,8,46,90,51.1,44,45,15,30,43,114,84,2,Premier_League,2022_2023
Leandro Trossard,BEL,FW,Arsenal,27,1994,10.3,12,7,4,2,6,6,18,33.3,12,18,0,18,6,18,3,1,Premier_League,2022_2023
Leandro Trossard,BEL,"FW,MF",Brighton,27,1994,14.6,10,6,7,1,2,1,8,12.5,7,17,0,17,6,16,1,0,Premier_League,2022_2023
Kostas Tsimikas,GRE,DF,Liverpool,26,1996,8.6,14,9,10,2,2,10,16,62.5,6,8,1,7,12,26,15,0,Premier_League,2022_2023
Deniz Undav,GER,"FW,MF",Brighton,26,1996,7.0,7,4,2,2,3,2,8,25.0,6,4,1,3,0,7,1,0,Premier_League,2022_2023
Yan Valery,TUN,DF,Southampton,23,1999,0.5,0,0,0,0,0,0,0,,0,1,0,1,0,0,3,0,Premier_League,2022_2023
Virgil van Dijk,NED,DF,Liverpool,31,1991,31.5,27,14,13,11,3,8,19,42.1,11,24,16,8,31,58,138,3,Premier_League,2022_2023
Raphaël Varane,FRA,DF,Manchester Utd,29,1993,21.2,24,9,18,6,0,7,17,41.2,10,24,17,7,11,35,91,0,Premier_League,2022_2023
Jamie Vardy,ENG,FW,Leicester City,35,1987,20.6,9,5,4,2,3,1,8,12.5,7,17,3,14,2,11,30,0,Premier_League,2022_2023
Joël Veltman,NED,DF,Brighton,30,1992,24.3,62,32,44,14,4,37,57,64.9,20,27,8,19,19,81,51,0,Premier_League,2022_2023
Fabio Vieira,POR,"MF,FW",Arsenal,22,2000,5.7,6,4,3,0,3,3,5,60.0,2,5,0,5,4,10,2,0,Premier_League,2022_2023
Matías Viña,URU,DF,Bournemouth,24,1997,5.1,19,11,9,8,2,14,30,46.7,16,13,1,12,4,23,22,0,Premier_League,2022_2023
Rúben Vinagre,POR,"DF,MF",Everton,23,1999,0.3,2,2,1,1,0,1,2,50.0,1,0,0,0,0,2,1,0,Premier_League,2022_2023
Carlos Vinícius,BRA,FW,Fulham,27,1995,12.3,4,1,0,2,2,0,4,0.0,4,7,0,7,0,4,10,0,Premier_League,2022_2023
Theo Walcott,ENG,"FW,MF",Southampton,33,1989,12.5,13,6,8,4,1,8,27,29.6,19,8,1,7,9,22,7,0,Premier_League,2022_2023
Kyle Walker,ENG,DF,Manchester City,32,1990,21.8,13,9,8,5,0,4,24,16.7,20,12,2,10,18,31,22,0,Premier_League,2022_2023
Kyle Walker-Peters,ENG,DF,Southampton,25,1997,29.4,61,32,34,24,3,22,43,51.2,21,47,8,39,27,88,52,0,Premier_League,2022_2023
Aaron Wan-Bissaka,ENG,DF,Manchester Utd,24,1997,15.9,40,25,20,17,3,23,25,92.0,2,24,8,16,22,62,41,0,Premier_League,2022_2023
Danny Ward,WAL,GK,Leicester City,29,1993,26.0,1,1,1,0,0,1,3,33.3,2,0,0,0,0,1,14,2,Premier_League,2022_2023
Joel Ward,ENG,DF,Crystal Palace,32,1989,25.1,50,36,30,11,9,30,41,73.2,11,32,16,16,25,75,80,1,Premier_League,2022_2023
James Ward-Prowse,ENG,MF,Southampton,27,1994,37.5,65,37,31,27,7,21,61,34.4,40,30,10,20,55,120,48,0,Premier_League,2022_2023
Ollie Watkins,ENG,FW,Aston Villa,26,1995,34.7,19,13,3,13,3,10,27,37.0,17,21,4,17,10,29,39,0,Premier_League,2022_2023
Adam Webster,ENG,DF,Brighton,27,1995,22.1,22,12,10,9,3,11,19,57.9,8,30,19,11,19,41,55,4,Premier_League,2022_2023
Wout Weghorst,NED,"FW,MF",Manchester Utd,29,1992,8.9,11,5,6,1,4,2,9,22.2,7,7,2,5,7,18,9,0,Premier_League,2022_2023
Danny Welbeck,ENG,FW,Brighton,31,1990,20.6,15,7,0,7,8,4,11,36.4,7,24,2,22,5,20,20,0,Premier_League,2022_2023
Ben White,ENG,DF,Arsenal,24,1997,33.9,60,31,23,30,7,42,70,60.0,28,47,11,36,22,82,79,1,Premier_League,2022_2023
Harvey White,ENG,MF,Tottenham,20,2001,0.1,0,0,0,0,0,0,1,0.0,1,0,0,0,0,0,0,0,Premier_League,2022_2023
Joseph Whitworth,ENG,GK,Crystal Palace,18,2004,2.0,0,0,0,0,0,0,0,,0,0,0,0,0,0,1,0,Premier_League,2022_2023
Neco Williams,WAL,DF,Nott'ham Forest,21,2001,20.9,72,47,49,17,6,38,71,53.5,33,33,8,25,33,105,48,0,Premier_League,2022_2023
Willian,BRA,FW,Fulham,33,1988,23.6,13,8,8,3,2,7,25,28.0,18,13,0,13,9,22,9,0,Premier_League,2022_2023
Joe Willock,ENG,MF,Newcastle Utd,22,1999,28.4,51,30,13,26,12,25,58,43.1,33,54,8,46,25,76,17,0,Premier_League,2022_2023
Callum Wilson,ENG,FW,Newcastle Utd,30,1992,20.9,9,3,0,8,1,0,3,0.0,3,8,0,8,1,10,5,0,Premier_League,2022_2023
Harry Wilson,WAL,FW,Fulham,25,1997,12.2,21,13,9,9,3,8,18,44.4,10,17,2,15,6,27,14,0,Premier_League,2022_2023
Yoane Wissa,COD,FW,Brentford,25,1996,17.8,17,12,4,7,6,6,13,46.2,7,10,0,10,6,23,15,0,Premier_League,2022_2023
Maximilian Wöber,AUT,DF,Leeds United,24,1998,14.1,25,18,9,15,1,16,24,66.7,8,32,14,18,27,52,67,1,Premier_League,2022_2023
Chris Wood,NZL,FW,Newcastle Utd,30,1991,5.0,5,4,0,3,2,3,5,60.0,2,2,2,0,1,6,7,0,Premier_League,2022_2023
Chris Wood,NZL,FW,Nott'ham Forest,30,1991,4.1,0,0,0,0,0,0,1,0.0,1,2,1,1,1,1,2,0,Premier_League,2022_2023
Joe Worrall,ENG,DF,Nott'ham Forest,25,1997,24.7,53,25,39,12,2,25,35,71.4,10,33,23,10,26,79,111,1,Premier_League,2022_2023
Granit Xhaka,SUI,MF,Arsenal,29,1992,33.3,34,27,11,18,5,16,41,39.0,25,28,10,18,15,49,45,1,Premier_League,2022_2023
Ryan Yates,ENG,MF,Nott'ham Forest,24,1997,20.4,38,19,19,16,3,14,22,63.6,8,26,8,18,10,48,44,0,Premier_League,2022_2023
Ashley Young,ENG,DF,Aston Villa,37,1985,22.6,50,27,34,15,1,37,50,74.0,13,25,11,14,21,71,65,0,Premier_League,2022_2023
Illia Zabarnyi,UKR,DF,Bournemouth,19,2002,3.3,4,2,4,0,0,3,7,42.9,4,7,2,5,3,7,14,0,Premier_League,2022_2023
Wilfried Zaha,CIV,"FW,MF",Crystal Palace,29,1992,25.4,32,20,12,12,8,8,21,38.1,13,21,1,20,16,48,9,0,Premier_League,2022_2023
Denis Zakaria,SUI,MF,Chelsea,25,1996,4.6,9,5,5,2,2,2,8,25.0,6,4,1,3,3,12,10,0,Premier_League,2022_2023
Jordan Zemura,ZIM,DF,Bournemouth,22,1999,16.2,39,24,24,14,1,23,44,52.3,21,31,9,22,16,55,32,0,Premier_League,2022_2023
Oleksandr Zinchenko,UKR,DF,Arsenal,25,1996,23.5,40,18,14,17,9,21,40,52.5,19,20,2,18,22,62,38,2,Premier_League,2022_2023
Hakim Ziyech,MAR,"FW,MF",Chelsea,29,1993,7.3,20,12,12,5,3,4,9,44.4,5,8,0,8,5,25,5,1,Premier_League,2022_2023
Kurt Zouma,FRA,DF,West Ham,27,1994,22.1,9,4,4,5,0,5,8,62.5,3,17,14,3,30,39,120,1,Premier_League,2022_2023
Martin Ødegaard,NOR,MF,Arsenal,23,1998,34.7,36,23,12,14,10,14,47,29.8,33,20,5,15,6,42,12,1,Premier_League,2022_2023
James Abankwah,IRL,DF,Udinese,18,2004,0.7,1,1,0,1,0,0,0,,0,4,2,2,0,1,5,0,Serie_A,2022_2023
Oliver Abildgaard,DEN,MF,Hellas Verona,26,1996,6.6,10,6,6,3,1,7,16,43.8,9,7,1,6,5,15,17,0,Serie_A,2022_2023
Tammy Abraham,ENG,FW,Roma,24,1997,24.3,17,10,4,8,5,3,16,18.8,13,10,4,6,3,20,14,0,Serie_A,2022_2023
Christian Acella,ITA,MF,Cremonese,20,2002,0.2,1,0,1,0,0,0,2,0.0,2,0,0,0,0,1,0,0,Serie_A,2022_2023
Francesco Acerbi,ITA,DF,Inter,34,1988,26.9,33,19,22,7,4,20,27,74.1,7,25,18,7,41,74,85,2,Serie_A,2022_2023
Yacine Adli,FRA,"MF,FW",Milan,22,2000,1.6,6,3,2,4,0,2,2,100.0,0,2,0,2,1,7,1,0,Serie_A,2022_2023
Michel Aebischer,SUI,"FW,MF",Bologna,25,1997,17.1,12,6,3,6,3,2,18,11.1,16,14,2,12,7,19,9,0,Serie_A,2022_2023
Felix Afena-Gyan,GHA,"FW,MF",Cremonese,19,2003,9.1,7,3,4,1,2,2,10,20.0,8,5,1,4,1,8,6,0,Serie_A,2022_2023
Kevin Agudelo,COL,"MF,FW",Spezia,23,1998,23.7,71,38,22,30,19,25,59,42.4,34,39,5,34,10,81,6,0,Serie_A,2022_2023
Ola Aina,NGA,DF,Torino,25,1996,9.7,17,13,5,8,4,9,15,60.0,6,12,2,10,11,28,26,0,Serie_A,2022_2023
Emanuel Aiwum,AUT,DF,Cremonese,21,2000,18.4,55,34,36,17,2,33,47,70.2,14,28,16,12,25,80,52,3,Serie_A,2022_2023
Jean-Daniel Akpa-Akpro,CIV,"MF,FW",Empoli,29,1992,15.1,53,37,25,19,9,23,42,54.8,19,35,4,31,13,66,27,0,Serie_A,2022_2023
Luis Alberto,ESP,MF,Lazio,29,1992,27.1,49,29,18,20,11,23,72,31.9,49,35,6,29,9,58,4,0,Serie_A,2022_2023
Agustín Álvarez Martínez,URU,"FW,MF",Sassuolo,21,2001,4.1,6,3,0,5,1,1,4,25.0,3,5,1,4,3,9,3,0,Serie_A,2022_2023
Kelvin Amian,FRA,DF,Spezia,24,1998,26.4,54,32,33,12,9,24,31,77.4,7,34,12,22,22,76,87,1,Serie_A,2022_2023
Bruno Amione,ARG,DF,Hellas Verona,20,2002,0.6,1,1,1,0,0,1,2,50.0,1,1,0,1,0,1,4,0,Serie_A,2022_2023
Bruno Amione,ARG,DF,Sampdoria,20,2002,23.2,50,33,36,14,0,19,43,44.2,24,26,11,15,25,75,62,1,Serie_A,2022_2023
Ethan Ampadu,WAL,"DF,MF",Spezia,21,2000,29.3,66,37,33,28,5,17,41,41.5,24,48,23,25,36,102,98,0,Serie_A,2022_2023
Sofyan Amrabat,MAR,MF,Fiorentina,25,1996,22.2,39,24,15,17,7,16,29,55.2,13,23,5,18,21,60,18,2,Serie_A,2022_2023
Felipe Anderson,BRA,FW,Lazio,29,1993,32.9,80,50,31,41,8,31,88,35.2,57,58,6,52,31,111,27,0,Serie_A,2022_2023
Janis Antiste,FRA,FW,Sassuolo,19,2002,0.6,1,0,1,0,0,1,1,100.0,0,0,0,0,0,1,0,0,Serie_A,2022_2023
Marcos Antônio,BRA,MF,Lazio,22,2000,6.6,9,6,4,5,0,9,20,45.0,11,7,2,5,11,20,18,0,Serie_A,2022_2023
Valentin Antov,BUL,DF,Monza,21,2000,3.4,6,5,3,3,0,1,5,20.0,4,5,4,1,4,10,14,1,Serie_A,2022_2023
Marko Arnautović,AUT,FW,Bologna,33,1989,17.0,9,6,2,5,2,1,6,16.7,5,11,1,10,2,11,10,0,Serie_A,2022_2023
Tolgay Arslan,GER,MF,Udinese,31,1990,13.5,29,18,13,15,1,14,39,35.9,25,19,0,19,12,41,9,1,Serie_A,2022_2023
Santiago Ascacíbar,ARG,MF,Cremonese,25,1997,8.1,29,14,17,10,2,14,35,40.0,21,14,2,12,13,42,11,0,Serie_A,2022_2023
Kristoffer Askildsen,NOR,MF,Lecce,21,2001,8.1,7,3,2,3,2,4,10,40.0,6,15,4,11,11,18,6,0,Serie_A,2022_2023
Kristjan Asllani,ALB,MF,Inter,20,2002,6.6,11,5,1,8,2,7,10,70.0,3,3,1,2,6,17,4,0,Serie_A,2022_2023
Emil Audero,ITA,GK,Sampdoria,25,1997,25.0,0,0,0,0,0,0,2,0.0,2,0,0,0,0,0,7,1,Serie_A,2022_2023
Tommaso Augello,ITA,DF,Sampdoria,27,1994,34.0,17,14,13,2,2,9,20,45.0,11,23,7,16,17,34,61,1,Serie_A,2022_2023
Carlos Augusto,BRA,DF,Monza,23,1999,34.3,73,38,42,23,8,33,54,61.1,21,24,6,18,24,97,85,1,Serie_A,2022_2023
Kaan Ayhan,TUR,DF,Sassuolo,27,1994,6.1,10,4,6,4,0,7,7,100.0,0,5,4,1,5,15,26,1,Serie_A,2022_2023
Jaime Báez,URU,DF,Cremonese,27,1995,1.1,4,2,3,0,1,3,6,50.0,3,0,0,0,0,4,2,1,Serie_A,2022_2023
Nedim Bajrami,ALB,"MF,FW",Empoli,23,1999,10.4,8,4,3,3,2,4,6,66.7,2,5,0,5,7,15,4,0,Serie_A,2022_2023
Nedim Bajrami,ALB,"FW,MF",Sassuolo,23,1999,9.1,12,7,6,2,4,5,11,45.5,6,9,1,8,7,19,6,0,Serie_A,2022_2023
Tiemoué Bakayoko,FRA,MF,Milan,27,1994,0.5,5,5,4,1,0,3,3,100.0,0,0,0,0,0,5,0,1,Serie_A,2022_2023
Tommaso Baldanzi,ITA,MF,Empoli,19,2003,19.7,25,12,9,13,3,7,32,21.9,25,21,1,20,2,27,5,0,Serie_A,2022_2023
Fodé Ballo-Touré,SEN,DF,Milan,25,1997,5.8,14,9,7,6,1,7,10,70.0,3,11,3,8,2,16,3,0,Serie_A,2022_2023
Lameck Banda,ZAM,"FW,MF",Lecce,21,2001,18.2,30,20,13,14,3,15,41,36.6,26,24,2,22,8,38,5,0,Serie_A,2022_2023
Filippo Bandinelli,ITA,MF,Empoli,27,1995,25.1,55,34,19,26,10,17,45,37.8,28,20,7,13,18,73,40,0,Serie_A,2022_2023
Antonín Barák,CZE,MF,Hellas Verona,27,1994,0.3,0,0,0,0,0,0,0,,0,0,0,0,0,0,0,0,Serie_A,2022_2023
Antonín Barák,CZE,MF,Fiorentina,27,1994,20.0,21,9,5,7,9,6,16,37.5,10,16,2,14,3,24,13,0,Serie_A,2022_2023
Andrea Barberis,ITA,MF,Monza,28,1993,3.8,7,2,4,3,0,5,11,45.5,6,0,0,0,8,15,1,0,Serie_A,2022_2023
Tommaso Barbieri,ITA,DF,Juventus,19,2002,1.2,3,3,3,0,0,3,8,37.5,5,3,0,3,0,3,2,0,Serie_A,2022_2023
Francesco Bardi,ITA,GK,Bologna,30,1992,1.0,0,0,0,0,0,0,0,,0,0,0,0,0,0,0,0,Serie_A,2022_2023
Nicolò Barella,ITA,MF,Inter,25,1997,29.0,49,25,17,26,6,28,53,52.8,25,29,5,24,12,61,12,0,Serie_A,2022_2023
Enzo Barrenechea,ARG,MF,Juventus,21,2001,1.8,8,3,3,4,1,3,5,60.0,2,3,0,3,2,10,3,0,Serie_A,2022_2023
Musa Barrow,GAM,"FW,MF",Bologna,23,1998,21.8,21,4,10,6,5,8,14,57.1,6,25,1,24,1,22,7,0,Serie_A,2022_2023
Federico Baschirotto,ITA,DF,Lecce,25,1996,37.0,40,30,35,5,0,22,36,61.1,14,45,29,16,36,76,192,0,Serie_A,2022_2023
Toma Bašić,CRO,MF,Lazio,25,1996,5.7,6,4,4,1,1,3,8,37.5,5,9,0,9,7,13,8,0,Serie_A,2022_2023
Alberto Basso,ITA,MF,Cremonese,18,2004,0.2,0,0,0,0,0,0,0,,0,0,0,0,0,0,0,0,Serie_A,2022_2023
Alessandro Bastoni,ITA,DF,Inter,23,1999,24.0,41,20,20,14,7,11,27,40.7,16,27,13,14,24,65,45,0,Serie_A,2022_2023
Simone Bastoni,ITA,"MF,DF",Spezia,25,1996,13.2,47,24,23,19,5,15,33,45.5,18,20,5,15,8,55,14,0,Serie_A,2022_2023
Brian Bayeye,COD,DF,Torino,22,2000,0.7,3,0,3,0,0,1,1,100.0,0,1,1,0,1,4,2,0,Serie_A,2022_2023
Rodrigo Becão,BRA,DF,Udinese,26,1996,27.6,70,36,50,17,3,40,53,75.5,13,44,24,20,26,96,68,2,Serie_A,2022_2023
Julius Beck,DEN,MF,Spezia,17,2005,0.1,2,1,1,1,0,0,0,,0,0,0,0,0,2,0,0,Serie_A,2022_2023
Raoul Bellanova,ITA,DF,Inter,22,2000,5.5,14,6,11,2,1,9,14,64.3,5,6,1,5,4,18,14,0,Serie_A,2022_2023
Andrea Belotti,ITA,FW,Roma,28,1993,12.7,12,5,3,5,4,5,11,45.5,6,11,1,10,3,15,5,0,Serie_A,2022_2023
Marco Benassi,ITA,DF,Fiorentina,27,1994,1.0,3,3,2,0,1,3,4,75.0,1,0,0,0,1,4,1,0,Serie_A,2022_2023
Marco Benassi,ITA,MF,Cremonese,27,1994,11.1,26,15,9,11,6,15,24,62.5,9,13,1,12,12,38,19,0,Serie_A,2022_2023
Ismaël Bennacer,ALG,MF,Milan,24,1997,22.3,59,33,26,31,2,30,51,58.8,21,25,7,18,26,85,16,1,Serie_A,2022_2023
Domenico Berardi,ITA,FW,Sassuolo,27,1994,20.7,23,14,8,10,5,9,40,22.5,31,13,0,13,19,42,18,0,Serie_A,2022_2023
Bartosz Bereszyński,POL,DF,Sampdoria,30,1992,13.3,28,18,15,11,2,17,26,65.4,9,18,4,14,21,49,25,0,Serie_A,2022_2023
Bartosz Bereszyński,POL,DF,Napoli,30,1992,1.8,3,2,1,1,1,2,2,100.0,0,4,0,4,3,6,3,0,Serie_A,2022_2023
Marco Bertini,ITA,MF,Lazio,19,2002,0.0,0,0,0,0,0,0,0,,0,0,0,0,0,0,0,0,Serie_A,2022_2023
Beto,GNB,FW,Udinese,24,1998,23.7,16,9,0,9,7,4,17,23.5,13,18,3,15,6,22,30,0,Serie_A,2022_2023
Matteo Bianchetti,ITA,DF,Cremonese,29,1993,23.7,32,19,21,9,2,20,32,62.5,12,31,17,14,20,52,111,0,Serie_A,2022_2023
Alessandro Bianco,ITA,MF,Fiorentina,19,2002,1.7,5,2,2,3,0,2,3,66.7,1,1,0,1,0,5,0,0,Serie_A,2022_2023
Jaka Bijol,SVN,DF,Udinese,23,1999,30.3,39,23,32,7,0,16,27,59.3,11,41,25,16,29,68,165,0,Serie_A,2022_2023
Cristiano Biraghi,ITA,DF,Fiorentina,29,1992,28.3,65,38,29,29,7,32,65,49.2,33,32,7,25,14,79,42,1,Serie_A,2022_2023
Samuele Birindelli,ITA,DF,Monza,23,1999,15.6,35,19,21,10,4,18,29,62.1,11,28,8,20,16,51,30,0,Serie_A,2022_2023
Kristijan Bistrović,CRO,MF,Lecce,24,1998,5.1,3,1,3,0,0,0,5,0.0,5,3,0,3,0,3,4,0,Serie_A,2022_2023
Alexis Blin,FRA,MF,Lecce,25,1996,26.4,69,39,27,33,9,38,73,52.1,35,55,15,40,34,103,74,0,Serie_A,2022_2023
Jeremie Boga,CIV,"MF,FW",Atalanta,25,1997,8.7,9,5,3,2,4,2,5,40.0,3,6,0,6,1,10,1,0,Serie_A,2022_2023
Emil Bohinen,NOR,MF,Salernitana,23,1999,9.2,25,13,15,8,2,12,23,52.2,11,25,7,18,17,42,21,0,Serie_A,2022_2023
Giacomo Bonaventura,ITA,MF,Fiorentina,32,1989,21.2,35,23,14,15,6,24,37,64.9,13,14,0,14,16,51,5,1,Serie_A,2022_2023
Federico Bonazzoli,ITA,"FW,MF",Salernitana,25,1997,12.4,5,3,0,3,2,0,9,0.0,9,9,1,8,3,8,0,0,Serie_A,2022_2023
Warren Bondo,FRA,MF,Monza,18,2003,0.7,1,0,1,0,0,0,0,,0,1,0,1,0,1,0,0,Serie_A,2022_2023
Kevin Bonifazi,ITA,DF,Bologna,26,1996,10.0,13,8,7,6,0,6,12,50.0,6,11,8,3,12,25,39,0,Serie_A,2022_2023
Leonardo Bonucci,ITA,DF,Juventus,35,1987,9.8,5,4,1,4,0,2,4,50.0,2,12,8,4,13,18,29,0,Serie_A,2022_2023
Erik Botheim,NOR,"MF,FW",Salernitana,22,2000,9.6,11,7,3,4,4,6,13,46.2,7,3,0,3,0,11,4,0,Serie_A,2022_2023
Mehdi Bourabia,MAR,MF,Spezia,30,1991,30.8,41,20,13,22,6,19,41,46.3,22,39,12,27,32,73,57,0,Serie_A,2022_2023
Edoardo Bove,ITA,MF,Roma,20,2002,11.0,35,18,12,15,8,16,39,41.0,23,15,1,14,10,45,11,0,Serie_A,2022_2023
Jayden Braaf,NED,"MF,FW",Hellas Verona,19,2002,3.2,5,3,2,3,0,0,0,,0,1,0,1,2,7,1,0,Serie_A,2022_2023
Domagoj Bradarić,CRO,DF,Salernitana,22,1999,25.0,26,19,14,8,4,7,16,43.8,9,20,5,15,21,47,44,0,Serie_A,2022_2023
Josip Brekalo,CRO,"FW,MF",Fiorentina,24,1998,2.5,2,1,0,1,1,1,4,25.0,3,1,0,1,1,3,1,0,Serie_A,2022_2023
Gleison Bremer,BRA,DF,Juventus,25,1997,29.3,29,20,23,5,1,19,26,73.1,7,44,22,22,42,71,120,2,Serie_A,2022_2023
Dylan Bronn,TUN,DF,Salernitana,27,1995,18.7,34,18,17,16,1,20,30,66.7,10,32,20,12,20,54,58,1,Serie_A,2022_2023
Marcelo Brozović,CRO,MF,Inter,29,1992,19.7,37,22,13,22,2,11,37,29.7,26,23,7,16,22,59,28,0,Serie_A,2022_2023
Cristian Buonaiuto,ITA,"MF,FW",Cremonese,29,1992,10.9,25,16,8,11,6,12,26,46.2,14,11,0,11,14,39,7,0,Serie_A,2022_2023
Alessandro Buongiorno,ITA,DF,Torino,23,1999,30.2,38,25,22,16,0,16,31,51.6,15,38,19,19,60,98,105,2,Serie_A,2022_2023
Leonardo Buta,POR,DF,Udinese,20,2002,0.2,1,1,0,1,0,0,0,,0,0,0,0,0,1,0,0,Serie_A,2022_2023
Arthur Cabral,BRA,FW,Fiorentina,24,1998,15.9,9,2,1,4,4,4,8,50.0,4,10,1,9,1,10,12,0,Serie_A,2022_2023
Liberato Cacace,NZL,DF,Empoli,21,2000,6.5,25,10,12,8,5,9,15,60.0,6,15,7,8,4,29,16,0,Serie_A,2022_2023
Davide Calabria,ITA,DF,Milan,25,1996,18.8,71,44,31,32,8,38,61,62.3,23,22,7,15,25,96,34,0,Serie_A,2022_2023
Mattia Caldara,ITA,DF,Spezia,28,1994,13.9,23,14,10,11,2,9,20,45.0,11,23,16,7,17,40,88,2,Serie_A,2022_2023
Luca Caldirola,ITA,DF,Monza,31,1991,26.1,26,14,19,4,3,13,26,50.0,13,32,18,14,25,51,66,1,Serie_A,2022_2023
Hakan Çalhanoğlu,TUR,MF,Inter,28,1994,26.3,48,27,17,26,5,16,43,37.2,27,30,5,25,25,73,13,1,Serie_A,2022_2023
Mohamed Camara,GUI,MF,Roma,25,1997,7.7,13,10,3,7,3,5,15,33.3,10,5,1,4,10,23,8,0,Serie_A,2022_2023
Nicolò Cambiaghi,ITA,"FW,MF",Empoli,21,2000,14.3,30,22,11,12,7,8,27,29.6,19,19,1,18,9,39,8,0,Serie_A,2022_2023
Andrea Cambiaso,ITA,DF,Bologna,22,2000,24.1,57,34,34,20,3,28,65,43.1,37,26,2,24,26,83,33,1,Serie_A,2022_2023
Matteo Cancellieri,ITA,FW,Lazio,20,2002,2.8,10,4,5,3,2,5,9,55.6,4,4,0,4,1,11,2,0,Serie_A,2022_2023
Antonio Candreva,ITA,"MF,DF",Salernitana,35,1987,30.3,17,7,13,2,2,11,38,28.9,27,7,3,4,17,34,32,0,Serie_A,2022_2023
Gianluca Caprari,ITA,"MF,FW",Monza,29,1993,27.1,16,6,3,11,2,8,26,30.8,18,22,1,21,8,24,3,0,Serie_A,2022_2023
Francesco Caputo,ITA,FW,Sampdoria,34,1987,12.2,3,1,0,0,3,0,3,0.0,3,0,0,0,1,4,3,0,Serie_A,2022_2023
Francesco Caputo,ITA,FW,Empoli,34,1987,19.0,2,2,0,1,1,0,1,0.0,1,7,2,5,2,4,8,0,Serie_A,2022_2023
Andrea Carboni,ITA,DF,Monza,21,2001,1.9,3,2,2,0,1,2,5,40.0,3,3,2,1,3,6,2,1,Serie_A,2022_2023
Franco Carboni,ITA,"DF,FW",Monza,19,2003,0.7,1,1,1,0,0,0,2,0.0,2,3,0,3,1,2,0,0,Serie_A,2022_2023
Valentin Carboni,ARG,"MF,DF",Inter,17,2005,0.3,1,1,0,1,0,1,3,33.3,2,1,0,1,0,1,0,0,Serie_A,2022_2023
Marco Carnesecchi,ITA,GK,Cremonese,22,2000,27.0,1,1,1,0,0,1,2,50.0,1,0,0,0,0,1,11,2,Serie_A,2022_2023
Nicolò Casale,ITA,DF,Lazio,24,1998,27.1,42,20,28,14,0,22,34,64.7,12,25,17,8,17,59,73,1,Serie_A,2022_2023
Tommaso Cassandro,ITA,DF,Lecce,22,2000,0.1,1,1,0,1,0,0,0,,0,1,1,0,0,1,0,0,Serie_A,2022_2023
Michele Castagnetti,ITA,MF,Cremonese,32,1989,15.7,46,21,20,24,2,18,54,33.3,36,14,4,10,15,61,22,0,Serie_A,2022_2023
Gaetano Castrovilli,ITA,MF,Fiorentina,25,1997,8.0,10,8,1,7,2,2,9,22.2,7,5,1,4,8,18,5,0,Serie_A,2022_2023
Danilo Cataldi,ITA,MF,Lazio,27,1994,21.3,25,16,7,15,3,14,40,35.0,26,23,9,14,24,49,33,0,Serie_A,2022_2023
Pietro Ceccaroni,ITA,DF,Lecce,26,1995,0.5,0,0,0,0,0,0,0,,0,1,1,0,3,3,2,0,Serie_A,2022_2023
Federico Ceccherini,ITA,DF,Hellas Verona,30,1992,15.7,25,19,15,9,1,13,23,56.5,10,17,10,7,19,44,55,0,Serie_A,2022_2023
Assan Ceesay,GAM,FW,Lecce,28,1994,20.1,23,18,7,8,8,9,17,52.9,8,15,2,13,3,26,24,0,Serie_A,2022_2023
Emil Ceide,NOR,FW,Sassuolo,20,2001,5.7,5,2,5,0,0,3,5,60.0,2,3,1,2,1,6,0,0,Serie_A,2022_2023
Zeki Çelik,TUR,DF,Roma,25,1997,16.7,42,21,19,21,2,24,41,58.5,17,33,6,27,14,56,36,2,Serie_A,2022_2023
Michele Cerofolini,ITA,GK,Fiorentina,23,1999,5.0,0,0,0,0,0,0,0,,0,0,0,0,1,1,2,0,Serie_A,2022_2023
Federico Chiesa,ITA,"DF,MF",Juventus,24,1997,9.5,22,11,6,6,10,5,14,35.7,9,13,1,12,0,22,1,0,Serie_A,2022_2023
Vlad Chiricheș,ROU,DF,Cremonese,32,1989,10.9,35,20,27,7,1,16,24,66.7,8,36,23,13,22,57,44,0,Serie_A,2022_2023
Daniel Ciofani,ITA,FW,Cremonese,37,1985,11.8,6,3,1,2,3,4,7,57.1,3,7,1,6,2,8,10,0,Serie_A,2022_2023
Tio Cipot,SVN,"FW,MF",Spezia,19,2003,1.5,12,7,6,3,3,6,8,75.0,2,0,0,0,0,12,2,0,Serie_A,2022_2023
Patrick Ciurria,ITA,"DF,MF",Monza,27,1995,30.6,31,18,20,10,1,17,33,51.5,16,24,2,22,7,38,32,0,Serie_A,2022_2023
Nicolò Cocetta,ITA,DF,Udinese,18,2003,0.4,0,0,0,0,0,0,1,0.0,1,1,1,0,1,1,1,0,Serie_A,2022_2023
Omar Colley,GAM,DF,Sampdoria,29,1992,15.4,17,10,10,7,0,9,12,75.0,3,9,5,4,22,39,69,1,Serie_A,2022_2023
Lorenzo Colombo,ITA,FW,Lecce,20,2002,16.8,17,9,1,9,7,6,14,42.9,8,22,0,22,2,19,7,0,Serie_A,2022_2023
Andrea Colpani,ITA,MF,Monza,23,1999,10.5,14,9,6,5,3,8,12,66.7,4,14,2,12,3,17,6,0,Serie_A,2022_2023
Andrea Consigli,ITA,GK,Sassuolo,35,1987,35.0,1,0,1,0,0,0,1,0.0,1,0,0,0,0,1,13,3,Serie_A,2022_2023
Andrea Conti,ITA,DF,Sampdoria,28,1994,0.3,0,0,0,0,0,0,0,,0,0,0,0,0,0,0,0,Serie_A,2022_2023
Diego Coppola,ITA,DF,Hellas Verona,18,2003,13.1,25,17,15,10,0,11,24,45.8,13,20,6,14,14,39,38,0,Serie_A,2022_2023
Alex Cordaz,ITA,GK,Inter,39,1983,0.3,0,0,0,0,0,0,0,,0,0,0,0,0,0,0,0,Serie_A,2022_2023
Joaquín Correa,ARG,FW,Inter,27,1994,10.6,12,7,3,6,3,4,15,26.7,11,4,1,3,3,15,0,0,Serie_A,2022_2023
Alessandro Cortinovis,ITA,MF,Hellas Verona,21,2001,0.1,1,0,1,0,0,0,0,,0,1,0,1,0,1,0,0,Serie_A,2022_2023
Lassana Coulibaly,MLI,MF,Salernitana,26,1996,32.1,84,50,42,35,7,30,73,41.1,43,35,7,28,25,109,33,2,Serie_A,2022_2023
Alessio Cragno,ITA,GK,Monza,28,1994,1.0,0,0,0,0,0,0,1,0.0,1,0,0,0,0,0,0,0,Serie_A,2022_2023
Bryan Cristante,ITA,"MF,DF",Roma,27,1995,32.6,113,62,55,49,9,55,90,61.1,35,39,10,29,18,131,53,0,Serie_A,2022_2023
Domen Črnigoj,SVN,MF,Salernitana,26,1995,3.3,8,3,0,7,1,1,2,50.0,1,9,1,8,9,17,6,0,Serie_A,2022_2023
Juan Cuadrado,COL,"DF,FW",Juventus,34,1988,23.1,50,34,34,13,3,27,65,41.5,38,15,2,13,24,74,32,0,Serie_A,2022_2023
Mickaël Cuisance,FRA,MF,Sampdoria,22,1999,6.9,13,10,7,5,1,5,23,21.7,18,10,0,10,5,18,4,0,Serie_A,2022_2023
Marco D'Alessandro,ITA,"DF,FW",Monza,31,1991,3.2,4,4,3,1,0,2,5,40.0,3,2,0,2,1,5,3,0,Serie_A,2022_2023
Danilo D'Ambrosio,ITA,DF,Inter,33,1988,8.1,25,17,17,7,1,15,27,55.6,12,12,4,8,10,35,17,0,Serie_A,2022_2023
Luca D'Andrea,ITA,FW,Sassuolo,17,2004,3.5,4,0,2,1,1,1,4,25.0,3,2,0,2,1,5,1,0,Serie_A,2022_2023
Flavius Daniliuc,AUT,DF,Salernitana,21,2001,24.4,57,29,37,17,3,26,47,55.3,21,30,13,17,29,86,76,0,Serie_A,2022_2023
Danilo,BRA,DF,Juventus,31,1991,35.4,92,62,61,23,8,52,73,71.2,21,39,20,19,47,139,114,1,Serie_A,2022_2023
Matteo Darmian,ITA,DF,Inter,32,1989,22.5,56,30,29,15,12,31,47,66.0,16,33,5,28,21,77,36,0,Serie_A,2022_2023
Juan David Cabal,COL,DF,Hellas Verona,21,2001,4.9,10,6,7,3,0,7,12,58.3,5,8,5,3,13,23,12,0,Serie_A,2022_2023
Paweł Dawidowicz,POL,DF,Hellas Verona,27,1995,18.1,48,31,28,17,3,22,31,71.0,9,14,9,5,23,71,71,0,Serie_A,2022_2023
Charles De Ketelaere,BEL,"MF,FW",Milan,21,2001,12.4,26,12,7,14,5,13,30,43.3,17,14,2,12,4,30,9,0,Serie_A,2022_2023
Manuel De Luca,ITA,"FW,MF",Sampdoria,24,1998,0.5,0,0,0,0,0,0,0,,0,0,0,0,0,0,0,0,Serie_A,2022_2023
Tommaso De Nipoti,ITA,MF,Atalanta,19,2003,0.0,1,0,0,1,0,0,0,,0,0,0,0,0,1,0,0,Serie_A,2022_2023
Mattia De Sciglio,ITA,DF,Juventus,29,1992,11.6,14,7,8,3,3,9,14,64.3,5,9,3,6,4,18,20,0,Serie_A,2022_2023
Lorenzo De Silvestri,ITA,DF,Bologna,34,1988,7.5,3,2,2,0,1,3,7,42.9,4,6,5,1,3,6,20,0,Serie_A,2022_2023
Koni De Winter,BEL,DF,Empoli,20,2002,11.4,14,9,11,3,0,5,13,38.5,8,14,12,2,6,20,65,0,Serie_A,2022_2023
Grégoire Defrel,MTQ,FW,Sassuolo,31,1991,13.0,9,7,5,2,2,4,13,30.8,9,11,0,11,2,11,5,0,Serie_A,2022_2023
Duccio Degl'Innocenti,ITA,MF,Empoli,19,2003,0.0,0,0,0,0,0,0,0,,0,0,0,0,1,1,0,0,Serie_A,2022_2023
Merih Demiral,TUR,DF,Atalanta,24,1998,17.1,41,29,30,11,0,26,36,72.2,10,24,7,17,24,65,57,1,Serie_A,2022_2023
Diego Demme,GER,MF,Napoli,30,1991,1.6,1,0,1,0,0,0,4,0.0,4,2,0,2,0,1,1,0,Serie_A,2022_2023
Fabio Depaoli,ITA,DF,Hellas Verona,25,1997,24.1,48,28,25,16,7,25,44,56.8,19,32,6,26,18,66,33,3,Serie_A,2022_2023
Fabio Depaoli,ITA,"DF,MF",Sampdoria,25,1997,1.5,5,3,2,3,0,3,4,75.0,1,1,0,1,1,6,4,0,Serie_A,2022_2023
Kastriot Dermaku,ALB,DF,Lecce,30,1992,0.4,0,0,0,0,0,0,0,,0,0,0,0,0,0,0,0,Serie_A,2022_2023
Cyriel Dessers,NGA,FW,Cremonese,27,1994,17.6,11,4,4,4,3,2,6,33.3,4,14,2,12,3,14,5,0,Serie_A,2022_2023
Sergiño Dest,USA,DF,Milan,21,2000,3.7,12,6,3,5,4,3,4,75.0,1,1,0,1,4,16,2,0,Serie_A,2022_2023
Mattia Destro,ITA,"FW,MF",Empoli,31,1991,6.4,1,1,0,1,0,0,0,,0,2,0,2,1,2,5,0,Serie_A,2022_2023
Gerard Deulofeu,ESP,FW,Udinese,28,1994,13.5,8,5,5,1,2,5,15,33.3,10,8,1,7,2,10,1,0,Serie_A,2022_2023
Samuel Di Carmine,ITA,"FW,MF",Cremonese,33,1988,0.3,0,0,0,0,0,0,0,,0,0,0,0,0,0,0,0,Serie_A,2022_2023
Federico Di Francesco,ITA,"FW,MF",Lecce,28,1994,22.6,28,16,7,11,10,9,19,47.4,10,16,0,16,8,36,14,0,Serie_A,2022_2023
Michele Di Gregorio,ITA,GK,Monza,25,1997,37.0,0,0,0,0,0,0,3,0.0,3,1,0,1,4,4,18,3,Serie_A,2022_2023
Giovanni Di Lorenzo,ITA,DF,Napoli,28,1993,36.2,60,29,33,19,8,25,49,51.0,24,30,9,21,30,90,60,0,Serie_A,2022_2023
Ángel Di María,ARG,"FW,MF",Juventus,34,1988,15.1,10,5,3,5,2,3,19,15.8,16,15,0,15,7,17,0,0,Serie_A,2022_2023
Boulaye Dia,SEN,"FW,MF",Salernitana,25,1996,28.0,12,5,3,6,3,2,7,28.6,5,10,0,10,7,19,27,1,Serie_A,2022_2023
Brahim Díaz,MAR,"MF,FW",Milan,22,1999,21.4,32,15,5,22,5,5,15,33.3,10,11,0,11,7,39,6,0,Serie_A,2022_2023
Federico Dimarco,ITA,DF,Inter,24,1997,23.0,31,25,6,18,7,9,19,47.4,10,15,4,11,18,49,20,0,Serie_A,2022_2023
Koffi Djidji,CIV,DF,Torino,29,1992,26.9,50,25,32,17,1,18,32,56.3,14,29,14,15,34,84,72,0,Serie_A,2022_2023
Berat Djimsiti,ALB,DF,Atalanta,29,1993,20.0,34,19,21,13,0,17,25,68.0,8,17,7,10,36,70,74,1,Serie_A,2022_2023
Dodô,BRA,DF,Fiorentina,23,1998,25.9,40,22,20,14,6,22,46,47.8,24,26,2,24,25,65,37,0,Serie_A,2022_2023
Josh Doig,SCO,DF,Hellas Verona,20,2002,15.0,19,8,6,7,6,6,16,37.5,10,25,6,19,11,30,13,1,Serie_A,2022_2023
Nicolás Domínguez,ARG,MF,Bologna,24,1998,25.6,79,49,34,33,12,39,76,51.3,37,29,3,26,21,100,29,1,Serie_A,2022_2023
Giulio Donati,ITA,DF,Monza,32,1990,4.7,4,1,1,1,2,3,6,50.0,3,3,1,2,4,8,11,0,Serie_A,2022_2023
Bartłomiej Drągowski,POL,GK,Spezia,24,1997,32.7,1,0,1,0,0,1,5,20.0,4,0,0,0,1,2,15,3,Serie_A,2022_2023
Ondrej Duda,SVK,MF,Hellas Verona,27,1994,11.8,22,14,7,12,3,9,16,56.3,7,11,0,11,13,35,8,0,Serie_A,2022_2023
Denzel Dumfries,NED,DF,Inter,26,1996,24.6,35,18,17,13,5,22,34,64.7,12,33,9,24,12,47,26,0,Serie_A,2022_2023
Alfred Duncan,GHA,MF,Fiorentina,29,1993,12.3,18,10,0,17,1,10,21,47.6,11,9,0,9,8,26,6,0,Serie_A,2022_2023
Paulo Dybala,ARG,"MF,FW",Roma,28,1993,19.3,14,4,1,8,5,8,26,30.8,18,12,1,11,8,22,4,0,Serie_A,2022_2023
Edin Džeko,BIH,FW,Inter,36,1986,19.2,3,2,0,3,0,0,4,0.0,4,15,1,14,3,6,25,0,Serie_A,2022_2023
Festy Ebosele,IRL,DF,Udinese,19,2002,4.6,15,10,8,7,0,4,10,40.0,6,5,0,5,2,17,5,0,Serie_A,2022_2023
Enzo Ebosse,CMR,DF,Udinese,23,1999,10.3,15,9,11,4,0,9,13,69.2,4,27,6,21,11,26,29,0,Serie_A,2022_2023
Tyronne Ebuehi,NGA,DF,Empoli,26,1995,21.4,22,14,11,7,4,9,13,69.2,4,23,12,11,12,34,79,1,Serie_A,2022_2023
Éderson,BRA,MF,Atalanta,23,1999,24.6,67,34,18,42,7,29,66,43.9,37,56,7,49,36,103,31,0,Serie_A,2022_2023
Kingsley Ehizibue,NED,DF,Udinese,27,1995,17.1,47,31,28,13,6,29,45,64.4,16,21,3,18,10,57,42,1,Serie_A,2022_2023
Albin Ekdal,SWE,MF,Spezia,33,1989,19.3,37,20,14,20,3,19,45,42.2,26,24,2,22,26,63,36,0,Serie_A,2022_2023
Emmanuel Ekong,SWE,"FW,MF",Empoli,20,2002,0.2,0,0,0,0,0,0,0,,0,0,0,0,0,0,0,0,Serie_A,2022_2023
Mikael Ellertsson,ISL,"MF,DF",Spezia,20,2002,1.9,4,2,1,3,0,0,3,0.0,3,2,1,1,2,6,0,0,Serie_A,2022_2023
Elif Elmas,MKD,"FW,MF",Napoli,22,1999,18.1,24,13,8,12,4,11,23,47.8,12,18,2,16,11,35,5,0,Serie_A,2022_2023
Martin Erlic,CRO,DF,Sassuolo,24,1998,25.9,27,16,18,8,1,10,23,43.5,13,36,23,13,31,58,120,1,Serie_A,2022_2023
Gonzalo Escalante,ARG,MF,Cremonese,29,1993,6.2,16,8,8,8,0,10,13,76.9,3,7,1,6,10,26,4,0,Serie_A,2022_2023
Salvatore Esposito,ITA,MF,Spezia,21,2000,10.8,15,12,8,5,2,5,21,23.8,16,9,1,8,11,26,18,0,Serie_A,2022_2023
Nicolò Fagioli,ITA,MF,Juventus,21,2001,16.9,29,19,12,15,2,8,27,29.6,19,16,2,14,8,37,7,1,Serie_A,2022_2023
Wladimiro Falcone,ITA,GK,Lecce,27,1995,38.0,2,0,2,0,0,2,2,100.0,0,0,0,0,2,4,21,3,Serie_A,2022_2023
Davide Faraoni,ITA,DF,Hellas Verona,30,1991,16.5,34,24,19,13,2,16,41,39.0,25,30,11,19,15,49,37,0,Serie_A,2022_2023
Federico Fazio,ARG,DF,Salernitana,35,1987,11.9,15,12,8,7,0,4,11,36.4,7,9,4,5,28,43,61,0,Serie_A,2022_2023
Jacopo Fazzini,ITA,MF,Empoli,19,2003,9.2,31,17,20,8,3,18,34,52.9,16,15,3,12,7,38,19,0,Serie_A,2022_2023
Lewis Ferguson,SCO,"MF,FW",Bologna,22,1999,25.7,44,25,16,20,8,20,40,50.0,20,22,7,15,19,63,25,0,Serie_A,2022_2023
Alex Ferrari,ITA,DF,Sampdoria,28,1994,9.6,9,5,7,2,0,4,8,50.0,4,21,10,11,19,28,25,0,Serie_A,2022_2023
Alex Ferrari,ITA,DF,Cremonese,28,1994,11.2,40,23,32,7,1,28,42,66.7,14,19,4,15,25,65,45,1,Serie_A,2022_2023
Salvador Ferrer,ESP,DF,Spezia,24,1998,1.5,4,2,2,2,0,1,3,33.3,2,3,1,2,1,5,4,0,Serie_A,2022_2023
Vincenzo Fiorillo,ITA,GK,Salernitana,32,1990,1.0,0,0,0,0,0,0,0,,0,0,0,0,0,0,0,0,Serie_A,2022_2023
Alessandro Florenzi,ITA,DF,Milan,31,1991,2.3,6,4,3,2,1,4,7,57.1,3,1,0,1,4,10,2,0,Serie_A,2022_2023
Davide Frattesi,ITA,MF,Sassuolo,22,1999,31.9,63,36,24,29,10,25,44,56.8,19,27,6,21,16,79,42,0,Serie_A,2022_2023
Matteo Gabbia,ITA,DF,Milan,22,1999,6.8,17,10,12,5,0,6,8,75.0,2,8,3,5,5,22,29,0,Serie_A,2022_2023
Manolo Gabbiadini,ITA,"FW,MF",Sampdoria,30,1991,26.2,23,15,8,9,6,9,23,39.1,14,16,2,14,6,29,25,0,Serie_A,2022_2023
Gianluca Gaetano,ITA,MF,Napoli,22,2000,0.8,5,3,1,3,1,0,0,,0,1,0,1,1,6,0,0,Serie_A,2022_2023
Roberto Gagliardini,ITA,MF,Inter,28,1994,8.7,16,6,9,6,1,10,21,47.6,11,14,5,9,4,20,15,0,Serie_A,2022_2023
Adolfo Gaich,ARG,FW,Hellas Verona,23,1999,8.1,5,3,0,3,2,1,6,16.7,5,7,2,5,3,8,7,1,Serie_A,2022_2023
Pablo Galdames Millán,CHI,MF,Cremonese,25,1996,8.2,14,10,8,3,3,5,33,15.2,28,13,2,11,10,24,13,0,Serie_A,2022_2023
Antonino Gallo,ITA,DF,Lecce,22,2000,27.6,56,36,35,12,9,38,57,66.7,19,37,6,31,13,69,71,0,Serie_A,2022_2023
Federico Gatti,ITA,DF,Juventus,24,1998,16.1,15,11,9,4,2,9,15,60.0,6,20,14,6,21,36,54,2,Serie_A,2022_2023
Valentin Gendrey,FRA,DF,Lecce,22,2000,34.5,88,57,54,25,9,40,71,56.3,31,45,4,41,37,125,89,0,Serie_A,2022_2023
Paolo Ghiglione,ITA,DF,Cremonese,25,1997,7.9,16,11,10,3,3,10,23,43.5,13,9,4,5,4,20,12,0,Serie_A,2022_2023
Mario Gila,ESP,DF,Lazio,21,2000,1.0,3,1,3,0,0,0,1,0.0,1,0,0,0,3,6,3,0,Serie_A,2022_2023
Gvidas Gineitis,LTU,MF,Torino,18,2004,1.5,3,1,0,2,1,1,2,50.0,1,0,0,0,0,3,1,0,Serie_A,2022_2023
Olivier Giroud,FRA,FW,Milan,35,1986,23.8,8,5,2,4,2,2,10,20.0,8,11,3,8,3,11,23,0,Serie_A,2022_2023
Pierluigi Gollini,ITA,GK,Fiorentina,27,1995,3.0,1,0,1,0,0,1,1,100.0,0,0,0,0,0,1,2,0,Serie_A,2022_2023
Pierluigi Gollini,ITA,GK,Napoli,27,1995,4.0,0,0,0,0,0,0,0,,0,0,0,0,0,0,1,0,Serie_A,2022_2023
Joan Gonzàlez,ESP,MF,Lecce,20,2002,24.4,48,28,20,18,10,17,51,33.3,34,37,8,29,16,64,28,0,Serie_A,2022_2023
Nicolás González,ARG,"FW,MF",Fiorentina,24,1998,15.0,17,10,3,10,4,5,16,31.3,11,14,0,14,4,21,6,0,Serie_A,2022_2023
Robin Gosens,GER,DF,Inter,28,1994,13.2,34,18,15,10,9,15,25,60.0,10,16,2,14,23,57,15,0,Serie_A,2022_2023
Alberto Grassi,ITA,MF,Empoli,27,1995,13.3,26,21,13,13,0,15,24,62.5,9,23,12,11,27,53,45,0,Serie_A,2022_2023
Andrew Gravillon,GLP,DF,Torino,24,1998,3.5,3,3,0,3,0,0,0,,0,4,2,2,9,12,16,0,Serie_A,2022_2023
Axel Guessand,FRA,DF,Udinese,17,2004,0.9,2,1,2,0,0,1,2,50.0,1,1,0,1,2,4,3,0,Serie_A,2022_2023
Koray Günter,GER,DF,Hellas Verona,27,1994,11.1,10,6,1,8,1,4,7,57.1,3,24,15,9,30,40,46,0,Serie_A,2022_2023
Koray Günter,GER,DF,Sampdoria,27,1994,8.6,10,8,6,4,0,6,9,66.7,3,10,5,5,11,21,46,0,Serie_A,2022_2023
Emmanuel Gyasi,GHA,"FW,DF",Spezia,28,1994,31.2,24,15,11,10,3,9,36,25.0,27,24,6,18,8,32,26,0,Serie_A,2022_2023
Norbert Gyömbér,SVK,DF,Salernitana,30,1992,19.3,32,23,25,6,1,16,24,66.7,8,33,22,11,35,67,92,0,Serie_A,2022_2023
Christian Gytkjær,DEN,"FW,MF",Monza,32,1990,6.2,6,2,1,4,1,2,5,40.0,3,6,1,5,0,6,2,0,Serie_A,2022_2023
Nicolas Haas,SUI,MF,Empoli,26,1996,12.8,27,13,16,6,5,12,24,50.0,12,16,4,12,8,35,27,0,Serie_A,2022_2023
Samir Handanović,SVN,GK,Inter,38,1984,13.7,0,0,0,0,0,0,0,,0,0,0,0,0,0,5,0,Serie_A,2022_2023
Abdou Harroui,NED,MF,Sassuolo,24,1998,7.2,17,6,6,7,4,2,7,28.6,5,6,1,5,2,19,10,0,Serie_A,2022_2023
Hans Hateboer,NED,DF,Atalanta,28,1994,15.5,21,13,11,8,2,11,27,40.7,16,23,4,19,12,33,25,0,Serie_A,2022_2023
Liam Henderson,SCO,MF,Empoli,26,1996,11.2,13,10,6,5,2,4,21,19.0,17,10,2,8,10,23,10,0,Serie_A,2022_2023
Jack Hendry,SCO,DF,Cremonese,27,1995,2.4,0,0,0,0,0,0,1,0.0,1,2,1,1,1,1,7,0,Serie_A,2022_2023
Matheus Henrique,BRA,MF,Sassuolo,24,1997,21.6,26,12,9,11,6,12,24,50.0,12,15,4,11,12,38,10,0,Serie_A,2022_2023
Thomas Henry,FRA,FW,Hellas Verona,27,1994,11.4,5,3,1,1,3,1,5,20.0,4,6,2,4,0,5,14,0,Serie_A,2022_2023
Theo Hernández,FRA,DF,Milan,24,1997,30.8,43,24,27,15,1,22,38,57.9,16,34,7,27,21,64,35,1,Serie_A,2022_2023
Isak Hien,SWE,DF,Hellas Verona,23,1999,29.0,73,36,54,19,0,38,61,62.3,23,40,17,23,31,104,92,1,Serie_A,2022_2023
Morten Hjulmand,DEN,MF,Lecce,23,1999,32.9,90,52,49,40,1,37,67,55.2,30,43,11,32,72,162,54,0,Serie_A,2022_2023
Emil Holm,SWE,DF,Spezia,22,2000,15.5,26,15,13,8,5,16,31,51.6,15,21,6,15,9,35,41,0,Serie_A,2022_2023
Martin Hongla,CMR,MF,Hellas Verona,24,1998,5.8,8,5,4,4,0,5,5,100.0,0,7,1,6,6,14,9,0,Serie_A,2022_2023
Petko Hristov,BUL,DF,Spezia,23,1999,4.1,6,4,2,4,0,5,8,62.5,3,4,2,2,4,10,12,0,Serie_A,2022_2023
Ajdin Hrustic,AUS,MF,Hellas Verona,26,1996,2.5,2,1,1,1,0,1,2,50.0,1,2,0,2,0,2,2,1,Serie_A,2022_2023
Elseid Hysaj,ALB,DF,Lazio,28,1994,22.2,39,23,24,11,4,23,41,56.1,18,31,7,24,20,59,42,0,Serie_A,2022_2023
Rasmus Højlund,DEN,FW,Atalanta,19,2003,20.4,4,3,0,2,2,1,6,16.7,5,9,1,8,1,5,5,0,Serie_A,2022_2023
Roger Ibanez,BRA,DF,Roma,23,1998,31.1,67,33,38,26,3,32,48,66.7,16,30,11,19,66,133,95,2,Serie_A,2022_2023
Zlatan Ibrahimović,SWE,FW,Milan,40,1981,1.6,0,0,0,0,0,0,0,,0,1,1,0,0,0,2,0,Serie_A,2022_2023
Antonio Iervolino,ITA,MF,Salernitana,19,2003,0.1,0,0,0,0,0,0,1,0.0,1,0,0,0,0,0,0,0,Serie_A,2022_2023
Igor,BRA,DF,Fiorentina,24,1998,22.9,43,29,21,18,4,20,27,74.1,7,33,14,19,25,68,56,2,Serie_A,2022_2023
Jonathan Ikone,FRA,FW,Fiorentina,24,1998,22.3,16,8,5,6,5,5,14,35.7,9,18,1,17,4,20,3,0,Serie_A,2022_2023
Ivan Ilić,SRB,MF,Hellas Verona,21,2001,9.5,16,10,9,7,0,6,11,54.5,5,10,1,9,8,24,14,0,Serie_A,2022_2023
Ivan Ilić,SRB,MF,Torino,21,2001,13.1,18,7,6,11,1,10,20,50.0,10,12,3,9,5,23,10,0,Serie_A,2022_2023
Samuel Iling-Junior,ENG,"DF,FW",Juventus,18,2003,3.5,7,2,3,1,3,4,9,44.4,5,5,1,4,2,9,6,0,Serie_A,2022_2023
Emirhan İlkhan,TUR,MF,Torino,18,2004,1.0,1,1,0,1,0,1,1,100.0,0,3,1,2,2,3,2,0,Serie_A,2022_2023
Emirhan İlkhan,TUR,MF,Sampdoria,18,2004,1.3,6,3,2,2,2,2,3,66.7,1,5,1,4,0,6,3,0,Serie_A,2022_2023
Ciro Immobile,ITA,FW,Lazio,32,1990,24.7,11,5,4,4,3,6,9,66.7,3,10,2,8,1,12,14,0,Serie_A,2022_2023
Ardian Ismajli,ALB,DF,Empoli,25,1996,23.3,40,32,25,15,0,18,24,75.0,6,47,31,16,27,67,120,0,Serie_A,2022_2023
Mihailo Ivanović,SRB,FW,Sampdoria,17,2004,0.0,0,0,0,0,0,0,0,,0,0,0,0,0,0,0,0,Serie_A,2022_2023
Armando Izzo,ITA,DF,Monza,30,1992,27.4,73,50,44,27,2,29,45,64.4,16,29,17,12,50,123,87,1,Serie_A,2022_2023
Mato Jajalo,BIH,MF,Udinese,34,1988,0.7,0,0,0,0,0,0,1,0.0,1,0,0,0,0,0,2,0,Serie_A,2022_2023
Jesé,ESP,FW,Sampdoria,29,1993,2.3,2,0,0,2,0,0,1,0.0,1,3,1,2,1,3,2,0,Serie_A,2022_2023
Juan Jesus,BRA,DF,Napoli,31,1991,10.4,16,11,9,6,1,9,12,75.0,3,18,11,7,10,26,29,0,Serie_A,2022_2023
Þórir Jóhann Helgason,ISL,MF,Lecce,21,2000,2.5,2,2,1,0,1,2,3,66.7,1,3,1,2,3,5,3,0,Serie_A,2022_2023
Luka Jović,SRB,"FW,MF",Fiorentina,24,1997,17.0,6,3,1,4,1,2,8,25.0,6,7,2,5,2,8,10,0,Serie_A,2022_2023
Hamed Junior Traorè,CIV,"MF,FW",Sassuolo,22,2000,6.6,11,6,4,6,1,4,11,36.4,7,4,0,4,2,13,0,1,Serie_A,2022_2023
Yayah Kallon,SLE,"MF,FW",Hellas Verona,21,2001,9.6,14,10,5,4,5,7,12,58.3,5,10,0,10,8,22,5,0,Serie_A,2022_2023
Pierre Kalulu,FRA,DF,Milan,22,2000,28.3,57,39,33,21,3,28,42,66.7,14,41,17,24,41,98,56,1,Serie_A,2022_2023
Yann Karamoh,FRA,"MF,FW",Torino,24,1998,8.0,5,2,3,2,0,1,5,20.0,4,5,0,5,0,5,2,1,Serie_A,2022_2023
Rick Karsdorp,NED,DF,Roma,27,1995,7.9,21,13,11,7,3,13,22,59.1,9,0,0,0,7,28,15,1,Serie_A,2022_2023
Denso Kasius,NED,DF,Bologna,19,2002,3.8,12,6,7,4,1,8,10,80.0,2,6,3,3,3,15,6,0,Serie_A,2022_2023
Grigoris Kastanos,CYP,"MF,DF",Salernitana,24,1998,14.3,39,23,18,19,2,16,40,40.0,24,20,6,14,8,47,8,0,Serie_A,2022_2023
Moise Kean,ITA,FW,Juventus,22,2000,11.1,8,6,2,5,1,3,7,42.9,4,4,0,4,5,13,2,0,Serie_A,2022_2023
Jakub Kiwior,POL,DF,Spezia,22,2000,16.0,22,17,15,7,0,6,24,25.0,18,26,18,8,24,46,71,1,Serie_A,2022_2023
Simon Kjær,DEN,DF,Milan,33,1989,11.2,15,8,9,6,0,7,11,63.6,4,14,11,3,9,24,35,1,Serie_A,2022_2023
Teun Koopmeiners,NED,MF,Atalanta,24,1998,31.8,46,26,15,24,7,28,55,50.9,27,41,5,36,19,65,36,2,Serie_A,2022_2023
Filip Kostić,SRB,"DF,FW",Juventus,29,1992,28.5,41,26,17,20,4,21,47,44.7,26,30,4,26,16,57,32,0,Serie_A,2022_2023
Christian Kouamé,CIV,FW,Fiorentina,24,1997,20.7,27,18,8,10,9,7,14,50.0,7,15,3,12,12,39,8,0,Serie_A,2022_2023
Viktor Kovalenko,UKR,MF,Spezia,26,1996,6.1,9,5,1,6,2,5,8,62.5,3,11,2,9,4,13,7,0,Serie_A,2022_2023
Julian Kristoffersen,NOR,FW,Salernitana,25,1997,0.2,0,0,0,0,0,0,0,,0,1,0,1,0,0,0,0,Serie_A,2022_2023
Raimonds Krollis,LVA,"FW,DF",Spezia,20,2001,0.4,1,1,0,0,1,0,1,0.0,1,0,0,0,0,1,0,0,Serie_A,2022_2023
Rade Krunić,BIH,MF,Milan,28,1993,18.4,40,28,18,18,4,16,50,32.0,34,31,11,20,16,56,21,0,Serie_A,2022_2023
Marash Kumbulla,ALB,DF,Roma,22,2000,2.9,4,4,2,2,0,2,3,66.7,1,2,1,1,4,8,6,0,Serie_A,2022_2023
Khvicha Kvaratskhelia,GEO,FW,Napoli,21,2001,28.0,43,23,12,8,23,17,43,39.5,26,20,0,20,5,48,6,1,Serie_A,2022_2023
Giorgos Kyriakopoulos,GRE,"DF,FW",Bologna,26,1996,7.8,13,6,4,5,4,10,23,43.5,13,14,2,12,4,17,10,0,Serie_A,2022_2023
Giorgos Kyriakopoulos,GRE,"FW,DF",Sassuolo,26,1996,8.5,21,8,7,9,5,10,14,71.4,4,7,1,6,11,32,12,1,Serie_A,2022_2023
Sam Lammers,NED,FW,Sampdoria,25,1997,12.2,12,5,2,7,3,6,15,40.0,9,10,3,7,6,18,11,0,Serie_A,2022_2023
Sam Lammers,NED,FW,Empoli,25,1997,9.8,20,10,5,9,6,7,11,63.6,4,4,1,3,3,23,8,0,Serie_A,2022_2023
Kevin Lasagna,ITA,"FW,MF",Hellas Verona,29,1992,17.5,12,6,7,3,2,6,14,42.9,8,17,1,16,5,17,13,0,Serie_A,2022_2023
Armand Lauriente,FRA,FW,Sassuolo,23,1998,24.2,21,15,5,7,9,8,21,38.1,13,20,0,20,12,33,8,0,Serie_A,2022_2023
Valentino Lazaro,AUT,DF,Torino,26,1996,15.3,10,5,6,0,4,6,14,42.9,8,16,3,13,3,13,29,0,Serie_A,2022_2023
Marko Lazetić,SRB,FW,Milan,18,2004,0.1,0,0,0,0,0,0,0,,0,0,0,0,0,0,0,0,Serie_A,2022_2023
Darko Lazović,SRB,"MF,DF",Hellas Verona,31,1990,24.9,24,13,9,12,3,13,29,44.8,16,14,3,11,16,40,19,0,Serie_A,2022_2023
Manuel Lazzari,ITA,DF,Lazio,28,1993,20.9,33,21,13,14,6,21,36,58.3,15,20,6,14,18,51,36,1,Serie_A,2022_2023
Rafael Leão,POR,"FW,MF",Milan,23,1999,26.9,8,7,2,3,3,6,14,42.9,8,9,2,7,15,23,8,0,Serie_A,2022_2023
Mehdi Léris,ALG,"MF,DF",Sampdoria,24,1998,27.3,63,46,30,24,9,23,55,41.8,32,38,6,32,27,90,34,0,Serie_A,2022_2023
Karol Linetty,POL,MF,Torino,27,1995,21.0,32,17,7,22,3,13,25,52.0,12,28,8,20,19,51,25,0,Serie_A,2022_2023
Marcin Listkowski,POL,"MF,FW",Lecce,24,1998,0.9,0,0,0,0,0,0,0,,0,0,0,0,3,3,2,0,Serie_A,2022_2023
Diego Llorente,ESP,DF,Roma,28,1993,6.4,10,5,6,4,0,5,12,41.7,7,4,2,2,11,21,20,0,Serie_A,2022_2023
Stanislav Lobotka,SVK,MF,Napoli,27,1994,34.5,83,44,35,35,13,43,73,58.9,30,29,7,22,23,106,16,0,Serie_A,2022_2023
Manuel Locatelli,ITA,MF,Juventus,24,1998,27.2,59,33,26,23,10,30,53,56.6,23,50,22,28,27,86,59,0,Serie_A,2022_2023
Luka Lochoshvili,GEO,DF,Cremonese,24,1998,20.4,45,19,30,11,4,22,31,71.0,9,31,10,21,22,67,89,0,Serie_A,2022_2023
Ademola Lookman,NGA,"FW,MF",Atalanta,24,1997,19.2,13,5,2,6,5,3,15,20.0,12,18,0,18,4,17,1,0,Serie_A,2022_2023
Maxime Lopez,FRA,MF,Sassuolo,24,1997,25.5,42,18,26,12,4,16,56,28.6,40,24,6,18,22,64,21,0,Serie_A,2022_2023
Matteo Lovato,ITA,DF,Salernitana,22,2000,9.0,17,14,14,3,0,10,25,40.0,15,8,5,3,13,30,33,2,Serie_A,2022_2023
Sandi Lovrić,SVN,MF,Udinese,24,1998,25.9,40,18,16,16,8,25,43,58.1,18,25,2,23,26,66,21,0,Serie_A,2022_2023
Hirving Lozano,MEX,FW,Napoli,27,1995,17.8,24,13,10,6,8,9,21,42.9,12,31,0,31,15,39,6,0,Serie_A,2022_2023
Jhon Lucumí,COL,DF,Bologna,24,1998,32.2,53,37,39,13,1,24,43,55.8,19,43,26,17,35,88,100,1,Serie_A,2022_2023
José Luis Palomino,ARG,DF,Atalanta,32,1990,8.4,23,14,16,7,0,11,19,57.9,8,11,4,7,28,51,20,0,Serie_A,2022_2023
Romelu Lukaku,BEL,FW,Inter,29,1993,18.4,3,1,1,0,2,2,5,40.0,3,3,1,2,0,3,16,0,Serie_A,2022_2023
Saša Lukić,SRB,MF,Torino,25,1996,13.3,21,14,10,10,1,9,15,60.0,6,17,7,10,13,34,10,0,Serie_A,2022_2023
Sebastiano Luperto,ITA,DF,Empoli,25,1996,34.8,33,18,24,8,1,9,20,45.0,11,54,42,12,43,76,163,1,Serie_A,2022_2023
Charalambos Lykogiannis,GRE,DF,Bologna,28,1993,12.3,16,8,5,6,5,5,13,38.5,8,9,4,5,15,31,30,0,Serie_A,2022_2023
Giulio Maggiore,ITA,MF,Salernitana,24,1998,9.9,20,8,11,6,3,10,21,47.6,11,19,4,15,8,28,10,0,Serie_A,2022_2023
Giangiacomo Magnani,ITA,DF,Hellas Verona,26,1995,17.0,33,22,20,11,2,19,25,76.0,6,20,15,5,21,54,76,0,Serie_A,2022_2023
Mike Maignan,FRA,GK,Milan,27,1995,22.0,1,0,1,0,0,1,1,100.0,0,0,0,0,1,2,10,1,Serie_A,2022_2023
Jordan Majchrzak,POL,FW,Roma,17,2004,0.2,0,0,0,0,0,0,0,,0,0,0,0,0,0,0,0,Serie_A,2022_2023
Jean-Victor Makengo,FRA,MF,Udinese,24,1998,8.9,16,13,7,7,2,5,9,55.6,4,8,2,6,9,25,3,0,Serie_A,2022_2023
Lorenzo Malagrida,ITA,"MF,DF",Sampdoria,18,2003,1.2,1,0,0,0,1,1,3,33.3,2,1,0,1,0,1,1,0,Serie_A,2022_2023
Daniel Maldini,ITA,"FW,MF",Spezia,20,2001,7.0,12,5,3,4,5,4,11,36.4,7,9,0,9,1,13,8,0,Serie_A,2022_2023
Youssef Maleh,MAR,MF,Fiorentina,23,1998,3.3,3,1,0,3,0,0,4,0.0,4,5,0,5,1,4,3,0,Serie_A,2022_2023
Youssef Maleh,MAR,MF,Lecce,23,1998,7.5,17,8,3,7,7,6,14,42.9,8,20,1,19,5,22,10,0,Serie_A,2022_2023
Ruslan Malinovskyi,UKR,"MF,FW",Atalanta,29,1993,6.1,14,8,5,6,3,6,17,35.3,11,8,1,7,5,19,2,0,Serie_A,2022_2023
Gianluca Mancini,ITA,DF,Roma,26,1996,31.8,37,19,27,9,1,18,34,52.9,16,38,17,21,46,83,67,0,Serie_A,2022_2023
Rolando Mandragora,ITA,MF,Fiorentina,25,1997,21.7,42,24,12,22,8,23,52,44.2,29,25,3,22,16,58,21,0,Serie_A,2022_2023
Federico Marchetti,ITA,GK,Spezia,39,1983,0.7,0,0,0,0,0,0,0,,0,0,0,0,0,0,0,0,Serie_A,2022_2023
Riccardo Marchizza,ITA,DF,Sassuolo,24,1998,3.1,2,2,1,1,0,2,4,50.0,2,2,0,2,2,4,8,0,Serie_A,2022_2023
Gian Marco Ferrari,ITA,DF,Sassuolo,30,1992,24.7,23,16,11,10,2,10,17,58.8,7,29,20,9,23,46,81,4,Serie_A,2022_2023
Pablo Marí,ESP,DF,Monza,28,1993,27.6,37,19,29,7,1,17,26,65.4,9,22,14,8,31,68,111,3,Serie_A,2022_2023
Răzvan Marin,ROU,MF,Empoli,26,1996,28.2,44,22,22,21,1,19,40,47.5,21,29,11,18,14,58,33,0,Serie_A,2022_2023
Marlon,BRA,DF,Monza,26,1995,17.7,35,21,20,14,1,15,29,51.7,14,13,4,9,18,53,50,0,Serie_A,2022_2023
Luca Marrone,ITA,DF,Monza,32,1990,1.5,0,0,0,0,0,0,2,0.0,2,2,2,0,0,0,4,1,Serie_A,2022_2023
Lautaro Martínez,ARG,FW,Inter,24,1997,28.6,25,14,3,15,7,7,23,30.4,16,31,1,30,13,38,16,1,Serie_A,2022_2023
Lucas Martínez Quarta,ARG,DF,Fiorentina,26,1996,24.1,80,48,44,32,4,42,61,68.9,19,41,19,22,48,128,78,1,Serie_A,2022_2023
Adam Marušić,MNE,DF,Lazio,29,1992,30.7,41,30,23,14,4,25,39,64.1,14,20,6,14,38,79,63,1,Serie_A,2022_2023
Adam Masina,MAR,DF,Udinese,28,1994,8.8,10,7,7,3,0,6,15,40.0,9,11,4,7,10,20,28,1,Serie_A,2022_2023
Nemanja Matić,SRB,MF,Roma,33,1988,20.6,47,27,24,19,4,19,33,57.6,14,27,7,20,25,72,21,1,Serie_A,2022_2023
Luís Maximiano,POR,GK,Lazio,23,1999,0.1,0,0,0,0,0,0,0,,0,0,0,0,0,0,0,0,Serie_A,2022_2023
Pasquale Mazzocchi,ITA,DF,Salernitana,27,1995,21.8,32,18,21,5,6,17,37,45.9,20,10,2,8,10,42,37,2,Serie_A,2022_2023
Weston McKennie,USA,"MF,DF",Juventus,23,1998,11.7,14,5,3,9,2,5,8,62.5,3,15,4,11,11,25,15,1,Serie_A,2022_2023
Gary Medel,CHI,"MF,DF",Bologna,34,1987,16.4,25,15,16,7,2,9,16,56.3,7,17,10,7,28,53,34,0,Serie_A,2022_2023
Soualiho Meïté,FRA,MF,Cremonese,28,1994,26.3,47,31,25,15,7,22,46,47.8,24,27,6,21,27,74,36,0,Serie_A,2022_2023
Alex Meret,ITA,GK,Napoli,25,1997,34.0,0,0,0,0,0,0,0,,0,0,0,0,0,0,6,1,Serie_A,2022_2023
Yıldırım Mert Çetin,TUR,DF,Lecce,25,1997,0.2,1,0,1,0,0,0,0,,0,0,0,0,1,2,1,0,Serie_A,2022_2023
Junior Messias,BRA,"FW,DF",Milan,31,1991,16.6,24,18,9,9,6,5,19,26.3,14,20,4,16,7,31,28,0,Serie_A,2022_2023
Tommaso Milanese,ITA,MF,Cremonese,20,2002,0.3,0,0,0,0,0,0,0,,0,1,1,0,0,0,0,0,Serie_A,2022_2023
Nikola Milenković,SRB,DF,Fiorentina,24,1997,23.7,40,25,20,17,3,18,27,66.7,9,27,14,13,22,62,72,0,Serie_A,2022_2023
Arkadiusz Milik,POL,FW,Juventus,28,1994,17.6,12,8,2,8,2,2,8,25.0,6,10,1,9,1,13,14,0,Serie_A,2022_2023
Sergej Milinković-Savić,SRB,MF,Lazio,27,1995,33.6,58,35,22,23,13,24,67,35.8,43,50,12,38,28,86,49,0,Serie_A,2022_2023
Vanja Milinković-Savić,SRB,GK,Torino,25,1997,38.0,2,1,2,0,0,2,2,100.0,0,0,0,0,1,3,19,1,Serie_A,2022_2023
Kim Min-jae,KOR,DF,Napoli,25,1996,33.9,55,30,32,22,1,25,29,86.2,4,36,26,10,41,96,123,1,Serie_A,2022_2023
Aleksei Miranchuk,RUS,MF,Torino,26,1995,23.2,11,5,3,4,4,3,11,27.3,8,11,0,11,2,13,5,0,Serie_A,2022_2023
Antonio Mirante,ITA,GK,Milan,39,1983,0.0,0,0,0,0,0,0,0,,0,0,0,0,0,0,0,0,Serie_A,2022_2023
Fabio Miretti,ITA,"MF,FW",Juventus,18,2003,13.7,24,11,15,6,3,12,29,41.4,17,20,1,19,4,28,11,0,Serie_A,2022_2023
Filippo Missori,ITA,DF,Roma,18,2004,2.0,4,3,3,0,1,3,6,50.0,3,0,0,0,3,7,5,0,Serie_A,2022_2023
Henrikh Mkhitaryan,ARM,MF,Inter,33,1989,22.1,41,26,13,22,6,14,41,34.1,27,27,4,23,21,62,18,0,Serie_A,2022_2023
Salvatore Molina,ITA,DF,Monza,30,1992,2.5,6,5,2,4,0,4,5,80.0,1,4,2,2,1,7,2,0,Serie_A,2022_2023
Daniele Montevago,ITA,FW,Sampdoria,19,2003,2.6,1,0,0,0,1,0,1,0.0,1,2,1,1,0,1,1,0,Serie_A,2022_2023
Lorenzo Montipò,ITA,GK,Hellas Verona,26,1996,37.0,1,0,1,0,0,0,3,0.0,3,1,0,1,0,1,26,3,Serie_A,2022_2023
Nikola Moro,CRO,MF,Bologna,24,1998,13.6,32,21,11,15,6,14,36,38.9,22,15,2,13,8,40,18,0,Serie_A,2022_2023
Dany Mota,POR,"FW,MF",Monza,24,1998,21.2,8,7,1,3,4,2,10,20.0,8,5,1,4,6,14,25,0,Serie_A,2022_2023
João Moutinho,POR,"DF,FW",Spezia,24,1998,0.6,7,1,5,1,1,3,4,75.0,1,1,1,0,0,7,0,0,Serie_A,2022_2023
Mert Müldür,TUR,"FW,DF",Sassuolo,23,1999,0.1,0,0,0,0,0,0,0,,0,0,0,0,0,0,0,0,Serie_A,2022_2023
Luis Muriel,COL,"FW,MF",Atalanta,31,1991,11.9,9,6,2,3,4,5,16,31.3,11,9,0,9,2,11,2,0,Serie_A,2022_2023
Jeison Murillo,COL,DF,Sampdoria,30,1992,11.7,22,11,16,6,0,17,26,65.4,9,22,14,8,8,30,39,0,Serie_A,2022_2023
Nicola Murru,ITA,DF,Sampdoria,27,1994,8.7,24,14,15,8,1,7,13,53.8,6,17,7,10,10,34,21,0,Serie_A,2022_2023
Juan Musso,ARG,GK,Atalanta,28,1994,23.1,1,1,1,0,0,1,1,100.0,0,0,0,0,0,1,11,1,Serie_A,2022_2023
Joakim Mæhle,DEN,"DF,MF",Atalanta,25,1997,24.5,32,18,12,7,13,22,39,56.4,17,29,6,23,24,56,26,0,Serie_A,2022_2023
Herculano Nabian,POR,MF,Empoli,18,2004,0.0,0,0,0,0,0,0,0,,0,0,0,0,0,0,0,0,Serie_A,2022_2023
Michel Ndary Adopo,FRA,"MF,DF",Torino,22,2000,2.9,7,2,4,2,1,1,3,33.3,2,2,2,0,1,8,4,0,Serie_A,2022_2023
Tanguy Ndombele,FRA,MF,Napoli,25,1996,9.0,14,8,4,8,2,4,7,57.1,3,10,1,9,7,21,7,1,Serie_A,2022_2023
Ilija Nestorovski,MKD,"FW,MF",Udinese,32,1990,7.1,7,3,2,1,4,5,11,45.5,6,6,1,5,2,9,10,0,Serie_A,2022_2023
Cyril Ngonge,BEL,"MF,FW",Hellas Verona,22,2000,8.3,7,3,2,2,3,3,11,27.3,8,7,0,7,6,13,4,0,Serie_A,2022_2023
Hans Nicolussi Caviglia,ITA,MF,Salernitana,22,2000,6.5,15,6,5,8,2,9,15,60.0,6,9,0,9,7,22,7,1,Serie_A,2022_2023
Dimitris Nikolaou,GRE,DF,Spezia,23,1998,32.9,45,32,31,10,4,25,37,67.6,12,41,26,15,27,72,82,0,Serie_A,2022_2023
Samuel Ntanda,BEL,MF,Sampdoria,17,2005,0.0,0,0,0,0,0,0,0,,0,0,0,0,0,0,0,0,Serie_A,2022_2023
Bram Nuytinck,NED,DF,Udinese,32,1990,4.3,7,4,3,4,0,4,8,50.0,4,6,6,0,5,12,22,0,Serie_A,2022_2023
Bram Nuytinck,NED,DF,Sampdoria,32,1990,16.6,54,38,33,21,0,23,34,67.6,11,36,21,15,23,77,84,0,Serie_A,2022_2023
M'Bala Nzola,ANG,FW,Spezia,25,1996,29.5,12,5,0,6,6,3,9,33.3,6,20,6,14,7,19,21,0,Serie_A,2022_2023
Pedro Obiang,EQG,MF,Sassuolo,30,1992,9.7,26,17,12,12,2,10,18,55.6,8,12,2,10,8,34,15,0,Serie_A,2022_2023
Guillermo Ochoa,MEX,GK,Salernitana,37,1985,20.0,0,0,0,0,0,0,2,0.0,2,0,0,0,0,0,9,1,Serie_A,2022_2023
Marios Oikonomou,GRE,DF,Sampdoria,29,1992,2.4,3,2,3,0,0,1,3,33.3,2,5,4,1,4,7,13,0,Serie_A,2022_2023
David Okereke,NGA,"FW,MF",Cremonese,24,1997,25.2,12,8,4,5,3,3,16,18.8,13,23,3,20,10,22,12,0,Serie_A,2022_2023
Caleb Okoli,ITA,DF,Atalanta,21,2001,10.7,21,17,14,6,1,10,25,40.0,15,10,5,5,30,51,44,3,Serie_A,2022_2023
Mathías Olivera,URU,DF,Napoli,24,1997,18.3,39,23,16,16,7,22,43,51.2,21,28,2,26,22,61,26,0,Serie_A,2022_2023
André Onana,CMR,GK,Inter,26,1996,24.0,0,0,0,0,0,0,1,0.0,1,0,0,0,0,0,5,0,Serie_A,2022_2023
Divock Origi,BEL,FW,Milan,27,1995,11.4,10,5,4,3,3,5,10,50.0,5,6,2,4,0,10,13,0,Serie_A,2022_2023
Riccardo Orsolini,ITA,FW,Bologna,25,1997,23.6,30,19,15,10,5,17,41,41.5,24,29,3,26,8,38,18,0,Serie_A,2022_2023
Victor Osimhen,NGA,FW,Napoli,23,1998,28.5,10,6,1,2,7,0,7,0.0,7,6,1,5,6,16,29,0,Serie_A,2022_2023
Remi Oudin,FRA,"FW,MF",Lecce,25,1996,14.7,25,13,9,12,4,10,23,43.5,13,16,2,14,29,54,23,0,Serie_A,2022_2023
Adam Ounas,ALG,FW,Napoli,25,1996,0.2,0,0,0,0,0,0,0,,0,0,0,0,1,1,0,0,Serie_A,2022_2023
Simone Pafundi,ITA,"MF,FW",Udinese,16,2006,0.9,8,5,1,5,2,2,4,50.0,2,0,0,0,1,9,0,0,Serie_A,2022_2023
Flavio Paoletti,ITA,MF,Sampdoria,19,2003,3.2,2,2,0,2,0,1,5,20.0,4,1,0,1,5,7,9,0,Serie_A,2022_2023
Leandro Paredes,ARG,MF,Juventus,28,1994,10.9,19,13,7,11,1,10,22,45.5,12,8,0,8,17,36,22,0,Serie_A,2022_2023
Fabiano Parisi,ITA,DF,Empoli,21,2000,31.4,65,35,37,21,7,30,72,41.7,42,51,16,35,41,106,91,0,Serie_A,2022_2023
Mario Pašalić,CRO,"MF,FW",Atalanta,27,1995,19.7,22,10,6,14,2,6,23,26.1,17,22,4,18,21,43,13,0,Serie_A,2022_2023
Patric,ESP,DF,Lazio,29,1993,15.7,17,11,12,3,2,11,16,68.8,5,17,12,5,11,28,53,1,Serie_A,2022_2023
Rui Patrício,POR,GK,Roma,34,1988,35.0,1,1,1,0,0,1,1,100.0,0,0,0,0,2,3,6,3,Serie_A,2022_2023
Pedro,ESP,FW,Lazio,35,1987,21.1,35,24,14,10,11,11,30,36.7,19,18,2,16,6,41,4,1,Serie_A,2022_2023
Gianluca Pegolo,ITA,GK,Sassuolo,41,1981,2.0,0,0,0,0,0,0,1,0.0,1,0,0,0,0,0,1,0,Serie_A,2022_2023
Pietro Pellegri,ITA,FW,Torino,21,2001,5.2,6,2,1,3,2,2,3,66.7,1,5,1,4,0,6,4,0,Serie_A,2022_2023
Lorenzo Pellegrini,ITA,MF,Roma,26,1996,28.3,52,29,24,24,4,22,48,45.8,26,27,4,23,26,78,22,0,Serie_A,2022_2023
Luca Pellegrini,ITA,DF,Lazio,23,1999,2.0,1,0,0,1,0,1,4,25.0,3,3,0,3,7,8,4,0,Serie_A,2022_2023
Pepín,EQG,MF,Monza,25,1996,12.5,28,19,10,11,7,9,27,33.3,18,14,3,11,13,41,17,0,Serie_A,2022_2023
Roberto Pereyra,ARG,"DF,MF",Udinese,31,1991,31.3,36,20,21,12,3,16,44,36.4,28,20,5,15,16,52,28,0,Serie_A,2022_2023
Nehuén Pérez,ARG,DF,Udinese,22,2000,31.3,77,40,54,20,3,39,55,70.9,16,53,23,30,35,112,106,1,Serie_A,2022_2023
Simone Perilli,ITA,GK,Hellas Verona,27,1995,1.0,0,0,0,0,0,0,0,,0,0,0,0,0,0,0,0,Serie_A,2022_2023
Mattia Perin,ITA,GK,Juventus,29,1992,10.5,0,0,0,0,0,0,0,,0,0,0,0,0,0,0,0,Serie_A,2022_2023
Samuele Perisan,ITA,GK,Empoli,24,1997,7.0,0,0,0,0,0,0,0,,0,0,0,0,0,0,2,0,Serie_A,2022_2023
Matteo Pessina,ITA,MF,Monza,25,1997,32.6,57,36,28,21,8,26,62,41.9,36,50,15,35,37,94,33,1,Serie_A,2022_2023
Andrea Petagna,ITA,FW,Monza,27,1995,18.5,7,5,2,3,2,3,6,50.0,3,16,4,12,3,10,18,0,Serie_A,2022_2023
Giuseppe Pezzella,ITA,DF,Lecce,24,1997,10.2,21,9,16,2,3,9,16,56.3,7,11,3,8,8,29,31,1,Serie_A,2022_2023
Krzysztof Piątek,POL,FW,Salernitana,27,1995,23.8,18,11,3,9,6,5,21,23.8,16,17,4,13,2,20,39,0,Serie_A,2022_2023
Roberto Piccoli,ITA,FW,Hellas Verona,21,2001,2.1,1,0,1,0,0,0,2,0.0,2,2,0,2,0,1,2,0,Serie_A,2022_2023
Roberto Piccoli,ITA,FW,Empoli,21,2001,5.7,1,1,1,0,0,0,3,0.0,3,4,1,3,1,2,9,0,Serie_A,2022_2023
Charles Pickel,COD,MF,Cremonese,25,1997,27.6,55,23,25,26,4,32,57,56.1,25,37,5,32,24,79,36,1,Serie_A,2022_2023
Andrea Pinamonti,ITA,FW,Sassuolo,23,1999,24.0,10,7,0,5,5,3,7,42.9,4,19,2,17,2,12,11,0,Serie_A,2022_2023
Lorenzo Pirola,ITA,DF,Salernitana,20,2002,21.6,33,29,18,14,1,19,27,70.4,8,50,35,15,30,63,85,1,Serie_A,2022_2023
Niccolò Pisilli,ITA,MF,Roma,17,2004,0.0,0,0,0,0,0,0,0,,0,0,0,0,0,0,0,0,Serie_A,2022_2023
Marko Pjaca,CRO,"MF,FW",Empoli,27,1995,5.8,4,3,3,1,0,3,5,60.0,2,3,0,3,3,7,3,0,Serie_A,2022_2023
Tommaso Pobega,ITA,MF,Milan,23,1999,9.8,27,16,8,15,4,13,20,65.0,7,12,4,8,9,36,11,0,Serie_A,2022_2023
Paul Pogba,FRA,"MF,FW",Juventus,29,1993,1.2,0,0,0,0,0,0,1,0.0,1,0,0,0,0,0,2,0,Serie_A,2022_2023
Matteo Politano,ITA,FW,Napoli,28,1993,13.0,18,9,9,5,4,11,25,44.0,14,6,0,6,7,25,7,0,Serie_A,2022_2023
Marin Pongračić,CRO,DF,Lecce,24,1997,8.8,16,14,8,7,1,5,7,71.4,2,4,3,1,16,32,31,0,Serie_A,2022_2023
Stefan Posch,AUT,DF,Bologna,25,1997,28.1,81,43,41,29,11,44,75,58.7,31,44,15,29,35,116,69,0,Serie_A,2022_2023
Ivan Provedel,ITA,GK,Lazio,28,1994,37.9,1,0,1,0,0,0,0,,0,0,0,0,0,1,15,1,Serie_A,2022_2023
Ignacio Pussetto,ARG,"MF,DF",Sampdoria,26,1995,1.7,6,3,2,3,1,3,4,75.0,1,4,0,4,0,6,3,0,Serie_A,2022_2023
Niklas Pyyhtiä,FIN,MF,Bologna,18,2003,1.2,1,0,0,1,0,0,1,0.0,1,1,1,0,1,2,4,0,Serie_A,2022_2023
Fabio Quagliarella,ITA,FW,Sampdoria,39,1983,8.9,2,1,1,1,0,1,7,14.3,6,5,1,4,0,2,9,0,Serie_A,2022_2023
Giacomo Quagliata,ITA,DF,Cremonese,22,2000,7.8,10,8,7,1,2,5,11,45.5,6,7,2,5,11,21,8,0,Serie_A,2022_2023
Adrien Rabiot,FRA,MF,Juventus,27,1995,30.5,65,35,31,23,11,30,57,52.6,27,37,7,30,26,91,44,1,Serie_A,2022_2023
Nemanja Radonjić,SRB,"MF,FW",Torino,26,1996,16.2,2,1,2,0,0,0,4,0.0,4,3,0,3,2,4,4,0,Serie_A,2022_2023
Ivan Radovanović,SRB,"MF,DF",Salernitana,33,1988,7.5,12,4,8,4,0,4,10,40.0,6,9,3,6,7,19,9,1,Serie_A,2022_2023
Ionuț Radu,ROU,GK,Cremonese,25,1997,9.0,0,0,0,0,0,0,0,,0,0,0,0,0,0,1,3,Serie_A,2022_2023
Ștefan Radu,ROU,FW,Lazio,35,1986,0.0,0,0,0,0,0,0,0,,0,0,0,0,0,0,0,0,Serie_A,2022_2023
Antonio Raimondo,ITA,FW,Bologna,18,2004,0.2,0,0,0,0,0,0,0,,0,0,0,0,0,0,1,0,Serie_A,2022_2023
Luca Ranieri,ITA,DF,Fiorentina,23,1999,5.6,9,4,6,3,0,6,9,66.7,3,5,3,2,11,20,15,1,Serie_A,2022_2023
Andrea Ranocchia,ITA,DF,Monza,34,1988,0.5,3,1,1,2,0,3,4,75.0,1,5,5,0,0,3,7,0,Serie_A,2022_2023
Filippo Ranocchia,ITA,MF,Monza,21,2001,5.9,11,6,5,4,2,4,12,33.3,8,5,1,4,4,15,7,0,Serie_A,2022_2023
Giacomo Raspadori,ITA,FW,Sassuolo,22,2000,0.5,0,0,0,0,0,0,0,,0,0,0,0,0,0,0,0,Serie_A,2022_2023
Giacomo Raspadori,ITA,"FW,MF",Napoli,22,2000,10.1,10,8,0,6,4,4,10,40.0,6,9,0,9,4,14,4,0,Serie_A,2022_2023
Nicola Ravaglia,ITA,GK,Sampdoria,33,1988,9.0,0,0,0,0,0,0,1,0.0,1,0,0,0,0,0,7,0,Serie_A,2022_2023
Ante Rebić,CRO,"FW,MF",Milan,28,1993,10.9,10,8,1,3,6,3,11,27.3,8,6,1,5,1,11,5,0,Serie_A,2022_2023
Arkadiusz Reca,POL,DF,Spezia,27,1995,24.1,44,28,22,12,10,19,32,59.4,13,21,5,16,24,68,54,0,Serie_A,2022_2023
Panagiotis Retsos,GRE,DF,Hellas Verona,23,1998,1.4,5,4,2,2,1,3,3,100.0,0,4,1,3,2,7,3,0,Serie_A,2022_2023
Franck Ribéry,FRA,MF,Salernitana,39,1983,0.4,0,0,0,0,0,0,0,,0,1,0,1,0,0,0,0,Serie_A,2022_2023
Samuele Ricci,ITA,MF,Torino,20,2001,23.0,32,21,17,10,5,18,23,78.3,5,20,5,15,17,49,29,1,Serie_A,2022_2023
Tomás Rincón,VEN,MF,Sampdoria,34,1988,28.4,56,27,22,26,8,29,61,47.5,32,37,7,30,30,86,18,0,Serie_A,2022_2023
Pablo Rodríguez,ESP,"FW,MF",Lecce,20,2001,0.6,2,1,2,0,0,0,2,0.0,2,3,0,3,0,2,0,0,Serie_A,2022_2023
Ricardo Rodríguez,SUI,DF,Torino,29,1992,29.7,54,33,30,17,7,28,42,66.7,14,30,15,15,38,92,61,0,Serie_A,2022_2023
Rogério,BRA,DF,Sassuolo,24,1998,33.3,37,21,22,8,7,17,35,48.6,18,32,9,23,37,74,70,0,Serie_A,2022_2023
Filippo Romagna,ITA,DF,Sassuolo,25,1997,0.5,0,0,0,0,0,0,0,,0,1,1,0,0,0,2,0,Serie_A,2022_2023
Alessio Romagnoli,ITA,DF,Lazio,27,1995,32.5,33,15,19,14,0,11,22,50.0,11,33,26,7,38,71,108,0,Serie_A,2022_2023
Simone Romagnoli,ITA,DF,Lecce,32,1990,1.9,6,5,3,3,0,2,2,100.0,0,4,1,3,1,7,11,0,Serie_A,2022_2023
Luka Romero,ARG,FW,Lazio,17,2004,1.7,0,0,0,0,0,0,3,0.0,3,4,0,4,3,3,1,0,Serie_A,2022_2023
Marten de Roon,NED,MF,Atalanta,31,1991,32.9,77,39,37,35,5,37,81,45.7,44,37,4,33,36,113,58,0,Serie_A,2022_2023
Francesco Rossi,ITA,GK,Atalanta,31,1991,0.0,0,0,0,0,0,0,0,,0,0,0,0,0,0,0,0,Serie_A,2022_2023
Nicolò Rovella,ITA,MF,Monza,20,2001,19.3,45,29,22,21,2,13,36,36.1,23,20,1,19,40,85,17,0,Serie_A,2022_2023
Nicolò Rovella,ITA,MF,Juventus,20,2001,0.3,1,1,0,1,0,1,1,100.0,0,0,0,0,0,1,0,0,Serie_A,2022_2023
Amir Rrahmani,KVX,DF,Napoli,28,1994,27.2,33,18,20,13,0,17,26,65.4,9,36,20,16,14,47,79,1,Serie_A,2022_2023
Ruan,BRA,DF,Sassuolo,23,1999,19.0,38,26,25,12,1,19,29,65.5,10,29,17,12,24,62,80,3,Serie_A,2022_2023
Daniele Rugani,ITA,DF,Juventus,28,1994,6.3,7,0,6,1,0,4,4,100.0,0,7,5,2,7,14,32,0,Serie_A,2022_2023
Matteo Ruggeri,ITA,"DF,MF",Atalanta,20,2002,9.2,17,12,5,9,3,8,16,50.0,8,14,3,11,12,29,16,0,Serie_A,2022_2023
Mário Rui,POR,DF,Napoli,31,1991,19.4,34,22,17,13,4,20,41,48.8,21,17,4,13,15,49,24,1,Serie_A,2022_2023
Alessandro Russo,ITA,GK,Sassuolo,21,2001,1.0,0,0,0,0,0,0,0,,0,0,0,0,0,0,1,1,Serie_A,2022_2023
Abdelhamid Sabiri,MAR,"MF,FW",Sampdoria,25,1996,11.9,18,7,5,9,4,4,13,30.8,9,18,4,14,2,20,5,0,Serie_A,2022_2023
Alexis Saelemaekers,BEL,"FW,DF",Milan,23,1999,15.6,31,20,12,16,3,19,41,46.3,22,13,1,12,19,50,11,0,Serie_A,2022_2023
Jacopo Sala,ITA,MF,Spezia,30,1991,1.2,1,0,1,0,0,0,2,0.0,2,2,0,2,1,2,2,0,Serie_A,2022_2023
Lazar Samardzic,SRB,MF,Udinese,20,2002,20.5,33,16,9,20,4,17,43,39.5,26,13,0,13,11,44,16,0,Serie_A,2022_2023
Junior Sambia,FRA,DF,Salernitana,25,1996,7.7,12,5,7,4,1,6,10,60.0,4,9,3,6,8,20,16,1,Serie_A,2022_2023
Antonio Sanabria,PAR,FW,Torino,26,1996,27.0,11,5,3,3,5,1,7,14.3,6,9,2,7,4,15,7,0,Serie_A,2022_2023
Leandro Sanca,GNB,"FW,MF",Spezia,22,2000,0.4,1,1,0,0,1,1,1,100.0,0,0,0,0,0,1,0,0,Serie_A,2022_2023
Alex Sandro,BRA,DF,Juventus,31,1991,19.9,35,20,16,16,3,15,22,68.2,7,27,10,17,15,50,64,1,Serie_A,2022_2023
Nicola Sansone,ITA,FW,Bologna,30,1991,8.2,12,4,6,4,2,5,10,50.0,5,0,0,0,0,12,4,0,Serie_A,2022_2023
Riccardo Saponara,ITA,FW,Fiorentina,30,1991,13.4,10,5,3,6,1,5,9,55.6,4,7,1,6,5,15,9,1,Serie_A,2022_2023
Mouhamadou Sarr,SEN,GK,Cremonese,25,1997,2.0,0,0,0,0,0,0,0,,0,0,0,0,0,0,2,0,Serie_A,2022_2023
Martin Satriano,URU,FW,Empoli,21,2001,18.9,13,8,5,6,2,6,14,42.9,8,5,0,5,3,16,22,0,Serie_A,2022_2023
Giorgio Scalvini,ITA,DF,Atalanta,18,2003,25.9,54,29,30,18,6,29,55,52.7,26,36,13,23,56,110,57,2,Serie_A,2022_2023
Jerdy Schouten,NED,MF,Bologna,25,1997,27.9,63,38,28,33,2,27,49,55.1,22,40,17,23,40,103,43,1,Serie_A,2022_2023
Perr Schuurs,NED,DF,Torino,22,1999,25.8,51,25,29,17,5,14,26,53.8,12,28,16,12,28,79,102,0,Serie_A,2022_2023
Demba Seck,SEN,"MF,FW",Torino,21,2001,5.8,5,2,3,2,0,2,3,66.7,1,3,1,2,1,6,1,0,Serie_A,2022_2023
Telasco Segovia,VEN,MF,Sampdoria,19,2003,0.0,0,0,0,0,0,0,0,,0,0,0,0,0,0,0,0,Serie_A,2022_2023
Jacopo Segre,ITA,DF,Torino,25,1997,0.2,0,0,0,0,0,0,0,,0,0,0,0,0,0,0,0,Serie_A,2022_2023
Vivaldo Semedo,POR,"FW,MF",Udinese,17,2005,0.4,0,0,0,0,0,0,0,,0,1,0,1,0,0,1,0,Serie_A,2022_2023
Stefano Sensi,ITA,MF,Monza,26,1995,18.0,41,26,25,13,3,18,48,37.5,30,13,3,10,20,61,4,0,Serie_A,2022_2023
Luigi Sepe,ITA,GK,Salernitana,31,1991,17.0,0,0,0,0,0,0,1,0.0,1,0,0,0,0,0,0,0,Serie_A,2022_2023
Leonardo Sernicola,ITA,DF,Cremonese,25,1997,25.7,45,33,25,13,7,29,43,67.4,14,23,6,17,38,83,55,0,Serie_A,2022_2023
Stephan El Shaarawy,ITA,"DF,MF",Roma,29,1992,16.9,21,9,8,10,3,6,22,27.3,16,11,1,10,15,36,11,0,Serie_A,2022_2023
Eldor Shomurodov,UZB,FW,Spezia,27,1995,9.0,5,5,3,1,1,2,11,18.2,9,5,1,4,3,8,4,0,Serie_A,2022_2023
Eldor Shomurodov,UZB,FW,Roma,27,1995,1.3,1,0,1,0,0,0,2,0.0,2,1,0,1,1,2,0,0,Serie_A,2022_2023
Marco Silvestri,ITA,GK,Udinese,31,1991,38.0,2,1,2,0,0,2,3,66.7,1,0,0,0,1,3,15,1,Serie_A,2022_2023
Giovanni Simeone,ARG,FW,Napoli,27,1995,4.5,12,3,3,5,4,3,8,37.5,5,2,1,1,1,13,4,0,Serie_A,2022_2023
Wilfried Singo,CIV,DF,Torino,21,2000,22.7,27,17,14,10,3,12,19,63.2,7,15,2,13,12,39,33,1,Serie_A,2022_2023
Salvatore Sirigu,ITA,GK,Fiorentina,35,1987,1.0,0,0,0,0,0,0,0,,0,0,0,0,0,0,1,0,Serie_A,2022_2023
Leo Skiri Østigård,NOR,DF,Napoli,22,1999,4.7,4,1,3,1,0,1,1,100.0,0,3,3,0,6,10,18,1,Serie_A,2022_2023
Łukasz Skorupski,POL,GK,Bologna,31,1991,37.0,2,1,2,0,0,1,2,50.0,1,0,0,0,0,2,19,2,Serie_A,2022_2023
Milan Škriniar,SVK,DF,Inter,27,1995,19.7,29,18,14,11,4,18,32,56.3,14,18,13,5,13,42,46,3,Serie_A,2022_2023
Chris Smalling,ENG,DF,Roma,32,1989,31.2,26,15,16,10,0,13,21,61.9,8,51,36,15,43,69,123,0,Serie_A,2022_2023
Ola Solbakken,NOR,"MF,FW",Roma,23,1998,5.6,2,2,1,1,0,2,7,28.6,5,2,0,2,2,4,8,0,Serie_A,2022_2023
Brandon Soppy,FRA,DF,Udinese,20,2002,1.0,1,1,0,1,0,0,0,,0,4,0,4,1,2,1,0,Serie_A,2022_2023
Brandon Soppy,FRA,DF,Atalanta,20,2002,7.1,8,5,4,4,0,3,9,33.3,6,10,0,10,3,11,7,0,Serie_A,2022_2023
Roberto Soriano,ITA,"FW,MF",Bologna,31,1991,14.7,31,16,9,16,6,13,25,52.0,12,23,2,21,6,37,14,0,Serie_A,2022_2023
Joaquin Sosa,URU,DF,Bologna,20,2002,7.6,6,2,5,1,0,4,18,22.2,14,5,3,2,6,12,31,0,Serie_A,2022_2023
Riccardo Sottil,ITA,FW,Fiorentina,23,1999,9.3,4,3,2,0,2,2,5,40.0,3,2,0,2,0,4,0,0,Serie_A,2022_2023
Matìas Soulé,ARG,"MF,FW",Juventus,19,2003,4.7,7,4,3,2,2,5,7,71.4,2,7,1,6,3,10,3,0,Serie_A,2022_2023
Adama Soumaoro,FRA,DF,Bologna,30,1992,20.7,25,17,11,12,2,5,7,71.4,2,18,13,5,15,40,75,1,Serie_A,2022_2023
Leonardo Spinazzola,ITA,DF,Roma,29,1993,18.4,15,8,7,6,2,8,23,34.8,15,13,3,10,9,24,25,0,Serie_A,2022_2023
Marco Sportiello,ITA,GK,Atalanta,30,1992,14.9,1,0,1,0,0,1,3,33.3,2,0,0,0,0,1,2,0,Serie_A,2022_2023
Petar Stojanović,SVN,DF,Empoli,26,1995,17.0,42,22,28,10,4,26,43,60.5,17,17,5,12,11,53,55,0,Serie_A,2022_2023
Gabriel Strefezza,BRA,"FW,MF",Lecce,25,1997,27.1,50,24,18,20,12,27,53,50.9,26,36,3,33,16,66,15,0,Serie_A,2022_2023
Dávid Strelec,SVK,FW,Spezia,21,2001,1.9,2,2,0,1,1,2,2,100.0,0,0,0,0,0,2,0,0,Serie_A,2022_2023
Isaac Success,NGA,FW,Udinese,26,1996,20.2,8,4,2,5,1,3,8,37.5,5,13,2,11,4,12,18,0,Serie_A,2022_2023
Ibrahim Sulemana,GHA,MF,Hellas Verona,19,2003,7.2,19,13,10,7,2,6,12,50.0,6,8,2,6,14,33,15,0,Serie_A,2022_2023
Mile Svilar,SRB,GK,Roma,22,1999,3.0,0,0,0,0,0,0,0,,0,0,0,0,0,0,1,0,Serie_A,2022_2023
Wojciech Szczęsny,POL,GK,Juventus,32,1990,27.5,1,0,1,0,0,0,1,0.0,1,0,0,0,0,1,7,0,Serie_A,2022_2023
Benjamin Tahirovic,BIH,MF,Roma,19,2003,3.9,8,5,5,2,1,4,12,33.3,8,9,4,5,3,11,3,0,Serie_A,2022_2023
Adrien Tameze,CMR,MF,Hellas Verona,28,1994,33.7,51,30,21,26,4,28,63,44.4,35,51,14,37,37,88,55,2,Serie_A,2022_2023
Ciprian Tătărușanu,ROU,GK,Milan,36,1986,16.0,0,0,0,0,0,0,0,,0,0,0,0,1,1,2,0,Serie_A,2022_2023
Filippo Terracciano,ITA,"DF,MF",Hellas Verona,19,2003,9.1,20,13,11,7,2,15,20,75.0,5,7,4,3,10,30,14,0,Serie_A,2022_2023
Pietro Terracciano,ITA,GK,Fiorentina,32,1990,29.0,2,1,2,0,0,2,3,66.7,1,0,0,0,1,3,14,0,Serie_A,2022_2023
Aleksa Terzić,SRB,DF,Fiorentina,22,1999,10.4,16,9,9,4,3,11,21,52.4,10,13,4,9,5,21,16,0,Serie_A,2022_2023
Florian Thauvin,FRA,"FW,MF",Udinese,29,1993,6.1,2,1,0,2,0,2,13,15.4,11,5,0,5,2,4,2,0,Serie_A,2022_2023
Malick Thiaw,GER,DF,Milan,20,2001,15.1,31,26,22,9,0,11,20,55.0,9,11,5,6,12,43,65,1,Serie_A,2022_2023
Kristian Thorstvedt,NOR,MF,Sassuolo,23,1999,12.6,16,7,4,9,3,6,17,35.3,11,19,5,14,14,30,13,0,Serie_A,2022_2023
Jeremy Toljan,GER,DF,Sassuolo,27,1994,29.7,36,23,17,14,5,22,33,66.7,11,31,14,17,18,54,60,1,Serie_A,2022_2023
Rafael Tolói,ITA,DF,Atalanta,31,1990,30.9,69,44,37,32,0,35,64,54.7,29,42,18,24,57,126,88,1,Serie_A,2022_2023
Fikayo Tomori,ENG,DF,Milan,24,1997,30.7,70,34,44,25,1,22,34,64.7,12,46,25,21,29,99,88,1,Serie_A,2022_2023
Sandro Tonali,ITA,MF,Milan,22,2000,30.1,64,41,35,24,5,27,44,61.4,17,34,9,25,25,89,26,1,Serie_A,2022_2023
Lorenzo Tonelli,ITA,DF,Empoli,32,1990,0.2,0,0,0,0,0,0,1,0.0,1,0,0,0,0,0,0,0,Serie_A,2022_2023
William Troost-Ekong,NGA,DF,Salernitana,28,1993,4.9,11,3,7,4,0,6,7,85.7,1,7,4,3,6,17,10,0,Serie_A,2022_2023
Frank Tsadjout,ITA,FW,Cremonese,23,1999,11.7,10,8,3,6,1,3,9,33.3,6,7,1,6,8,18,9,0,Serie_A,2022_2023
Alessandro Tuia,ITA,DF,Lecce,32,1990,5.7,10,6,6,4,0,3,9,33.3,6,3,1,2,15,25,29,0,Serie_A,2022_2023
Martin Turk,SVN,GK,Sampdoria,18,2003,4.0,0,0,0,0,0,0,0,,0,0,0,0,0,0,1,0,Serie_A,2022_2023
Destiny Udogie,ITA,DF,Udinese,19,2002,30.0,71,45,42,24,5,34,59,57.6,25,34,6,28,36,107,25,0,Serie_A,2022_2023
Samir Ujkani,KVX,GK,Empoli,34,1988,0.1,0,0,0,0,0,0,0,,0,0,0,0,0,0,0,0,Serie_A,2022_2023
Samuel Umtiti,FRA,DF,Lecce,28,1993,23.5,52,34,25,25,2,18,26,69.2,8,26,14,12,26,78,79,0,Serie_A,2022_2023
Diego Valencia,CHI,"MF,FW",Salernitana,22,2000,2.6,8,5,4,2,2,2,9,22.2,7,10,1,9,1,9,2,0,Serie_A,2022_2023
Emanuele Valeri,ITA,DF,Cremonese,23,1998,30.9,54,27,29,21,4,29,69,42.0,40,17,3,14,22,76,44,1,Serie_A,2022_2023
Mattia Valoti,ITA,"MF,FW",Monza,28,1993,5.0,17,10,7,9,1,5,16,31.3,11,13,3,10,3,20,6,0,Serie_A,2022_2023
Johan Vásquez,MEX,DF,Cremonese,23,1998,20.1,41,26,34,7,0,18,39,46.2,21,27,20,7,45,86,93,1,Serie_A,2022_2023
Matías Vecino,URU,MF,Lazio,30,1991,18.8,47,27,13,23,11,23,48,47.9,25,33,10,23,16,63,39,1,Serie_A,2022_2023
Miguel Veloso,POR,MF,Hellas Verona,36,1986,12.9,33,10,20,12,1,16,26,61.5,10,26,6,20,6,39,14,0,Serie_A,2022_2023
Lorenzo Venuti,ITA,DF,Fiorentina,27,1995,10.3,18,7,6,11,1,11,18,61.1,7,7,2,5,5,23,17,2,Serie_A,2022_2023
Daniele Verde,ITA,"FW,MF",Spezia,26,1996,11.1,4,4,3,0,1,3,7,42.9,4,6,0,6,8,12,4,0,Serie_A,2022_2023
Simone Verdi,ITA,"MF,FW",Hellas Verona,30,1992,12.2,15,10,7,5,3,6,17,35.3,11,8,1,7,0,15,2,0,Serie_A,2022_2023
Valerio Verre,ITA,MF,Sampdoria,28,1994,7.5,14,7,6,5,3,8,17,47.1,9,9,1,8,9,23,3,0,Serie_A,2022_2023
Guglielmo Vicario,ITA,GK,Empoli,25,1996,30.9,1,1,1,0,0,1,2,50.0,1,0,0,0,0,1,15,2,Serie_A,2022_2023
Ronaldo Vieira,ENG,MF,Torino,24,1998,0.2,1,0,0,1,0,1,1,100.0,0,0,0,0,0,1,2,0,Serie_A,2022_2023
Ronaldo Vieira,ENG,MF,Sampdoria,24,1998,9.1,18,10,4,12,2,10,13,76.9,3,15,5,10,13,31,10,2,Serie_A,2022_2023
Emanuel Vignato,ITA,"MF,FW",Bologna,21,2000,2.7,4,4,2,2,0,2,4,50.0,2,2,0,2,3,7,0,0,Serie_A,2022_2023
Emanuel Vignato,ITA,"MF,FW",Empoli,21,2000,0.6,2,0,2,0,0,0,0,,0,0,0,0,0,2,1,0,Serie_A,2022_2023
Samuele Vignato,ITA,"MF,FW",Monza,18,2004,0.7,0,0,0,0,0,0,0,,0,1,0,1,0,0,0,0,Serie_A,2022_2023
Tonny Vilhena,NED,MF,Salernitana,27,1995,25.2,44,22,16,23,5,20,50,40.0,30,17,7,10,18,62,21,0,Serie_A,2022_2023
Gonzalo Villar,ESP,MF,Sampdoria,24,1998,7.7,13,7,4,8,1,7,15,46.7,8,11,3,8,4,17,9,1,Serie_A,2022_2023
Matías Viña,URU,DF,Roma,24,1997,0.6,3,1,1,1,1,1,3,33.3,2,5,1,4,2,5,5,0,Serie_A,2022_2023
Dušan Vlahović,SRB,FW,Juventus,22,2000,21.4,11,6,0,7,4,4,10,40.0,6,10,3,7,3,14,8,1,Serie_A,2022_2023
Nikola Vlašić,CRO,"MF,FW",Torino,24,1997,30.3,32,21,9,16,7,15,34,44.1,19,25,2,23,10,42,14,0,Serie_A,2022_2023
Joel Voelkerling Persson,SWE,"FW,MF",Lecce,19,2003,1.1,1,1,0,0,1,0,1,0.0,1,1,0,1,0,1,0,0,Serie_A,2022_2023
Mërgim Vojvoda,KVX,DF,Torino,27,1995,19.1,22,12,15,6,1,12,24,50.0,12,14,2,12,10,32,31,1,Serie_A,2022_2023
Cristian Volpato,ITA,MF,Roma,18,2003,2.5,3,2,1,1,1,0,2,0.0,2,2,0,2,2,5,0,0,Serie_A,2022_2023
Lukáš Vorlický,CZE,"MF,FW",Atalanta,20,2002,0.3,0,0,0,0,0,0,0,,0,0,0,0,1,1,0,0,Serie_A,2022_2023
Aster Vranckx,BEL,MF,Milan,19,2002,2.7,3,2,0,2,1,2,7,28.6,5,3,1,2,2,5,1,0,Serie_A,2022_2023
Stefan de Vrij,NED,DF,Inter,30,1992,21.6,28,18,19,9,0,8,14,57.1,6,18,10,8,40,68,80,0,Serie_A,2022_2023
Walace,BRA,MF,Udinese,27,1995,35.4,82,39,42,31,9,41,90,45.6,49,47,12,35,51,133,51,1,Serie_A,2022_2023
Sebastian Walukiewicz,POL,DF,Empoli,22,2000,6.7,9,6,7,2,0,4,6,66.7,2,10,9,1,7,16,30,0,Serie_A,2022_2023
Georginio Wijnaldum,NED,MF,Roma,31,1990,8.5,4,3,1,3,0,0,2,0.0,2,7,1,6,2,6,3,0,Serie_A,2022_2023
Harry Winks,ENG,MF,Sampdoria,26,1996,19.1,27,12,7,18,2,14,43,32.6,29,14,8,6,24,51,24,0,Serie_A,2022_2023
Przemysław Wiśniewski,POL,DF,Spezia,24,1998,11.1,13,6,7,6,0,6,18,33.3,12,16,8,8,11,24,66,0,Serie_A,2022_2023
Gerard Yepes,ESP,MF,Sampdoria,19,2002,2.2,5,3,2,3,0,1,3,33.3,2,3,0,3,4,9,3,0,Serie_A,2022_2023
Mattia Zaccagni,ITA,FW,Lazio,27,1995,30.8,42,28,16,18,8,14,38,36.8,24,37,3,34,21,63,10,1,Serie_A,2022_2023
Denis Zakaria,SUI,MF,Juventus,25,1996,1.4,6,3,1,4,1,2,2,100.0,0,2,0,2,2,8,1,0,Serie_A,2022_2023
Nicola Zalewski,POL,DF,Roma,20,2002,24.4,45,26,25,15,5,22,71,31.0,49,27,1,26,31,76,23,0,Serie_A,2022_2023
Andre-Frank Zambo Anguissa,CMR,MF,Napoli,26,1995,33.9,53,32,16,29,8,16,64,25.0,48,50,4,46,49,102,25,0,Serie_A,2022_2023
Luca Zanimacchia,ITA,"MF,FW",Cremonese,24,1998,8.3,21,13,11,6,4,8,21,38.1,13,9,0,9,9,30,5,0,Serie_A,2022_2023
Nicolò Zaniolo,ITA,"MF,FW",Roma,23,1999,9.9,7,5,2,4,1,2,7,28.6,5,11,0,11,2,9,0,0,Serie_A,2022_2023
Alessandro Zanoli,ITA,DF,Sampdoria,21,2000,17.1,22,14,14,6,2,8,17,47.1,9,19,15,4,12,34,39,0,Serie_A,2022_2023
Alessandro Zanoli,ITA,DF,Napoli,21,2000,0.1,1,0,0,1,0,0,0,,0,0,0,0,0,1,1,0,Serie_A,2022_2023
Mattia Zanotti,ITA,DF,Inter,19,2003,0.3,0,0,0,0,0,0,1,0.0,1,2,0,2,0,0,0,0,Serie_A,2022_2023
Duván Zapata,COL,FW,Atalanta,31,1991,15.4,8,4,1,3,4,3,5,60.0,2,6,2,4,4,12,17,1,Serie_A,2022_2023
Davide Zappacosta,ITA,DF,Atalanta,30,1992,16.3,34,18,17,12,5,15,22,68.2,7,23,2,21,9,43,16,0,Serie_A,2022_2023
Karim Zedadka,FRA,FW,Napoli,22,2000,0.2,0,0,0,0,0,0,0,,0,0,0,0,0,0,1,0,Serie_A,2022_2023
Deyovaisio Zeefuik,NED,DF,Hellas Verona,24,1998,0.1,1,1,0,1,0,0,0,,0,0,0,0,0,1,0,0,Serie_A,2022_2023
Marvin Zeegelaar,NED,DF,Udinese,31,1990,3.9,8,4,6,2,0,3,4,75.0,1,2,0,2,3,11,5,0,Serie_A,2022_2023
Alessio Zerbin,ITA,FW,Napoli,23,1999,2.2,10,5,4,5,1,4,8,50.0,4,2,0,2,2,12,2,0,Serie_A,2022_2023
Piotr Zieliński,POL,MF,Napoli,28,1994,25.4,17,10,1,11,5,12,25,48.0,13,16,5,11,14,31,7,0,Serie_A,2022_2023
David Zima,CZE,DF,Torino,21,2000,4.5,9,5,5,4,0,3,4,75.0,1,7,2,5,9,18,11,2,Serie_A,2022_2023
Joshua Zirkzee,NED,FW,Bologna,21,2001,9.1,4,2,1,1,2,2,7,28.6,5,4,1,3,4,8,4,0,Serie_A,2022_2023
Jeroen Zoet,NED,GK,Spezia,31,1991,3.7,1,1,1,0,0,1,1,100.0,0,0,0,0,0,1,1,0,Serie_A,2022_2023
Nadir Zortea,ITA,"DF,MF",Atalanta,23,1999,2.5,10,5,3,7,0,3,4,75.0,1,4,0,4,0,10,4,0,Serie_A,2022_2023
Nadir Zortea,ITA,DF,Sassuolo,23,1999,7.3,15,8,12,2,1,9,14,64.3,5,10,4,6,4,19,21,0,Serie_A,2022_2023
Petar Zovko,BIH,GK,Spezia,20,2002,0.8,1,0,1,0,0,1,1,100.0,0,0,0,0,0,1,0,0,Serie_A,2022_2023
Szymon Żurkowski,POL,MF,Fiorentina,24,1997,0.4,0,0,0,0,0,0,0,,0,0,0,0,0,0,0,0,Serie_A,2022_2023
Szymon Żurkowski,POL,MF,Spezia,24,1997,4.7,9,3,4,4,1,2,15,13.3,13,9,2,7,4,13,6,0,Serie_A,2022_2023
Milan Đurić,BIH,FW,Hellas Verona,32,1990,15.2,2,1,1,0,1,1,3,33.3,2,7,4,3,1,3,24,0,Serie_A,2022_2023
Filip Đuričić,SRB,"MF,FW",Sampdoria,30,1992,24.1,43,22,18,20,5,14,32,43.8,18,19,6,13,7,50,8,0,Serie_A,2022_2023
Dickson Abiama,NGA,FW,Greuther Fürth,22,1998,8.1,11,7,4,5,2,2,10,20.0,8,12,1,11,4,15,8,0,Bundesliga,2021_2022
Ragnar Ache,GER,"MF,FW",Eint Frankfurt,23,1998,2.9,2,0,0,1,1,1,4,25.0,3,3,0,3,0,2,1,0,Bundesliga,2021_2022
Tyler Adams,USA,MF,RB Leipzig,22,1999,15.0,23,7,5,16,2,7,25,28.0,18,24,1,23,16,39,19,2,Bundesliga,2021_2022
Sargis Adamyan,ARM,"FW,MF",Hoffenheim,28,1993,3.7,8,6,3,4,1,3,11,27.3,8,4,0,4,1,9,2,0,Bundesliga,2021_2022
Amine Adli,MAR,"FW,MF",Leverkusen,21,2000,14.0,27,14,10,14,3,8,15,53.3,7,26,2,24,11,38,12,0,Bundesliga,2021_2022
Naouirou Ahamada,FRA,"MF,DF",Stuttgart,19,2002,0.7,1,0,1,0,0,1,3,33.3,2,0,0,0,0,1,0,0,Bundesliga,2021_2022
Manuel Akanji,SUI,DF,Dortmund,26,1995,25.1,33,23,20,11,2,22,32,68.8,10,26,15,11,35,68,58,0,Bundesliga,2021_2022
Kevin Akpoguma,NGA,"DF,FW",Hoffenheim,26,1995,17.0,33,19,16,11,6,16,28,57.1,12,32,2,30,20,53,29,2,Bundesliga,2021_2022
Lucas Alario,ARG,FW,Leverkusen,28,1992,7.3,6,5,0,2,4,2,5,40.0,3,5,0,5,1,7,6,0,Bundesliga,2021_2022
Nadiem Amiri,GER,"MF,FW",Leverkusen,24,1996,4.1,8,4,3,2,3,4,8,50.0,4,4,2,2,5,13,0,0,Bundesliga,2021_2022
Sebastian Andersson,SWE,FW,Köln,30,1991,14.0,11,7,0,3,8,3,9,33.3,6,8,0,8,3,14,14,0,Bundesliga,2021_2022
Andrés Andrade Cedeño,PAN,DF,Arminia,22,1998,11.6,27,16,18,8,1,17,35,48.6,18,16,7,9,19,46,44,0,Bundesliga,2021_2022
Fredrik André Bjørkan,NOR,DF,Hertha BSC,22,1998,3.9,12,10,7,4,1,7,9,77.8,2,6,2,4,6,18,8,0,Bundesliga,2021_2022
Robert Andrich,GER,MF,Leverkusen,26,1994,20.2,33,17,18,14,1,14,28,50.0,14,19,7,12,31,64,46,0,Bundesliga,2021_2022
Angeliño,ESP,DF,RB Leipzig,24,1997,25.5,28,21,14,13,1,14,30,46.7,16,24,3,21,29,57,40,0,Bundesliga,2021_2022
Waldemar Anton,GER,DF,Stuttgart,25,1996,28.8,40,26,22,15,3,19,32,59.4,13,27,16,11,32,72,116,1,Bundesliga,2021_2022
Christopher Antwi-Adjei,GHA,"FW,MF",Bochum,27,1994,12.6,21,18,7,8,6,6,26,23.1,20,12,0,12,1,22,8,0,Bundesliga,2021_2022
Charles Aránguiz,CHI,MF,Leverkusen,32,1989,17.5,45,25,18,21,6,22,52,42.3,30,24,4,20,33,78,21,0,Bundesliga,2021_2022
Maximilian Arnold,GER,MF,Wolfsburg,27,1994,33.3,37,20,19,16,2,20,50,40.0,30,43,15,28,37,74,55,0,Bundesliga,2021_2022
Takuma Asano,JPN,"FW,MF",Bochum,26,1994,17.9,11,6,3,6,2,5,19,26.3,14,14,1,13,7,18,7,0,Bundesliga,2021_2022
Santiago Ascacíbar,ARG,MF,Hertha BSC,24,1997,26.4,93,54,50,37,6,38,89,42.7,51,31,6,25,41,134,42,0,Bundesliga,2021_2022
Fisnik Asllani,KVX,"MF,FW",Hoffenheim,18,2002,0.1,0,0,0,0,0,0,1,0.0,1,0,0,0,0,0,0,0,Bundesliga,2021_2022
Simon Asta,GER,DF,Greuther Fürth,20,2001,8.7,13,6,4,5,4,4,8,50.0,4,14,2,12,8,21,16,0,Bundesliga,2021_2022
Taiwo Awoniyi,NGA,FW,Union Berlin,23,1997,24.2,11,7,3,6,2,1,9,11.1,8,11,2,9,2,13,29,0,Bundesliga,2021_2022
Sardar Azmoun,IRN,"FW,MF",Leverkusen,26,1995,4.0,3,1,0,2,1,0,5,0.0,5,2,0,2,0,3,8,0,Bundesliga,2021_2022
Mitchel Bakker,NED,DF,Leverkusen,21,2000,20.2,33,22,16,12,5,20,34,58.8,14,13,2,11,23,56,42,3,Bundesliga,2021_2022
Ridle Baku,GER,"DF,FW",Wolfsburg,23,1998,27.2,62,37,30,24,8,25,65,38.5,40,43,1,42,21,83,52,1,Bundesliga,2021_2022
Aymen Barkok,MAR,"MF,DF",Eint Frankfurt,23,1998,1.8,6,2,2,3,1,2,7,28.6,5,4,1,3,5,11,6,0,Bundesliga,2021_2022
Leandro Barreiro Martins,LUX,MF,Mainz 05,21,2000,19.9,63,32,23,27,13,29,50,58.0,21,23,6,17,32,95,23,0,Bundesliga,2021_2022
Jacob Barrett Laursen,DEN,DF,Arminia,26,1994,18.1,16,12,10,6,0,8,21,38.1,13,19,7,12,28,44,43,0,Bundesliga,2021_2022
Abdourahmane Barry,GUI,DF,Greuther Fürth,21,2000,2.3,6,4,3,3,0,5,7,71.4,2,5,2,3,4,10,1,0,Bundesliga,2021_2022
Maximilian Bauer,GER,DF,Greuther Fürth,21,2000,18.8,28,15,17,10,1,11,28,39.3,17,24,14,10,29,57,99,0,Bundesliga,2021_2022
Oliver Baumann,GER,GK,Hoffenheim,31,1990,33.0,0,0,0,0,0,0,3,0.0,3,0,0,0,0,0,19,1,Bundesliga,2021_2022
Timo Baumgartl,GER,DF,Union Berlin,25,1996,24.1,59,28,34,21,4,31,47,66.0,16,27,11,16,37,96,58,0,Bundesliga,2021_2022
Julian Baumgartlinger,AUT,"MF,FW",Leverkusen,33,1988,1.0,3,1,2,1,0,1,2,50.0,1,1,0,1,2,5,0,0,Bundesliga,2021_2022
Christoph Baumgartner,AUT,"MF,FW",Hoffenheim,21,1999,21.0,28,15,14,7,7,13,32,40.6,19,24,3,21,8,36,16,0,Bundesliga,2021_2022
Noah Joel Sarenren Bazee,NGA,"MF,FW",Augsburg,24,1996,2.7,5,2,2,2,1,3,4,75.0,1,8,2,6,1,6,4,0,Bundesliga,2021_2022
Ihlas Bebou,TOG,"FW,DF",Hoffenheim,27,1994,23.2,22,14,5,12,5,7,21,33.3,14,20,3,17,12,34,25,0,Bundesliga,2021_2022
Sheraldo Becker,SUR,"FW,MF",Union Berlin,26,1995,19.5,9,6,3,4,2,6,18,33.3,12,11,0,11,2,11,4,0,Bundesliga,2021_2022
Kevin Behrens,GER,FW,Union Berlin,30,1991,5.5,3,2,1,1,1,0,4,0.0,4,3,0,3,3,6,7,0,Bundesliga,2021_2022
Ishak Belfodil,ALG,FW,Hertha BSC,29,1992,18.2,9,6,4,4,1,4,8,50.0,4,9,1,8,5,14,16,0,Bundesliga,2021_2022
Stefan Bell,GER,DF,Mainz 05,29,1991,31.8,54,23,37,16,1,30,63,47.6,33,26,15,11,41,95,112,1,Bundesliga,2021_2022
Armel Bella Kotchap,GER,DF,Bochum,19,2001,19.6,34,20,25,9,0,18,28,64.3,10,21,16,5,42,76,84,2,Bundesliga,2021_2022
Karim Bellarabi,GER,"FW,MF",Leverkusen,31,1990,7.6,9,4,4,4,1,3,13,23.1,10,5,0,5,9,18,4,0,Bundesliga,2021_2022
Jude Bellingham,ENG,MF,Dortmund,18,2003,31.0,52,34,15,31,6,21,53,39.6,32,50,4,46,42,94,32,0,Bundesliga,2021_2022
George Bello,USA,DF,Arminia,19,2002,4.8,7,7,7,0,0,4,4,100.0,0,5,4,1,6,13,11,0,Bundesliga,2021_2022
László Bénes,SVK,MF,Gladbach,23,1997,2.7,5,3,1,3,1,1,6,16.7,5,5,2,3,2,7,5,0,Bundesliga,2021_2022
Keanan Bennetts,ENG,"FW,DF",Gladbach,22,1999,0.6,2,0,1,1,0,1,1,100.0,0,1,0,1,0,2,0,0,Bundesliga,2021_2022
Ramy Bensebaini,ALG,DF,Gladbach,26,1995,22.4,42,30,24,15,3,27,44,61.4,17,33,7,26,39,81,77,1,Bundesliga,2021_2022
Jordan Beyer,GER,DF,Gladbach,21,2000,15.4,46,27,32,13,1,23,39,59.0,16,18,5,13,15,61,52,2,Bundesliga,2021_2022
Bartosz Białek,POL,"FW,DF",Wolfsburg,19,2001,2.0,0,0,0,0,0,0,1,0.0,1,1,0,1,0,0,2,0,Bundesliga,2021_2022
Ermin Bičakčić,BIH,DF,Hoffenheim,31,1990,0.1,0,0,0,0,0,0,0,,0,0,0,0,0,0,0,0,Bundesliga,2021_2022
Tom Bischof,GER,MF,Hoffenheim,16,2005,0.2,0,0,0,0,0,0,0,,0,1,0,1,0,0,1,0,Bundesliga,2021_2022
Danny Blum,GER,FW,Bochum,30,1991,3.8,2,1,0,0,2,0,2,0.0,2,4,0,4,2,4,1,0,Bundesliga,2021_2022
Kevin-Prince Boateng,GHA,"MF,FW",Hertha BSC,34,1987,7.7,6,5,1,4,1,3,9,33.3,6,7,2,5,6,12,11,0,Bundesliga,2021_2022
Herbert Bockhorn,GER,DF,Bochum,26,1995,9.4,20,14,13,4,3,12,20,60.0,8,10,1,9,14,34,18,0,Bundesliga,2021_2022
Jean-Paul Boëtius,NED,MF,Mainz 05,27,1994,20.0,40,23,18,17,5,22,53,41.5,31,41,3,38,25,65,11,0,Bundesliga,2021_2022
Tarsis Bonga,GER,"MF,FW",Bochum,24,1997,0.2,0,0,0,0,0,0,0,,0,0,0,0,0,0,0,0,Bundesliga,2021_2022
Solomon Bonnah,NED,DF,RB Leipzig,17,2003,0.1,0,0,0,0,0,0,0,,0,1,0,1,1,1,0,0,Bundesliga,2021_2022
Sebastiaan Bornauw,BEL,DF,Wolfsburg,22,1999,22.3,30,19,23,5,2,16,25,64.0,9,29,8,21,42,72,97,1,Bundesliga,2021_2022
Rafael Borré,COL,FW,Eint Frankfurt,25,1995,26.4,31,22,4,13,14,7,33,21.2,26,24,4,20,5,36,9,0,Bundesliga,2021_2022
Dedryck Boyata,BEL,DF,Hertha BSC,30,1990,21.1,15,13,11,3,1,8,11,72.7,3,17,13,4,17,32,134,1,Bundesliga,2021_2022
Julian Brandt,GER,"MF,FW",Dortmund,25,1996,23.1,37,19,13,20,4,17,54,31.5,37,19,2,17,24,61,14,1,Bundesliga,2021_2022
Iker Bravo,ESP,FW,Leverkusen,16,2005,0.1,1,1,0,1,0,0,0,,0,0,0,0,0,1,0,0,Bundesliga,2021_2022
Fabian Bredlow,GER,GK,Stuttgart,26,1995,4.0,0,0,0,0,0,0,0,,0,0,0,0,0,0,1,0,Bundesliga,2021_2022
Josip Brekalo,CRO,FW,Wolfsburg,23,1998,0.2,0,0,0,0,0,0,0,,0,0,0,0,0,0,0,0,Bundesliga,2021_2022
Brian Brobbey,NED,"FW,MF",RB Leipzig,19,2002,1.5,1,0,0,1,0,1,1,100.0,0,1,0,1,0,1,0,0,Bundesliga,2021_2022
John Brooks,USA,DF,Wolfsburg,28,1993,29.1,47,25,25,18,4,36,60,60.0,24,33,19,14,41,88,125,1,Bundesliga,2021_2022
Daniel Brosinski,GER,DF,Mainz 05,33,1988,4.3,2,1,1,1,0,1,1,100.0,0,6,0,6,3,5,9,0,Bundesliga,2021_2022
Cédric Brunner,SUI,DF,Arminia,27,1994,24.3,51,35,29,20,2,25,49,51.0,24,27,10,17,43,94,84,0,Bundesliga,2021_2022
Jacob Bruun Larsen,DEN,"FW,MF",Hoffenheim,22,1998,9.0,2,1,1,1,0,0,5,0.0,5,14,3,11,5,7,5,2,Bundesliga,2021_2022
Sascha Burchert,GER,GK,Greuther Fürth,31,1989,14.0,1,1,1,0,0,1,2,50.0,1,0,0,0,0,1,11,1,Bundesliga,2021_2022
Delano Burgzorg,SUR,MF,Mainz 05,22,1998,0.3,1,1,1,0,0,0,1,0.0,1,0,0,0,0,1,0,0,Bundesliga,2021_2022
Jonathan Burkardt,GER,"FW,MF",Mainz 05,21,2000,29.0,17,8,0,10,7,6,25,24.0,19,31,5,26,8,25,16,0,Bundesliga,2021_2022
Roman Bürki,SUI,GK,Dortmund,30,1990,1.0,0,0,0,0,0,0,0,,0,0,0,0,0,0,0,0,Bundesliga,2021_2022
Daniel Caligiuri,ITA,"DF,MF",Augsburg,33,1988,22.3,46,30,17,26,3,27,72,37.5,45,36,5,31,18,64,33,0,Bundesliga,2021_2022
Emre Can,GER,"DF,MF",Dortmund,27,1994,18.8,36,22,20,16,0,15,30,50.0,15,26,10,16,36,72,40,2,Bundesliga,2021_2022
Koen Casteels,BEL,GK,Wolfsburg,29,1992,28.0,0,0,0,0,0,0,1,0.0,1,0,0,0,0,0,9,2,Bundesliga,2021_2022
Gonzalo Castro,GER,"MF,FW",Arminia,34,1987,4.8,8,3,4,4,0,1,5,20.0,4,3,0,3,3,11,3,0,Bundesliga,2021_2022
Julian Chabot,GER,DF,Köln,23,1998,2.3,8,3,4,4,0,2,5,40.0,3,4,2,2,3,11,5,1,Bundesliga,2021_2022
Timothy Chandler,USA,DF,Eint Frankfurt,31,1990,13.5,18,12,10,8,0,11,24,45.8,13,10,3,7,19,37,28,1,Bundesliga,2021_2022
Justin Che,USA,"FW,DF",Hoffenheim,17,2003,0.5,2,0,1,0,1,1,2,50.0,1,0,0,0,1,3,0,0,Bundesliga,2021_2022
Max Christiansen,GER,MF,Greuther Fürth,24,1996,22.8,46,25,19,22,5,18,43,41.9,25,52,16,36,68,114,56,0,Bundesliga,2021_2022
Kingsley Coman,FRA,"FW,DF",Bayern Munich,25,1996,15.1,14,8,1,9,4,5,16,31.3,11,14,0,14,8,22,5,0,Bundesliga,2021_2022
Lucas Copado,GER,FW,Bayern Munich,17,2004,0.2,1,0,1,0,0,1,1,100.0,0,0,0,0,0,1,0,0,Bundesliga,2021_2022
Sergio Córdova,VEN,"FW,MF",Augsburg,23,1997,3.6,4,3,2,2,0,1,2,50.0,1,4,0,4,0,4,4,0,Bundesliga,2021_2022
Danny da Costa,GER,"DF,MF",Eint Frankfurt,28,1993,8.1,15,4,6,7,2,6,18,33.3,12,14,1,13,11,26,18,1,Bundesliga,2021_2022
Tanguy Coulibaly,FRA,"FW,MF",Stuttgart,20,2001,12.0,27,15,14,11,2,9,19,47.4,10,14,2,12,4,31,10,0,Bundesliga,2021_2022
Mickaël Cuisance,FRA,MF,Bayern Munich,21,1999,0.1,1,1,0,1,0,0,0,,0,0,0,0,0,1,0,0,Bundesliga,2021_2022
Matheus Cunha,BRA,FW,Hertha BSC,22,1999,0.7,0,0,0,0,0,0,0,,0,0,0,0,0,0,0,0,Bundesliga,2021_2022
Rafael Czichos,GER,DF,Köln,31,1990,15.6,29,18,18,9,2,14,28,50.0,14,23,13,10,19,48,53,2,Bundesliga,2021_2022
Lennart-Marten Czyborra,GER,DF,Arminia,22,1999,1.5,0,0,0,0,0,0,2,0.0,2,0,0,0,3,3,3,1,Bundesliga,2021_2022
Moanes Dabbur,ISR,"FW,MF",Hoffenheim,29,1992,14.6,18,10,3,5,10,4,17,23.5,13,10,0,10,5,23,4,0,Bundesliga,2021_2022
Finn Dahmen,GER,GK,Mainz 05,23,1998,2.0,0,0,0,0,0,0,0,,0,0,0,0,0,0,2,0,Bundesliga,2021_2022
Mahmoud Dahoud,GER,MF,Dortmund,25,1996,18.4,42,19,10,24,8,20,46,43.5,26,18,3,15,17,59,16,0,Bundesliga,2021_2022
Márton Dárdai,HUN,DF,Hertha BSC,19,2002,8.4,10,4,8,2,0,8,18,44.4,10,16,6,10,20,30,33,2,Bundesliga,2021_2022
Vladimír Darida,CZE,MF,Hertha BSC,30,1990,19.8,32,18,15,13,4,13,32,40.6,19,22,3,19,20,52,17,2,Bundesliga,2021_2022
Alphonso Davies,CAN,DF,Bayern Munich,20,2000,19.3,34,17,17,8,9,13,31,41.9,18,27,1,26,23,57,26,1,Bundesliga,2021_2022
Saulo Decarli,SUI,DF,Bochum,29,1992,0.1,0,0,0,0,0,0,0,,0,0,0,0,0,0,0,0,Bundesliga,2021_2022
Thomas Delaney,DEN,MF,Dortmund,29,1991,0.2,0,0,0,0,0,0,0,,0,0,0,0,0,0,0,0,Bundesliga,2021_2022
Kerem Demirbay,GER,MF,Leverkusen,28,1993,22.8,52,31,19,30,3,16,41,39.0,25,32,9,23,33,85,21,0,Bundesliga,2021_2022
Ermedin Demirović,BIH,FW,Freiburg,23,1998,9.7,12,6,4,4,4,1,10,10.0,9,14,1,13,1,13,7,0,Bundesliga,2021_2022
Mike van der Hoorn,NED,DF,Arminia,28,1992,0.2,1,0,1,0,0,0,0,,0,0,0,0,1,2,2,0,Bundesliga,2021_2022
Moussa Diaby,FRA,"FW,MF",Leverkusen,22,1999,30.7,20,11,8,9,3,5,38,13.2,33,11,0,11,8,28,2,0,Bundesliga,2021_2022
Daniel Didavi,GER,"MF,FW",Stuttgart,31,1990,3.1,6,2,0,4,2,4,7,57.1,3,4,1,3,1,7,1,0,Bundesliga,2021_2022
Javairô Dilrosun,NED,FW,Hertha BSC,23,1998,1.5,3,1,1,2,0,1,1,100.0,0,1,0,1,0,3,0,0,Bundesliga,2021_2022
Lee Dongjun,KOR,"MF,FW",Hertha BSC,24,1997,1.3,2,1,0,2,0,1,3,33.3,2,2,0,2,2,4,1,0,Bundesliga,2021_2022
Niklas Dorsch,GER,MF,Augsburg,23,1998,25.8,76,47,47,23,6,30,60,50.0,30,34,12,22,35,111,36,3,Bundesliga,2021_2022
Ondrej Duda,SVK,"MF,FW",Köln,26,1994,17.9,23,16,4,12,7,6,23,26.1,17,14,2,12,17,40,9,0,Bundesliga,2021_2022
Jeremy Dudziak,TUN,"MF,FW",Greuther Fürth,25,1995,12.6,17,6,5,8,4,3,14,21.4,11,8,0,8,10,27,4,0,Bundesliga,2021_2022
Erik Durm,GER,DF,Eint Frankfurt,29,1992,5.3,13,7,6,5,2,10,13,76.9,3,8,1,7,10,23,7,0,Bundesliga,2021_2022
Maximilian Eggestein,GER,MF,Freiburg,24,1996,24.4,48,28,17,25,6,22,50,44.0,28,35,11,24,30,78,32,1,Bundesliga,2021_2022
Lilian Egloff,GER,"MF,DF",Stuttgart,18,2002,0.3,1,0,0,1,0,0,0,,0,1,0,1,0,1,0,0,Bundesliga,2021_2022
Kingsley Ehizibue,NED,DF,Köln,26,1995,7.6,32,18,27,5,0,15,24,62.5,9,13,4,9,9,41,26,0,Bundesliga,2021_2022
Julian Eitschberger,GER,DF,Hertha BSC,17,2004,0.5,0,0,0,0,0,0,1,0.0,1,1,1,0,2,2,2,0,Bundesliga,2021_2022
Jurgen Ekkelenkamp,NED,"MF,FW",Hertha BSC,21,2000,8.0,8,3,2,6,0,2,7,28.6,5,9,2,7,4,12,5,0,Bundesliga,2021_2022
Nico Elvedi,SUI,DF,Gladbach,24,1996,27.0,40,24,23,17,0,22,36,61.1,14,33,22,11,34,74,83,1,Bundesliga,2021_2022
Breel Embolo,SUI,FW,Gladbach,24,1997,24.1,16,11,1,12,3,3,8,37.5,5,14,2,12,6,22,7,0,Bundesliga,2021_2022
Keita Endo,JPN,MF,Union Berlin,23,1997,0.6,1,1,1,0,0,0,0,,0,1,0,1,0,1,0,0,Bundesliga,2021_2022
Wataru Endo,JPN,MF,Stuttgart,28,1993,32.2,73,41,34,34,5,31,72,43.1,41,43,12,31,30,103,64,0,Bundesliga,2021_2022
Michael Esser,GER,GK,Bochum,33,1987,3.0,0,0,0,0,0,0,1,0.0,1,0,0,0,0,0,2,0,Bundesliga,2021_2022
Wahid Faghir,DEN,FW,Stuttgart,18,2003,1.4,0,0,0,0,0,0,1,0.0,1,2,0,2,0,0,0,0,Bundesliga,2021_2022
Ömer Faruk Beyaz,TUR,"DF,MF",Stuttgart,17,2003,0.8,4,3,1,3,0,1,5,20.0,4,0,0,0,2,6,0,0,Bundesliga,2021_2022
Adrian Fein,GER,MF,Greuther Fürth,22,1999,0.4,0,0,0,0,0,0,1,0.0,1,0,0,0,2,2,0,0,Bundesliga,2021_2022
Ohis Felix Uduokhai,GER,DF,Augsburg,23,1997,8.7,9,6,6,3,0,6,11,54.5,5,13,8,5,9,18,33,0,Bundesliga,2021_2022
Edimilson Fernandes,SUI,"MF,FW",Arminia,25,1996,3.1,2,0,1,1,0,1,4,25.0,3,2,2,0,2,4,6,0,Bundesliga,2021_2022
Alfreð Finnbogason,ISL,FW,Augsburg,32,1989,3.2,3,1,0,2,1,2,4,50.0,2,5,1,4,2,5,8,0,Bundesliga,2021_2022
Mark Flekken,NED,GK,Freiburg,28,1993,32.0,0,0,0,0,0,0,2,0.0,2,1,0,1,2,2,10,1,Bundesliga,2021_2022
Emil Forsberg,SWE,MF,RB Leipzig,29,1991,19.0,21,12,2,11,8,7,22,31.8,15,18,0,18,2,23,2,1,Bundesliga,2021_2022
Philipp Förster,GER,"MF,FW",Stuttgart,26,1995,10.7,20,13,4,12,4,11,26,42.3,15,12,1,11,3,23,2,0,Bundesliga,2021_2022
Timothy Fosu-Mensah,NED,DF,Leverkusen,23,1998,1.6,5,3,3,1,1,4,4,100.0,0,1,0,1,2,7,2,0,Bundesliga,2021_2022
Raphael Framberger,GER,DF,Augsburg,25,1995,9.4,26,19,12,10,4,13,27,48.1,14,8,2,6,9,35,25,0,Bundesliga,2021_2022
Marvin Friedrich,GER,DF,Gladbach,25,1995,6.7,14,8,10,4,0,9,11,81.8,2,5,3,2,5,19,26,0,Bundesliga,2021_2022
Marvin Friedrich,GER,DF,Union Berlin,25,1995,13.0,17,5,14,3,0,10,16,62.5,6,13,7,6,23,40,47,0,Bundesliga,2021_2022
Jeremie Frimpong,NED,DF,Leverkusen,20,2000,22.8,32,18,19,12,1,12,23,52.2,11,24,6,18,17,49,40,2,Bundesliga,2021_2022
Christian Früchtl,GER,GK,Bayern Munich,21,2000,0.1,0,0,0,0,0,0,0,,0,0,0,0,0,0,0,0,Bundesliga,2021_2022
Chris Führich,GER,"FW,MF",Stuttgart,23,1998,19.0,28,16,10,10,8,18,39,46.2,21,31,2,29,8,36,9,0,Bundesliga,2021_2022
Marius Funk,GER,GK,Greuther Fürth,25,1996,8.0,0,0,0,0,0,0,0,,0,0,0,0,0,0,8,1,Bundesliga,2021_2022
Stephan Fürstner,GER,MF,Mainz 05,33,1987,0.1,0,0,0,0,0,0,2,0.0,2,0,0,0,0,0,1,0,Bundesliga,2021_2022
Mijat Gaćinović,SRB,"FW,MF",Hoffenheim,26,1995,1.2,3,3,1,1,1,3,3,100.0,0,1,0,1,1,4,2,0,Bundesliga,2021_2022
Cristian Gamboa,CRC,DF,Bochum,31,1989,19.1,59,36,40,16,3,30,61,49.2,31,22,7,15,32,91,35,1,Bundesliga,2021_2022
Silvère Ganvoula M'Boussy,CGO,FW,Bochum,25,1996,1.7,0,0,0,0,0,0,1,0.0,1,0,0,0,0,0,1,0,Bundesliga,2021_2022
Linus Gechter,GER,DF,Hertha BSC,17,2004,8.0,15,8,13,2,0,7,14,50.0,7,12,7,5,11,26,29,0,Bundesliga,2021_2022
Dennis Geiger,GER,MF,Hoffenheim,23,1998,15.3,34,23,9,20,5,17,30,56.7,13,15,1,14,14,48,7,1,Bundesliga,2021_2022
Yannick Gerhardt,GER,"MF,DF",Wolfsburg,27,1994,17.5,42,20,18,17,7,22,36,61.1,14,24,1,23,25,67,25,1,Bundesliga,2021_2022
Hamadi Al Ghaddioui,MAR,FW,Stuttgart,30,1990,5.5,5,4,2,1,2,0,4,0.0,4,3,1,2,0,5,4,0,Bundesliga,2021_2022
Niko Gießelmann,GER,"DF,FW",Union Berlin,29,1991,23.1,24,17,10,11,3,15,38,39.5,23,26,4,22,18,42,29,1,Bundesliga,2021_2022
Rafał Gikiewicz,POL,GK,Augsburg,33,1987,34.0,2,0,2,0,0,2,7,28.6,5,0,0,0,3,5,11,5,Bundesliga,2021_2022
Daniel Ginczek,GER,"MF,FW",Wolfsburg,30,1991,0.1,0,0,0,0,0,0,0,,0,0,0,0,0,0,0,0,Bundesliga,2021_2022
Matthias Ginter,GER,DF,Gladbach,27,1994,26.2,36,22,20,13,3,27,40,67.5,13,21,10,11,33,69,76,0,Bundesliga,2021_2022
Jamie Gittens,ENG,FW,Dortmund,16,2004,1.5,3,2,0,2,1,2,5,40.0,3,4,1,3,1,4,1,0,Bundesliga,2021_2022
Serge Gnabry,GER,"FW,DF",Bayern Munich,26,1995,24.3,47,31,16,20,11,22,57,38.6,35,26,0,26,14,61,3,0,Bundesliga,2021_2022
Leon Goretzka,GER,MF,Bayern Munich,26,1995,15.5,25,15,12,9,4,11,26,42.3,15,11,1,10,17,42,23,2,Bundesliga,2021_2022
Jeffrey Gouweleeuw,NED,DF,Augsburg,30,1991,28.6,50,27,33,17,0,22,36,61.1,14,35,18,17,49,99,116,0,Bundesliga,2021_2022
Jens Grahl,GER,GK,Eint Frankfurt,32,1988,1.0,0,0,0,0,0,0,0,,0,0,0,0,0,0,1,0,Bundesliga,2021_2022
Julian Green,USA,MF,Greuther Fürth,26,1995,11.7,9,5,0,8,1,2,8,25.0,6,10,2,8,7,16,10,0,Bundesliga,2021_2022
Michael Gregoritsch,AUT,"FW,MF",Augsburg,27,1994,15.5,19,8,4,10,5,2,15,13.3,13,18,2,16,6,25,29,0,Bundesliga,2021_2022
Sebastian Griesbeck,GER,"DF,MF",Greuther Fürth,30,1990,27.1,60,31,38,19,3,39,62,62.9,23,38,13,25,43,103,100,1,Bundesliga,2021_2022
Sebastian Griesbeck,GER,MF,Union Berlin,30,1990,0.1,1,1,0,1,0,1,1,100.0,0,0,0,0,0,1,0,0,Bundesliga,2021_2022
Vincenzo Grifo,ITA,"MF,FW",Freiburg,28,1993,30.8,27,15,9,13,5,9,26,34.6,17,12,2,10,13,40,28,0,Bundesliga,2021_2022
Lennart Grill,GER,GK,Leverkusen,22,1999,1.0,0,0,0,0,0,0,0,,0,0,0,0,0,0,0,0,Bundesliga,2021_2022
Florian Grillitsch,AUT,"DF,MF",Hoffenheim,25,1995,16.6,37,19,15,21,1,17,31,54.8,14,18,7,11,29,66,36,1,Bundesliga,2021_2022
Carlos Gruezo,ECU,MF,Augsburg,26,1995,10.8,22,11,10,10,2,8,21,38.1,13,11,2,9,9,31,15,0,Bundesliga,2021_2022
Raphaël Guerreiro,POR,DF,Dortmund,27,1993,19.9,35,19,19,12,4,16,31,51.6,15,18,2,16,25,60,14,1,Bundesliga,2021_2022
Josuha Guilavogui,FRA,"MF,DF",Wolfsburg,30,1990,10.5,23,14,13,9,1,7,18,38.9,11,11,6,5,25,48,42,0,Bundesliga,2021_2022
Péter Gulácsi,HUN,GK,RB Leipzig,31,1990,33.0,0,0,0,0,0,0,0,,0,0,0,0,1,1,15,1,Bundesliga,2021_2022
Manuel Gulde,GER,DF,Freiburg,30,1991,13.6,18,10,14,3,1,8,11,72.7,3,16,8,8,17,35,37,0,Bundesliga,2021_2022
Robert Gumny,POL,DF,Augsburg,23,1998,25.2,48,29,25,20,3,25,43,58.1,18,24,7,17,28,76,57,3,Bundesliga,2021_2022
Christian Günter,GER,"DF,MF",Freiburg,28,1993,34.0,34,20,16,15,3,18,50,36.0,32,23,6,17,17,51,49,2,Bundesliga,2021_2022
Lasse Günther,GER,DF,Augsburg,18,2003,1.8,8,5,4,3,1,5,9,55.6,4,0,0,0,2,10,2,0,Bundesliga,2021_2022
Joško Gvardiol,CRO,DF,RB Leipzig,19,2002,26.8,47,31,28,17,2,22,39,56.4,17,30,11,19,51,98,62,2,Bundesliga,2021_2022
Erling Haaland,NOR,FW,Dortmund,21,2000,21.2,2,1,0,1,1,0,1,0.0,1,8,1,7,1,3,31,0,Bundesliga,2021_2022
Janik Haberer,GER,MF,Freiburg,27,1994,9.1,14,8,5,6,3,7,19,36.8,12,11,4,7,16,30,11,0,Bundesliga,2021_2022
Alexander Hack,GER,DF,Mainz 05,27,1993,23.0,52,26,35,17,0,29,46,63.0,17,31,14,17,51,103,95,1,Bundesliga,2021_2022
Robin Hack,GER,"FW,MF",Arminia,22,1998,15.2,14,8,6,5,3,3,21,14.3,18,18,1,17,5,19,4,0,Bundesliga,2021_2022
André Hahn,GER,"MF,FW",Augsburg,30,1990,23.3,36,20,9,15,12,17,50,34.0,33,38,5,33,15,51,43,0,Bundesliga,2021_2022
Amadou Haidara,MLI,MF,RB Leipzig,23,1998,14.7,30,14,11,19,0,17,37,45.9,20,22,6,16,16,46,8,1,Bundesliga,2021_2022
Marcel Halstenberg,GER,DF,RB Leipzig,29,1991,5.6,10,7,6,4,0,6,11,54.5,5,6,0,6,7,17,11,0,Bundesliga,2021_2022
Genki Haraguchi,JPN,MF,Union Berlin,30,1991,19.5,37,20,12,22,3,15,48,31.3,33,25,3,22,26,63,15,0,Bundesliga,2021_2022
Luis Hartwig,GER,FW,Bochum,18,2002,0.0,0,0,0,0,0,0,0,,0,0,0,0,0,0,0,0,Bundesliga,2021_2022
Makoto Hasebe,JPN,DF,Eint Frankfurt,37,1984,13.2,27,12,15,11,1,13,29,44.8,16,24,8,16,22,49,36,0,Bundesliga,2021_2022
Thorgan Hazard,BEL,"FW,DF",Dortmund,28,1993,14.9,23,13,8,10,5,15,40,37.5,25,23,1,22,6,29,4,0,Bundesliga,2021_2022
Jonas Hector,GER,DF,Köln,31,1990,28.4,76,39,36,26,14,29,74,39.2,45,59,8,51,50,126,68,1,Bundesliga,2021_2022
Hwang Hee-chan,KOR,FW,RB Leipzig,25,1996,0.5,0,0,0,0,0,0,0,,0,0,0,0,1,1,0,0,Bundesliga,2021_2022
Dominique Heintz,GER,DF,Union Berlin,27,1993,5.2,8,5,5,3,0,3,6,50.0,3,7,4,3,7,15,14,0,Bundesliga,2021_2022
Dominique Heintz,GER,DF,Freiburg,27,1993,0.3,0,0,0,0,0,0,0,,0,0,0,0,1,1,0,0,Bundesliga,2021_2022
Benjamin Henrichs,GER,DF,RB Leipzig,24,1997,12.7,30,21,18,6,6,12,22,54.5,10,16,1,15,19,49,14,0,Bundesliga,2021_2022
Lucas Hernández,FRA,DF,Bayern Munich,25,1996,22.6,50,31,20,24,6,26,42,61.9,16,22,11,11,28,78,54,1,Bundesliga,2021_2022
Patrick Herrmann,GER,"DF,FW",Gladbach,30,1991,8.4,15,7,5,6,4,9,24,37.5,15,10,1,9,6,21,8,0,Bundesliga,2021_2022
Piero Hincapié,ECU,DF,Leverkusen,19,2002,19.5,33,23,23,8,2,19,25,76.0,6,34,15,19,33,66,56,2,Bundesliga,2021_2022
Martin Hinteregger,AUT,DF,Eint Frankfurt,28,1992,24.7,45,28,28,16,1,28,43,65.1,15,36,16,20,42,87,78,3,Bundesliga,2021_2022
Marwin Hitz,SUI,GK,Dortmund,33,1987,4.5,0,0,0,0,0,0,0,,0,0,0,0,0,0,2,0,Bundesliga,2021_2022
Nicolas Höfler,GER,MF,Freiburg,31,1990,28.9,73,42,37,29,7,28,62,45.2,34,50,21,29,46,119,42,0,Bundesliga,2021_2022
Jonas Hofmann,GER,"MF,FW",Gladbach,29,1992,23.1,30,20,6,17,7,17,42,40.5,25,23,0,23,12,42,10,0,Bundesliga,2021_2022
Lucas Höler,GER,FW,Freiburg,27,1994,28.7,41,25,10,17,14,13,28,46.4,15,25,4,21,17,58,39,2,Bundesliga,2021_2022
Gerrit Holtmann,PHI,"FW,MF",Bochum,26,1995,20.4,15,9,5,3,7,6,22,27.3,16,26,2,24,8,23,6,0,Bundesliga,2021_2022
Justin Hoogma,NED,DF,Greuther Fürth,23,1998,3.0,6,5,4,2,0,4,6,66.7,2,5,5,0,4,10,4,0,Bundesliga,2021_2022
Jannes Horn,GER,DF,Köln,24,1997,5.3,6,4,4,2,0,4,8,50.0,4,1,1,0,3,9,9,0,Bundesliga,2021_2022
Timo Horn,GER,GK,Köln,28,1993,13.0,0,0,0,0,0,0,1,0.0,1,0,0,0,0,0,5,0,Bundesliga,2021_2022
Lukáš Hrádecký,FIN,GK,Leverkusen,31,1989,32.0,1,1,1,0,0,1,1,100.0,0,0,0,0,0,1,10,1,Bundesliga,2021_2022
Branimir Hrgota,SWE,FW,Greuther Fürth,28,1993,30.9,46,29,10,31,5,21,72,29.2,51,27,1,26,11,57,3,1,Bundesliga,2021_2022
Ajdin Hrustic,AUS,MF,Eint Frankfurt,25,1996,10.7,16,11,5,7,4,11,32,34.4,21,18,1,17,10,26,7,0,Bundesliga,2021_2022
Timo Hübers,GER,DF,Köln,25,1996,19.3,45,27,28,17,0,27,45,60.0,18,31,19,12,52,97,95,0,Bundesliga,2021_2022
Benjamin Hübner,GER,DF,Hoffenheim,32,1989,4.2,9,5,0,7,2,3,5,60.0,2,2,2,0,9,18,7,0,Bundesliga,2021_2022
Mats Hummels,GER,DF,Dortmund,32,1988,19.6,34,22,20,13,1,20,36,55.6,16,18,13,5,32,66,66,1,Bundesliga,2021_2022
Iago,BRA,DF,Augsburg,24,1997,24.2,49,29,25,19,5,15,34,44.1,19,28,6,22,27,76,62,0,Bundesliga,2021_2022
Stefan Ilsanker,AUT,"DF,MF",Eint Frankfurt,32,1989,3.0,14,8,7,6,1,5,10,50.0,5,6,2,4,6,20,15,1,Bundesliga,2021_2022
Burak İnce,TUR,FW,Arminia,17,2004,1.5,1,1,1,0,0,1,2,50.0,1,1,0,1,0,1,0,0,Bundesliga,2021_2022
Marcus Ingvartsen,DEN,MF,Union Berlin,25,1996,1.4,0,0,0,0,0,0,2,0.0,2,0,0,0,2,2,1,0,Bundesliga,2021_2022
Marcus Ingvartsen,DEN,"FW,MF",Mainz 05,25,1996,7.6,3,2,2,0,1,3,9,33.3,6,6,0,6,6,9,7,1,Bundesliga,2021_2022
Hiroki Ito,JPN,DF,Stuttgart,22,1999,26.1,43,31,21,19,3,25,43,58.1,18,40,19,21,53,96,95,0,Bundesliga,2021_2022
Cedric Itten,SUI,FW,Greuther Fürth,24,1996,7.1,5,2,1,2,2,1,6,16.7,5,3,0,3,2,7,4,0,Bundesliga,2021_2022
Gian-Luca Itter,GER,DF,Greuther Fürth,22,1999,16.2,44,26,30,11,3,21,38,55.3,17,24,9,15,13,57,51,0,Bundesliga,2021_2022
Lee Jae-sung,KOR,"MF,FW",Mainz 05,28,1992,16.0,30,12,8,14,8,6,27,22.2,21,20,2,18,18,48,18,0,Bundesliga,2021_2022
Paul Jaeckel,GER,DF,Union Berlin,23,1998,22.7,51,29,27,24,0,29,51,56.9,22,34,10,24,57,108,81,0,Bundesliga,2021_2022
Kristijan Jakić,CRO,MF,Eint Frankfurt,24,1997,20.9,37,22,10,21,6,15,62,24.2,47,33,3,30,21,58,25,1,Bundesliga,2021_2022
Tony Jantschke,GER,DF,Gladbach,31,1990,2.5,6,5,2,4,0,3,6,50.0,3,3,2,1,5,11,8,0,Bundesliga,2021_2022
Dennis Jastrzembski,POL,"DF,FW",Hertha BSC,21,2000,2.5,2,1,1,1,0,2,8,25.0,6,1,0,1,5,7,3,0,Bundesliga,2021_2022
Fredrik Jensen,FIN,"MF,FW",Augsburg,23,1997,4.6,5,4,1,3,1,4,7,57.1,3,5,1,4,2,7,4,0,Bundesliga,2021_2022
Marco John,GER,DF,Hoffenheim,19,2002,0.5,0,0,0,0,0,0,1,0.0,1,1,0,1,1,1,1,0,Bundesliga,2021_2022
Stevan Jovetić,MNE,"FW,MF",Hertha BSC,31,1989,11.3,5,2,0,2,3,1,6,16.7,5,3,0,3,1,6,6,0,Bundesliga,2021_2022
Gideon Jung,GER,DF,Greuther Fürth,26,1994,1.6,3,1,1,2,0,2,4,50.0,2,1,1,0,2,5,5,0,Bundesliga,2021_2022
Anton Kade,GER,"FW,MF",Hertha BSC,17,2004,0.9,4,2,3,1,0,2,8,25.0,6,3,0,3,3,7,1,0,Bundesliga,2021_2022
Pavel Kadeřábek,CZE,"DF,MF",Hoffenheim,29,1992,13.3,11,10,6,3,2,5,16,31.3,11,18,6,12,13,24,22,0,Bundesliga,2021_2022
Florian Kainz,AUT,"MF,FW",Köln,28,1992,25.8,41,26,9,25,7,23,51,45.1,28,27,3,24,32,73,24,0,Bundesliga,2021_2022
Sasa Kalajdzic,AUT,FW,Stuttgart,24,1997,13.6,10,6,2,5,3,3,11,27.3,8,5,0,5,2,12,14,0,Bundesliga,2021_2022
Daichi Kamada,JPN,MF,Eint Frankfurt,24,1996,23.8,40,21,7,26,7,11,40,27.5,29,18,0,18,8,48,10,0,Bundesliga,2021_2022
Kevin Kampl,SVN,MF,RB Leipzig,30,1990,21.1,41,19,16,20,5,10,42,23.8,32,24,5,19,24,65,17,0,Bundesliga,2021_2022
Stefanos Kapino,GRE,GK,Arminia,27,1994,1.0,0,0,0,0,0,0,0,,0,0,0,0,0,0,0,0,Bundesliga,2021_2022
Atakan Karazor,GER,MF,Stuttgart,24,1996,21.1,48,24,18,27,3,18,36,50.0,18,37,14,23,34,82,47,0,Bundesliga,2021_2022
Silas Katompa,COD,"FW,MF",Stuttgart,22,1998,3.1,5,4,4,0,1,3,7,42.9,4,5,0,5,2,7,1,0,Bundesliga,2021_2022
Noah Katterbach,GER,DF,Köln,20,2001,0.2,1,1,1,0,0,1,1,100.0,0,0,0,0,0,1,1,0,Bundesliga,2021_2022
Yannik Keitel,GER,MF,Freiburg,21,2000,5.6,11,4,5,4,2,5,15,33.3,10,7,1,6,1,12,8,0,Bundesliga,2021_2022
Marc-Oliver Kempf,GER,DF,Hertha BSC,26,1995,11.7,10,9,9,1,0,5,14,35.7,9,14,7,7,25,35,49,1,Bundesliga,2021_2022
Marc-Oliver Kempf,GER,DF,Stuttgart,26,1995,9.3,13,8,7,4,2,3,10,30.0,7,16,14,2,16,29,26,2,Bundesliga,2021_2022
Rani Khedira,GER,MF,Union Berlin,27,1994,30.6,75,38,25,42,8,32,66,48.5,34,21,8,13,50,125,27,1,Bundesliga,2021_2022
Luca Kilian,GER,FW,Mainz 05,21,1999,0.0,0,0,0,0,0,0,0,,0,0,0,0,0,0,0,0,Bundesliga,2021_2022
Luca Kilian,GER,DF,Köln,21,1999,25.3,42,24,30,9,3,21,41,51.2,20,31,13,18,46,88,109,3,Bundesliga,2021_2022
Joshua Kimmich,GER,MF,Bayern Munich,26,1995,27.5,39,20,14,17,8,18,58,31.0,40,34,8,26,52,91,29,1,Bundesliga,2021_2022
Philipp Klement,GER,MF,Stuttgart,28,1992,3.8,7,3,1,4,2,3,3,100.0,0,6,1,5,1,8,0,0,Bundesliga,2021_2022
Mateo Klimowicz,GER,"MF,FW",Stuttgart,21,2000,6.7,13,6,6,7,0,5,16,31.3,11,2,0,2,4,17,3,0,Bundesliga,2021_2022
Fabian Klos,GER,FW,Arminia,33,1987,15.8,7,5,0,5,2,2,10,20.0,8,17,4,13,0,7,31,0,Bundesliga,2021_2022
Lukas Klostermann,GER,DF,RB Leipzig,25,1996,18.3,29,16,11,15,3,13,19,68.4,6,16,3,13,26,55,58,0,Bundesliga,2021_2022
Lukas Klünter,GER,DF,Hertha BSC,25,1996,2.2,1,1,1,0,0,1,5,20.0,4,1,0,1,2,3,2,0,Bundesliga,2021_2022
Ansgar Knauff,GER,"FW,MF",Dortmund,19,2002,1.3,3,1,1,1,1,0,4,0.0,4,2,0,2,0,3,4,0,Bundesliga,2021_2022
Ansgar Knauff,GER,"DF,MF",Eint Frankfurt,19,2002,8.4,18,14,8,5,5,8,15,53.3,7,11,1,10,8,26,6,0,Bundesliga,2021_2022
Robin Knoche,GER,DF,Union Berlin,29,1992,33.0,50,24,38,12,0,30,53,56.6,23,45,26,19,49,99,151,1,Bundesliga,2021_2022
Gregor Kobel,SUI,GK,Dortmund,23,1997,28.5,0,0,0,0,0,0,2,0.0,2,0,0,0,1,1,20,0,Bundesliga,2021_2022
Dominik Kohr,GER,MF,Mainz 05,27,1994,17.9,40,20,18,19,3,16,42,38.1,26,21,2,19,35,75,22,0,Bundesliga,2021_2022
Manu Koné,FRA,MF,Gladbach,20,2001,24.3,60,37,29,28,3,25,42,59.5,17,27,4,23,34,94,12,0,Bundesliga,2021_2022
Odilon Kossounou,CIV,DF,Leverkusen,20,2001,19.9,23,17,16,6,1,15,25,60.0,10,36,14,22,26,49,66,0,Bundesliga,2021_2022
Filip Kostić,SRB,"DF,FW",Eint Frankfurt,28,1992,28.0,44,17,26,9,9,20,53,37.7,33,24,1,23,15,59,24,0,Bundesliga,2021_2022
Andrej Kramarić,CRO,"FW,MF",Hoffenheim,30,1991,30.1,8,4,1,5,2,7,17,41.2,10,10,0,10,9,17,7,1,Bundesliga,2021_2022
Christoph Kramer,GER,MF,Gladbach,30,1991,8.3,28,11,15,10,3,12,28,42.9,16,18,5,13,12,40,9,0,Bundesliga,2021_2022
Florian Krüger,GER,"FW,MF",Arminia,22,1999,12.5,3,1,0,3,0,2,10,20.0,8,12,1,11,2,5,13,0,Bundesliga,2021_2022
Max Kruse,GER,"MF,FW",Wolfsburg,33,1988,12.5,9,3,4,4,1,5,12,41.7,7,2,0,2,3,12,4,0,Bundesliga,2021_2022
Max Kruse,GER,"FW,MF",Union Berlin,33,1988,14.1,4,1,0,3,1,2,16,12.5,14,12,0,12,3,7,2,0,Bundesliga,2021_2022
Lukas Kübler,GER,"DF,MF",Freiburg,28,1992,25.9,62,35,38,16,8,28,49,57.1,21,24,8,16,44,106,70,0,Bundesliga,2021_2022
Fabian Kunze,GER,MF,Arminia,23,1998,14.0,35,21,14,20,1,15,32,46.9,17,17,2,15,19,54,27,1,Bundesliga,2021_2022
Maxence Lacroix,FRA,DF,Wolfsburg,21,2000,27.7,59,33,41,16,2,29,40,72.5,11,35,16,19,60,119,144,0,Bundesliga,2021_2022
Konrad Laimer,AUT,MF,RB Leipzig,24,1997,13.8,38,24,11,22,5,24,53,45.3,29,29,3,26,4,42,9,0,Bundesliga,2021_2022
Stefan Lainer,AUT,DF,Gladbach,28,1992,16.3,19,11,9,7,3,12,28,42.9,16,24,5,19,14,33,31,0,Bundesliga,2021_2022
Vassilis Lambropoulos,GRE,DF,Bochum,31,1990,13.0,18,12,13,3,2,11,25,44.0,14,21,10,11,17,35,56,0,Bundesliga,2021_2022
Sam Lammers,NED,"FW,MF",Eint Frankfurt,24,1997,5.7,4,4,0,2,2,2,6,33.3,4,9,2,7,2,6,4,0,Bundesliga,2021_2022
Bryan Lasme,FRA,FW,Arminia,22,1998,9.7,6,6,1,2,3,0,3,0.0,3,7,0,7,1,7,9,0,Bundesliga,2021_2022
Maxim Leitsch,GER,DF,Bochum,23,1998,17.1,18,10,9,7,2,10,15,66.7,5,31,19,12,31,49,74,1,Bundesliga,2021_2022
Tim Lemperle,GER,"FW,MF",Köln,19,2002,1.7,4,1,2,1,1,1,3,33.3,2,1,0,1,2,6,2,0,Bundesliga,2021_2022
Christopher Lenz,GER,DF,Eint Frankfurt,26,1994,7.4,29,15,22,6,1,12,21,57.1,9,9,4,5,7,36,21,0,Bundesliga,2021_2022
Robert Lewandowski,POL,FW,Bayern Munich,32,1988,32.7,10,3,0,6,4,5,17,29.4,12,17,2,15,6,16,8,0,Bundesliga,2021_2022
Jamie Leweling,GER,"FW,MF",Greuther Fürth,20,2001,21.8,13,8,3,7,3,3,16,18.8,13,9,0,9,13,26,5,0,Bundesliga,2021_2022
Philipp Lienhart,AUT,DF,Freiburg,25,1996,31.9,24,13,17,6,1,13,24,54.2,11,33,23,10,50,74,158,1,Bundesliga,2021_2022
Andreas Linde,SWE,GK,Greuther Fürth,28,1993,12.0,0,0,0,0,0,0,0,,0,0,0,0,1,1,1,1,Bundesliga,2021_2022
Jesper Lindstrøm,DEN,"MF,FW",Eint Frankfurt,21,2000,22.0,28,13,6,13,9,12,36,33.3,24,30,0,30,24,52,11,1,Bundesliga,2021_2022
Dejan Ljubicic,AUT,"MF,FW",Köln,23,1997,21.9,33,19,12,13,8,13,49,26.5,36,19,1,18,15,48,11,0,Bundesliga,2021_2022
Jürgen Locadia,CUW,"FW,MF",Bochum,27,1993,4.9,4,2,1,0,3,1,1,100.0,0,1,0,1,1,5,2,0,Bundesliga,2021_2022
Anthony Losilla,FRA,MF,Bochum,35,1986,32.6,65,39,29,30,6,34,69,49.3,35,32,9,23,70,135,53,1,Bundesliga,2021_2022
Marcel Lotka,POL,GK,Hertha BSC,20,2001,9.8,1,0,1,0,0,1,1,100.0,0,0,0,0,1,2,3,3,Bundesliga,2021_2022
Eduard Löwen,GER,MF,Bochum,24,1997,15.7,28,22,12,11,5,10,43,23.3,33,17,2,15,9,37,15,1,Bundesliga,2021_2022
Anderson Lucoqui,ANG,DF,Mainz 05,24,1997,8.3,22,10,11,6,5,11,22,50.0,11,15,3,12,11,33,10,0,Bundesliga,2021_2022
Dodi Lukebakio,BEL,FW,Hertha BSC,23,1997,2.0,2,1,2,0,0,1,3,33.3,2,2,0,2,2,4,0,0,Bundesliga,2021_2022
Dodi Lukebakio,BEL,"FW,MF",Wolfsburg,23,1997,9.8,7,4,3,2,2,1,10,10.0,9,5,0,5,13,20,4,0,Bundesliga,2021_2022
Andrey Lunyov,RUS,GK,Leverkusen,29,1991,1.0,0,0,0,0,0,0,0,,0,0,0,0,0,0,0,0,Bundesliga,2021_2022
Andreas Luthe,GER,GK,Union Berlin,34,1987,27.0,0,0,0,0,0,0,1,0.0,1,0,0,0,0,0,11,4,Bundesliga,2021_2022
Matej Maglica,CRO,MF,Stuttgart,22,1998,0.1,0,0,0,0,0,0,1,0.0,1,0,0,0,0,0,0,0,Bundesliga,2021_2022
Arne Maier,GER,MF,Augsburg,22,1999,20.7,20,13,6,10,4,8,26,30.8,18,18,1,17,15,35,13,0,Bundesliga,2021_2022
Donyell Malen,NED,FW,Dortmund,22,1999,18.7,13,10,4,5,4,7,13,53.8,6,10,0,10,10,23,11,0,Bundesliga,2021_2022
Lennard Maloney,USA,DF,Dortmund,21,1999,0.1,1,0,1,0,0,1,1,100.0,0,0,0,0,0,1,0,0,Bundesliga,2021_2022
Orel Mangala,BEL,MF,Stuttgart,23,1998,20.6,17,10,5,7,5,11,22,50.0,11,11,4,7,12,29,19,1,Bundesliga,2021_2022
Myziane Maolida,COM,"FW,MF",Hertha BSC,22,1999,8.6,7,4,5,1,1,3,9,33.3,6,5,0,5,1,8,6,0,Bundesliga,2021_2022
Omar Marmoush,EGY,FW,Wolfsburg,22,1999,0.3,0,0,0,0,0,0,0,,0,0,0,0,0,0,0,0,Bundesliga,2021_2022
Omar Marmoush,EGY,FW,Stuttgart,22,1999,17.5,26,17,6,14,6,4,20,20.0,16,9,1,8,7,33,6,0,Bundesliga,2021_2022
Aarón Martín,ESP,DF,Mainz 05,24,1997,25.5,54,33,32,18,4,24,55,43.6,31,24,4,20,20,74,35,0,Bundesliga,2021_2022
Josep Martinez,ESP,GK,RB Leipzig,23,1998,1.0,0,0,0,0,0,0,0,,0,0,0,0,0,0,0,0,Bundesliga,2021_2022
Erhan Mašović,SRB,DF,Bochum,22,1998,17.2,35,20,21,13,1,21,33,63.6,12,28,19,9,34,69,64,1,Bundesliga,2021_2022
Roberto Massimo,GER,"DF,FW",Stuttgart,20,2000,9.7,14,5,6,7,1,4,16,25.0,12,9,0,9,3,17,6,0,Bundesliga,2021_2022
Konstantinos Mavropanos,GRE,DF,Stuttgart,23,1997,30.1,57,39,35,21,1,30,51,58.8,21,46,23,23,69,126,174,2,Bundesliga,2021_2022
Eric Maxim Choupo-Moting,CMR,"FW,MF",Bayern Munich,32,1989,4.2,10,9,3,6,1,3,10,30.0,7,1,0,1,5,15,2,0,Bundesliga,2021_2022
Kevin Mbabu,SUI,DF,Wolfsburg,26,1995,15.5,31,20,21,5,5,12,23,52.2,11,25,8,17,35,66,35,0,Bundesliga,2021_2022
Nathan de Medina,BEL,DF,Arminia,23,1997,8.6,17,10,11,6,0,6,10,60.0,4,14,3,11,10,27,28,0,Bundesliga,2021_2022
Admir Mehmedi,SUI,DF,Wolfsburg,30,1991,0.0,0,0,0,0,0,0,0,,0,0,0,0,0,0,0,0,Bundesliga,2021_2022
Jorge Meré,ESP,DF,Köln,24,1997,5.4,9,6,3,6,0,4,7,57.1,3,6,4,2,10,19,19,0,Bundesliga,2021_2022
Thomas Meunier,BEL,DF,Dortmund,29,1991,15.6,29,19,13,12,4,16,33,48.5,17,10,2,8,12,41,25,1,Bundesliga,2021_2022
Marco Meyerhöfer,GER,DF,Greuther Fürth,25,1995,25.3,53,35,22,22,9,24,37,64.9,13,38,19,19,47,100,64,1,Bundesliga,2021_2022
Sven Michel,GER,FW,Union Berlin,31,1990,3.8,10,6,5,3,2,2,8,25.0,6,3,0,3,1,11,1,0,Bundesliga,2021_2022
Enzo Millot,FRA,MF,Stuttgart,19,2002,0.6,2,0,0,2,0,0,1,0.0,1,0,0,0,1,3,1,0,Bundesliga,2021_2022
Maximilian Mittelstädt,GER,"DF,FW",Hertha BSC,24,1997,16.6,52,33,30,12,10,26,50,52.0,24,28,5,23,46,98,37,0,Bundesliga,2021_2022
Anthony Modeste,FRA,FW,Köln,33,1988,29.0,10,6,4,5,1,3,18,16.7,15,11,2,9,4,14,29,0,Bundesliga,2021_2022
Kevin Möhwald,GER,MF,Union Berlin,28,1993,3.9,7,1,3,3,1,1,7,14.3,6,3,0,3,3,10,6,0,Bundesliga,2021_2022
Clinton Mola,ENG,DF,Stuttgart,20,2001,1.3,3,1,2,1,0,2,4,50.0,2,5,5,0,3,6,2,0,Bundesliga,2021_2022
Jan Morávek,CZE,MF,Augsburg,31,1989,5.2,11,6,3,7,1,6,18,33.3,12,11,2,9,6,17,8,0,Bundesliga,2021_2022
Ilaix Moriba,GUI,MF,RB Leipzig,18,2003,0.4,0,0,0,0,0,0,4,0.0,4,2,0,2,1,1,0,0,Bundesliga,2021_2022
Youssoufa Moukoko,GER,"FW,MF",Dortmund,16,2004,2.5,1,0,0,1,0,0,1,0.0,1,5,0,5,3,4,0,0,Bundesliga,2021_2022
Nordi Mukiele,FRA,"DF,FW",RB Leipzig,23,1997,20.5,35,22,23,9,3,14,27,51.9,13,31,5,26,31,66,44,2,Bundesliga,2021_2022
Florian Müller,GER,GK,Stuttgart,23,1997,30.0,0,0,0,0,0,0,1,0.0,1,1,0,1,0,0,13,2,Bundesliga,2021_2022
Thomas Müller,GER,MF,Bayern Munich,31,1989,28.4,35,20,7,16,12,16,54,29.6,38,32,1,31,15,50,12,0,Bundesliga,2021_2022
Torben Müsel,GER,MF,Gladbach,22,1999,0.1,0,0,0,0,0,0,0,,0,0,0,0,0,0,0,0,Bundesliga,2021_2022
Jamal Musiala,GER,"MF,FW",Bayern Munich,18,2003,16.3,40,26,11,16,13,15,36,41.7,21,25,0,25,19,59,2,1,Bundesliga,2021_2022
Obite N'Dicka,CIV,DF,Eint Frankfurt,21,1999,31.7,60,34,29,27,4,44,59,74.6,15,46,20,26,48,108,137,0,Bundesliga,2021_2022
Nikolas Nartey,DEN,"MF,DF",Stuttgart,21,2000,4.5,6,3,0,5,1,3,9,33.3,6,4,2,2,7,13,5,0,Bundesliga,2021_2022
Paul Nebel,GER,"MF,FW",Mainz 05,18,2002,2.5,5,3,3,1,1,2,3,66.7,1,0,0,0,0,5,1,0,Bundesliga,2021_2022
David Nemeth,AUT,DF,Mainz 05,20,2001,3.5,3,2,2,1,0,1,3,33.3,2,5,1,4,6,9,11,1,Bundesliga,2021_2022
Luca Netz,GER,"DF,FW",Gladbach,18,2003,15.5,24,11,12,10,2,11,40,27.5,29,24,4,20,13,37,33,1,Bundesliga,2021_2022
Manuel Neuer,GER,GK,Bayern Munich,35,1986,27.9,2,1,2,0,0,1,2,50.0,1,0,0,0,0,2,7,1,Bundesliga,2021_2022
Florian Neuhaus,GER,MF,Gladbach,24,1997,23.6,55,28,24,26,5,27,64,42.2,37,38,6,32,31,86,19,4,Bundesliga,2021_2022
Jessic Ngankam,GER,FW,Greuther Fürth,21,2000,3.8,3,1,1,1,1,1,2,50.0,1,3,0,3,0,3,1,0,Bundesliga,2021_2022
Moussa Niakhate,SEN,DF,Mainz 05,25,1996,28.5,40,23,25,13,2,20,33,60.6,13,37,11,26,50,90,69,1,Bundesliga,2021_2022
Tanguy Nianzou,FRA,DF,Bayern Munich,19,2002,6.5,11,7,7,3,1,7,11,63.6,4,7,2,5,7,18,17,0,Bundesliga,2021_2022
Florian Niederlechner,GER,FW,Augsburg,30,1990,12.9,6,5,1,3,2,4,13,30.8,9,9,0,9,4,10,7,0,Bundesliga,2021_2022
Håvard Nielsen,NOR,"MF,FW",Greuther Fürth,28,1993,15.2,17,12,5,11,1,8,21,38.1,13,18,1,17,7,24,22,0,Bundesliga,2021_2022
Joakim Nilsson,SWE,DF,Arminia,27,1994,30.4,37,19,24,13,0,20,26,76.9,6,36,23,13,56,93,143,1,Bundesliga,2021_2022
Christopher Nkunku,FRA,"FW,MF",RB Leipzig,23,1997,30.3,23,10,10,11,2,9,35,25.7,26,23,2,21,15,38,15,0,Bundesliga,2021_2022
Felix Nmecha,GER,"MF,FW",Wolfsburg,20,2000,3.6,3,1,1,1,1,0,2,0.0,2,2,0,2,7,10,6,0,Bundesliga,2021_2022
Lukas Nmecha,GER,"FW,MF",Wolfsburg,22,1998,18.1,12,5,5,5,2,5,19,26.3,14,9,1,8,4,16,10,0,Bundesliga,2021_2022
Håvard Nordtveit,NOR,DF,Hoffenheim,31,1990,3.4,7,6,2,4,1,4,4,100.0,0,2,1,1,10,17,11,0,Bundesliga,2021_2022
Connor Noß,IRL,MF,Gladbach,20,2001,0.6,1,0,0,1,0,0,1,0.0,1,1,1,0,0,1,0,0,Bundesliga,2021_2022
Hugo Novoa,ESP,"MF,FW",RB Leipzig,18,2003,1.5,4,4,2,0,2,2,7,28.6,5,2,0,2,1,5,0,0,Bundesliga,2021_2022
Soma Novothny,HUN,"FW,MF",Bochum,27,1994,0.9,1,1,1,0,0,0,1,0.0,1,1,0,1,0,1,2,0,Bundesliga,2021_2022
Kasim Nuhu,GHA,DF,Hoffenheim,26,1995,0.1,0,0,0,0,0,0,1,0.0,1,0,0,0,0,0,1,0,Bundesliga,2021_2022
Hans Nunoo Sarpei,GHA,"DF,MF",Greuther Fürth,22,1998,7.1,16,11,9,7,0,10,14,71.4,4,8,5,3,14,30,21,0,Bundesliga,2021_2022
Bastian Oczipka,GER,DF,Union Berlin,32,1989,10.4,24,15,15,7,2,10,13,76.9,3,10,2,8,12,36,21,0,Bundesliga,2021_2022
Masaya Okugawa,JPN,"MF,FW",Arminia,25,1996,28.1,46,25,18,22,6,12,37,32.4,25,29,1,28,20,66,13,0,Bundesliga,2021_2022
Mathias Olesen,LUX,"MF,FW",Köln,20,2001,0.2,0,0,0,0,0,0,0,,0,0,0,0,1,1,0,0,Bundesliga,2021_2022
Dani Olmo,ESP,"MF,FW",RB Leipzig,23,1998,8.3,14,6,5,7,2,5,18,27.8,13,5,1,4,4,18,1,0,Bundesliga,2021_2022
Karim Onisiwo,AUT,FW,Mainz 05,29,1992,26.2,18,10,4,6,8,7,22,31.8,15,27,2,25,7,25,8,0,Bundesliga,2021_2022
Willi Orban,HUN,DF,RB Leipzig,28,1992,29.4,32,22,20,11,1,13,25,52.0,12,40,24,16,44,76,123,2,Bundesliga,2021_2022
Stefan Ortega,GER,GK,Arminia,28,1992,33.0,1,0,1,0,0,1,2,50.0,1,2,0,2,0,1,5,1,Bundesliga,2021_2022
Patrick Osterhage,GER,MF,Bochum,21,2000,6.7,9,6,3,5,1,3,7,42.9,4,7,1,6,11,20,8,0,Bundesliga,2021_2022
Tomáš Ostrák,CZE,"MF,FW",Köln,21,2000,0.3,1,0,0,0,1,1,3,33.3,2,0,0,0,1,2,0,0,Bundesliga,2021_2022
Paulo Otávio,BRA,"DF,MF",Wolfsburg,26,1994,4.0,14,10,7,4,3,8,15,53.3,7,11,6,5,4,18,9,0,Bundesliga,2021_2022
Reece Oxford,ENG,DF,Augsburg,22,1998,29.9,27,14,16,9,2,15,31,48.4,16,42,33,9,72,99,172,1,Bundesliga,2021_2022
Salih Özcan,TUR,MF,Köln,23,1998,25.7,42,30,14,23,5,22,51,43.1,29,37,5,32,51,93,35,1,Bundesliga,2021_2022
Levin Öztunalı,GER,MF,Union Berlin,25,1996,6.4,14,11,6,5,3,7,17,41.2,10,3,0,3,4,18,12,0,Bundesliga,2021_2022
Gonçalo Paciência,POR,FW,Eint Frankfurt,26,1994,5.7,4,2,2,1,1,1,3,33.3,2,2,0,2,1,5,4,0,Bundesliga,2021_2022
Exequiel Palacios,ARG,MF,Leverkusen,22,1998,12.2,30,19,12,14,4,15,38,39.5,23,20,1,19,28,58,11,2,Bundesliga,2021_2022
Miloš Pantović,SRB,"MF,FW",Bochum,25,1996,17.0,19,10,8,7,4,6,25,24.0,19,26,4,22,18,37,14,0,Bundesliga,2021_2022
Antonios Papadopoulos,GER,"DF,MF",Dortmund,21,1999,0.2,0,0,0,0,0,0,0,,0,1,0,1,0,0,0,0,Bundesliga,2021_2022
Merveille Papela,GER,MF,Mainz 05,20,2001,0.9,3,2,2,1,0,2,3,66.7,1,2,0,2,2,5,0,0,Bundesliga,2021_2022
Kevin Paredes,USA,"FW,DF",Wolfsburg,18,2003,0.2,1,0,0,0,1,0,0,,0,1,0,1,0,1,0,0,Bundesliga,2021_2022
Felix Passlack,GER,DF,Dortmund,23,1998,5.2,13,9,8,4,1,6,12,50.0,6,5,1,4,4,17,7,0,Bundesliga,2021_2022
Paulinho,BRA,"FW,MF",Leverkusen,21,2000,13.5,22,13,6,13,3,13,27,48.1,14,14,1,13,6,28,7,0,Bundesliga,2021_2022
Benjamin Pavard,FRA,DF,Bayern Munich,25,1996,23.1,35,20,21,13,1,19,29,65.5,10,28,16,12,36,71,50,1,Bundesliga,2021_2022
Mads Pedersen,DEN,"MF,DF",Augsburg,24,1996,15.5,28,21,8,15,5,12,27,44.4,15,13,4,9,15,43,30,0,Bundesliga,2021_2022
Peter Pekarík,SVK,DF,Hertha BSC,34,1986,24.8,45,29,33,11,1,32,46,69.6,14,28,10,18,29,74,58,0,Bundesliga,2021_2022
Philipp Pentke,GER,GK,Hoffenheim,36,1985,1.0,0,0,0,0,0,0,0,,0,0,0,0,0,0,0,0,Bundesliga,2021_2022
Ricardo Pepi,USA,"FW,MF",Augsburg,18,2003,5.3,4,2,1,3,0,1,8,12.5,7,7,0,7,3,7,8,0,Bundesliga,2021_2022
Pavao Pervan,AUT,GK,Wolfsburg,33,1987,6.0,0,0,0,0,0,0,0,,0,0,0,0,0,0,3,0,Bundesliga,2021_2022
Nils Petersen,GER,FW,Freiburg,32,1988,6.4,5,3,2,3,0,1,13,7.7,12,7,0,7,2,7,17,0,Bundesliga,2021_2022
Jens Petter Hauge,NOR,"MF,FW",Eint Frankfurt,21,1999,11.6,14,5,6,7,1,7,23,30.4,16,7,0,7,3,17,5,0,Bundesliga,2021_2022
Immanuel Pherai,SUR,MF,Dortmund,20,2001,0.0,0,0,0,0,0,0,0,,0,0,0,0,0,0,0,0,Bundesliga,2021_2022
Maximilian Philipp,GER,MF,Wolfsburg,27,1994,10.7,15,11,6,7,2,5,21,23.8,16,12,1,11,4,19,5,0,Bundesliga,2021_2022
Krzysztof Piątek,POL,FW,Hertha BSC,26,1995,3.9,2,2,0,1,1,0,1,0.0,1,0,0,0,0,2,6,0,Bundesliga,2021_2022
Amos Pieper,GER,DF,Arminia,23,1998,26.4,58,29,38,19,1,32,51,62.7,19,37,23,14,50,108,132,1,Bundesliga,2021_2022
Marvin Plattenhardt,GER,DF,Hertha BSC,29,1992,18.2,25,11,18,6,1,15,27,55.6,12,18,3,15,17,42,52,0,Bundesliga,2021_2022
Alassane Pléa,FRA,"MF,FW",Gladbach,28,1993,23.0,18,14,6,9,3,7,20,35.0,13,9,1,8,4,22,9,0,Bundesliga,2021_2022
Joel Pohjanpalo,FIN,FW,Leverkusen,26,1994,0.1,0,0,0,0,0,0,0,,0,0,0,0,0,0,0,0,Bundesliga,2021_2022
Sebastian Polter,GER,FW,Bochum,30,1991,26.0,9,3,1,4,4,2,11,18.2,9,15,5,10,2,11,24,0,Bundesliga,2021_2022
Marin Pongračić,CRO,DF,Dortmund,23,1997,9.2,17,10,13,4,0,6,10,60.0,4,11,5,6,17,34,32,2,Bundesliga,2021_2022
Stefan Posch,AUT,DF,Hoffenheim,24,1997,24.4,48,30,20,26,2,22,39,56.4,17,43,18,25,28,76,71,2,Bundesliga,2021_2022
Yussuf Poulsen,DEN,"FW,MF",RB Leipzig,27,1994,12.0,13,4,3,6,4,3,13,23.1,10,13,0,13,3,16,9,0,Bundesliga,2021_2022
Manuel Prietl,AUT,MF,Arminia,29,1991,23.6,59,26,23,31,5,23,60,38.3,37,28,3,25,39,98,33,0,Bundesliga,2021_2022
Grischa Prömel,GER,MF,Union Berlin,26,1995,26.9,36,22,14,17,5,22,52,42.3,30,18,3,15,23,59,22,0,Bundesliga,2021_2022
Nick Proschwitz,GER,FW,Hoffenheim,34,1986,0.3,0,0,0,0,0,0,0,,0,0,0,0,0,0,0,0,Bundesliga,2021_2022
Afimico Pululu,FRA,"FW,MF",Greuther Fürth,22,1999,0.8,1,0,1,0,0,1,2,50.0,1,1,0,1,0,1,0,0,Bundesliga,2021_2022
Sidney Raebiger,GER,MF,RB Leipzig,16,2005,0.0,0,0,0,0,0,0,0,,0,0,0,0,0,0,0,0,Bundesliga,2021_2022
Diant Ramaj,GER,GK,Eint Frankfurt,19,2001,1.0,0,0,0,0,0,0,0,,0,0,0,0,0,0,3,0,Bundesliga,2021_2022
Guilherme Ramos,POR,DF,Arminia,23,1997,10.1,25,15,17,8,0,12,19,63.2,7,21,8,13,27,52,52,0,Bundesliga,2021_2022
Tobias Raschl,GER,MF,Greuther Fürth,21,2000,6.6,12,9,4,8,0,5,7,71.4,2,10,1,9,3,15,1,0,Bundesliga,2021_2022
David Raum,GER,"DF,FW",Hoffenheim,23,1998,30.6,52,29,30,10,12,30,64,46.9,34,38,5,33,27,79,39,1,Bundesliga,2021_2022
Reinier,BRA,"FW,MF",Dortmund,19,2002,1.8,5,3,4,0,1,1,1,100.0,0,3,0,3,0,5,0,0,Bundesliga,2021_2022
Panagiotis Retsos,GRE,"DF,FW",Leverkusen,22,1998,0.4,0,0,0,0,0,0,0,,0,0,0,0,1,1,0,1,Bundesliga,2021_2022
Marco Reus,GER,"MF,FW",Dortmund,32,1989,27.8,45,30,13,21,11,16,42,38.1,26,23,6,17,12,57,41,1,Bundesliga,2021_2022
Elvis Rexhbeçaj,KVX,MF,Bochum,23,1997,28.2,41,20,17,19,5,19,40,47.5,21,41,6,35,27,68,15,0,Bundesliga,2021_2022
Gio Reyna,USA,MF,Dortmund,18,2002,4.9,7,4,2,4,1,3,9,33.3,6,6,0,6,1,8,3,0,Bundesliga,2021_2022
Chris Richards,USA,DF,Hoffenheim,21,2000,14.5,26,15,10,15,1,11,18,61.1,7,21,9,12,22,48,50,1,Bundesliga,2021_2022
Chris Richards,USA,DF,Bayern Munich,21,2000,0.0,0,0,0,0,0,0,0,,0,1,0,1,0,0,0,0,Bundesliga,2021_2022
Omar Richards,ENG,DF,Bayern Munich,23,1998,4.9,19,12,11,5,3,11,16,68.8,5,7,1,6,4,23,7,0,Bundesliga,2021_2022
Marco Richter,GER,"FW,MF",Hertha BSC,23,1997,18.9,30,16,14,10,6,13,36,36.1,23,30,4,26,16,46,24,0,Bundesliga,2021_2022
Manuel Riemann,GER,GK,Bochum,32,1988,31.0,1,0,1,0,0,1,4,25.0,3,0,0,0,1,2,12,3,Bundesliga,2021_2022
Marc Roca,ESP,MF,Bayern Munich,24,1996,4.2,9,7,2,4,3,2,8,25.0,6,6,0,6,6,15,4,0,Bundesliga,2021_2022
Cimo Röcker,GER,DF,Hertha BSC,27,1994,0.2,0,0,0,0,0,0,0,,0,0,0,0,2,2,0,0,Bundesliga,2021_2022
Sebastian Rode,GER,MF,Eint Frankfurt,30,1990,8.4,15,7,5,8,2,5,17,29.4,12,11,1,10,13,28,8,0,Bundesliga,2021_2022
Romario Rösch,GER,MF,Mainz 05,22,1999,0.0,0,0,0,0,0,0,0,,0,0,0,0,0,0,0,0,Bundesliga,2021_2022
Tom Rothe,GER,DF,Dortmund,16,2004,1.0,4,3,2,2,0,3,6,50.0,3,2,0,2,2,6,3,0,Bundesliga,2021_2022
Jérôme Roussillon,FRA,DF,Wolfsburg,28,1993,19.7,14,9,8,6,0,10,16,62.5,6,24,5,19,14,28,34,2,Bundesliga,2021_2022
Sebastian Rudy,GER,MF,Hoffenheim,31,1990,8.6,22,12,9,13,0,11,21,52.4,10,8,3,5,11,33,8,1,Bundesliga,2021_2022
Georginio Rutter,FRA,"FW,MF",Hoffenheim,19,2002,17.9,18,13,4,8,6,6,17,35.3,11,29,1,28,6,24,11,1,Bundesliga,2021_2022
Julian Ryerson,NOR,DF,Union Berlin,23,1997,15.9,27,15,11,12,4,17,25,68.0,8,12,4,8,16,43,32,0,Bundesliga,2021_2022
Frederik Rønnow,DEN,GK,Union Berlin,28,1992,7.0,0,0,0,0,0,0,0,,0,0,0,0,0,0,1,0,Bundesliga,2021_2022
Marcel Sabitzer,AUT,"MF,FW",RB Leipzig,27,1994,0.5,2,1,1,1,0,1,1,100.0,0,0,0,0,1,3,0,0,Bundesliga,2021_2022
Marcel Sabitzer,AUT,"MF,DF",Bayern Munich,27,1994,10.1,18,7,8,8,2,9,19,47.4,10,7,0,7,9,27,10,1,Bundesliga,2021_2022
Roland Sallai,HUN,"MF,FW",Freiburg,24,1997,17.2,22,16,8,11,3,7,23,30.4,16,12,0,12,11,33,12,0,Bundesliga,2021_2022
Diadie Samassékou,MLI,MF,Hoffenheim,25,1996,18.4,41,26,14,21,6,21,44,47.7,23,27,11,16,28,69,26,0,Bundesliga,2021_2022
Leroy Sané,GER,"FW,MF",Bayern Munich,25,1996,22.0,28,16,5,19,4,9,24,37.5,15,18,0,18,12,40,2,1,Bundesliga,2021_2022
Mohamed Sankoh,NED,FW,Stuttgart,17,2003,0.0,0,0,0,0,0,0,0,,0,0,0,0,0,0,0,0,Bundesliga,2021_2022
Baptiste Santamaria,FRA,MF,Freiburg,26,1995,0.2,0,0,0,0,0,0,1,0.0,1,0,0,0,1,1,1,0,Bundesliga,2021_2022
Bouna Sarr,SEN,DF,Bayern Munich,29,1992,0.7,4,4,2,1,1,4,5,80.0,1,2,1,1,6,10,1,0,Bundesliga,2021_2022
Joe Scally,USA,DF,Gladbach,18,2002,21.2,40,30,21,14,5,17,41,41.5,24,27,4,23,22,62,38,0,Bundesliga,2021_2022
Kevin Schade,GER,"MF,FW",Freiburg,19,2001,9.2,9,7,6,2,1,3,10,30.0,7,15,3,12,3,12,16,0,Bundesliga,2021_2022
András Schäfer,HUN,MF,Union Berlin,22,1999,2.7,4,1,3,1,0,0,5,0.0,5,7,1,6,2,6,4,0,Bundesliga,2021_2022
Louis Schaub,AUT,"MF,FW",Köln,26,1994,7.3,16,10,7,7,2,11,20,55.0,9,17,3,14,3,19,3,0,Bundesliga,2021_2022
Patrik Schick,CZE,FW,Leverkusen,25,1996,23.1,5,2,2,2,1,1,9,11.1,8,6,1,5,3,8,28,0,Bundesliga,2021_2022
Kingsley Schindler,GHA,"DF,FW",Köln,28,1993,3.9,1,0,0,0,1,1,5,20.0,4,5,1,4,5,6,5,0,Bundesliga,2021_2022
Xaver Schlager,AUT,MF,Wolfsburg,23,1997,11.6,43,20,20,20,3,20,49,40.8,29,25,2,23,9,52,14,0,Bundesliga,2021_2022
Keven Schlotterbeck,GER,"DF,FW",Freiburg,24,1997,3.5,11,5,6,5,0,5,6,83.3,1,7,4,3,11,22,24,1,Bundesliga,2021_2022
Nico Schlotterbeck,GER,DF,Freiburg,21,1999,30.9,72,43,36,34,2,33,48,68.8,15,41,32,9,56,128,154,1,Bundesliga,2021_2022
Jonathan Schmid,FRA,DF,Freiburg,31,1990,6.5,12,6,6,3,3,5,7,71.4,2,7,1,6,6,18,15,0,Bundesliga,2021_2022
Benno Schmitz,GER,DF,Köln,26,1994,26.9,57,37,21,27,9,42,86,48.8,44,44,8,36,39,96,39,0,Bundesliga,2021_2022
Alessandro Schöpf,AUT,MF,Arminia,27,1994,26.6,40,22,19,16,5,14,30,46.7,16,31,5,26,30,70,21,1,Bundesliga,2021_2022
Nico Schulz,GER,DF,Dortmund,28,1993,9.3,21,12,9,7,5,9,21,42.9,12,8,1,7,11,32,8,0,Bundesliga,2021_2022
Marvin Schwäbe,GER,GK,Köln,26,1995,21.0,0,0,0,0,0,0,0,,0,0,0,0,0,0,8,1,Bundesliga,2021_2022
Alexander Schwolow,GER,GK,Hertha BSC,29,1992,24.2,0,0,0,0,0,0,1,0.0,1,0,0,0,2,2,18,3,Bundesliga,2021_2022
Paul Seguin,GER,MF,Greuther Fürth,26,1995,23.4,50,31,15,32,3,26,56,46.4,30,27,3,24,19,69,30,1,Bundesliga,2021_2022
Davie Selke,GER,FW,Hertha BSC,26,1995,11.2,5,4,1,3,1,1,3,33.3,2,6,1,5,1,6,11,0,Bundesliga,2021_2022
Lion Semić,GER,DF,Dortmund,17,2003,0.0,0,0,0,0,0,0,0,,0,0,0,0,0,0,0,0,Bundesliga,2021_2022
Suat Serdar,GER,"MF,FW",Hertha BSC,24,1997,24.6,64,30,24,29,11,25,55,45.5,30,32,3,29,20,84,14,0,Bundesliga,2021_2022
Janni Serra,GER,FW,Arminia,23,1998,12.4,4,2,2,0,2,2,7,28.6,5,8,3,5,5,9,19,0,Bundesliga,2021_2022
Zidan Sertdemir,DEN,"MF,FW",Leverkusen,16,2005,0.2,2,2,2,0,0,0,0,,0,0,0,0,0,2,0,0,Bundesliga,2021_2022
Nils Seufert,GER,MF,Greuther Fürth,24,1997,1.1,3,2,1,1,1,0,1,0.0,1,0,0,0,0,3,0,0,Bundesliga,2021_2022
Kiliann Sildillia,FRA,"DF,MF",Freiburg,19,2002,1.9,7,3,3,4,0,3,6,50.0,3,1,0,1,2,9,7,1,Bundesliga,2021_2022
André Silva,POR,FW,RB Leipzig,25,1995,23.1,13,9,2,3,8,4,13,30.8,9,20,2,18,2,15,15,0,Bundesliga,2021_2022
Mohamed Simakan,FRA,DF,RB Leipzig,21,2000,22.3,48,27,25,21,2,27,41,65.9,14,22,11,11,40,88,46,1,Bundesliga,2021_2022
Daley Sinkgraven,NED,DF,Leverkusen,26,1995,3.9,6,2,4,0,2,3,7,42.9,4,3,1,2,3,9,6,0,Bundesliga,2021_2022
Tobias Sippel,GER,GK,Gladbach,33,1988,1.0,0,0,0,0,0,0,0,,0,0,0,0,0,0,0,0,Bundesliga,2021_2022
Hugo Siquet,BEL,DF,Freiburg,19,2002,0.2,0,0,0,0,0,0,0,,0,0,0,0,0,0,0,0,Bundesliga,2021_2022
Ellyes Skhiri,TUN,MF,Köln,26,1995,20.2,55,33,25,26,4,22,41,53.7,19,41,7,34,37,92,35,1,Bundesliga,2021_2022
Robert Skov,DEN,"FW,DF",Hoffenheim,25,1996,4.1,3,2,1,1,1,2,9,22.2,7,2,0,2,3,6,3,0,Bundesliga,2021_2022
Danilo Soares,BRA,DF,Bochum,29,1991,28.5,109,71,61,39,9,56,84,66.7,28,63,9,54,62,171,65,2,Bundesliga,2021_2022
Yann Sommer,SUI,GK,Gladbach,32,1988,33.0,0,0,0,0,0,0,2,0.0,2,0,0,0,3,3,8,3,Bundesliga,2021_2022
Borna Sosa,CRO,"DF,FW",Stuttgart,23,1998,27.8,22,12,14,5,3,12,26,46.2,14,30,3,27,26,48,61,0,Bundesliga,2021_2022
Djibril Sow,SUI,MF,Eint Frankfurt,24,1997,26.8,57,33,28,25,4,22,60,36.7,38,35,8,27,50,107,20,1,Bundesliga,2021_2022
Jerry St. Juste,NED,DF,Mainz 05,24,1996,6.7,13,9,7,6,0,7,8,87.5,1,7,3,4,14,27,14,0,Bundesliga,2021_2022
Anton Stach,GER,MF,Mainz 05,22,1998,20.7,28,19,14,13,1,15,38,39.5,23,24,5,19,51,79,25,0,Bundesliga,2021_2022
Kostas Stafylidis,GRE,"DF,MF",Bochum,27,1993,15.4,37,27,22,13,2,20,26,76.9,6,19,6,13,31,68,43,0,Bundesliga,2021_2022
Josip Stanišić,CRO,DF,Bayern Munich,21,2000,7.2,21,10,7,12,2,12,18,66.7,6,7,0,7,11,32,10,2,Bundesliga,2021_2022
Niklas Stark,GER,DF,Hertha BSC,26,1995,22.6,28,16,18,10,0,12,17,70.6,5,27,17,10,36,64,122,2,Bundesliga,2021_2022
Renato Steffen,SUI,"FW,MF",Wolfsburg,29,1991,10.7,20,16,10,10,0,9,16,56.3,7,7,0,7,13,33,14,0,Bundesliga,2021_2022
Pascal Stenzel,GER,DF,Stuttgart,25,1996,10.0,24,11,15,5,4,17,33,51.5,16,13,3,10,11,35,25,0,Bundesliga,2021_2022
Angelo Stiller,GER,MF,Hoffenheim,20,2001,18.8,30,17,11,15,4,9,23,39.1,14,32,6,26,9,39,16,2,Bundesliga,2021_2022
Lars Stindl,GER,"MF,FW",Gladbach,32,1988,18.1,23,15,6,14,3,9,33,27.3,24,28,2,26,10,33,14,0,Bundesliga,2021_2022
Kevin Stöger,AUT,MF,Mainz 05,27,1993,4.7,10,5,5,5,0,4,10,40.0,6,6,0,6,5,15,1,1,Bundesliga,2021_2022
Tobias Strobl,GER,"MF,DF",Augsburg,31,1990,3.6,8,3,3,5,0,3,11,27.3,8,7,2,5,7,15,3,0,Bundesliga,2021_2022
Niklas Süle,GER,DF,Bayern Munich,25,1995,20.4,29,23,21,7,1,18,24,75.0,6,16,12,4,28,57,49,0,Bundesliga,2021_2022
Ádám Szalai,HUN,FW,Mainz 05,33,1987,2.9,3,2,0,2,1,0,2,0.0,2,2,0,2,0,3,0,0,Bundesliga,2021_2022
Dominik Szoboszlai,HUN,"MF,FW",RB Leipzig,20,2000,17.1,17,12,5,9,3,8,27,29.6,19,30,3,27,10,27,15,0,Bundesliga,2021_2022
Jonathan Tah,GER,DF,Leverkusen,25,1996,32.0,25,18,19,5,1,17,33,51.5,16,31,20,11,43,68,156,0,Bundesliga,2021_2022
Edmond Tapsoba,BFA,DF,Leverkusen,22,1999,20.2,35,17,24,10,1,20,32,62.5,12,27,15,12,29,64,72,1,Bundesliga,2021_2022
Niklas Tauer,GER,"DF,MF",Mainz 05,20,2001,5.4,16,9,9,7,0,9,14,64.3,5,6,2,4,9,25,14,0,Bundesliga,2021_2022
Robert Tesche,GER,MF,Bochum,34,1987,3.9,6,4,4,1,1,5,7,71.4,2,6,2,4,5,11,5,1,Bundesliga,2021_2022
Cedric Teuchert,GER,"MF,FW",Union Berlin,24,1997,1.2,3,2,3,0,0,2,6,33.3,4,1,0,1,0,3,0,0,Bundesliga,2021_2022
Jan Thielmann,GER,"MF,FW",Köln,19,2002,13.2,24,16,6,12,6,8,23,34.8,15,23,2,21,10,34,11,0,Bundesliga,2021_2022
Erik Thommy,GER,"FW,MF",Stuttgart,26,1994,3.0,2,0,0,2,0,1,2,50.0,1,3,0,3,4,6,0,0,Bundesliga,2021_2022
Marcus Thuram,FRA,FW,Gladbach,23,1997,10.9,6,5,0,5,1,1,4,25.0,3,5,0,5,5,11,5,0,Bundesliga,2021_2022
Alexis Tibidi,FRA,"MF,FW",Stuttgart,17,2003,4.3,7,3,1,3,3,3,4,75.0,1,4,0,4,3,10,2,0,Bundesliga,2021_2022
Steffen Tigges,GER,"FW,MF",Dortmund,23,1998,1.2,4,3,1,2,1,2,3,66.7,1,3,1,2,0,4,3,0,Bundesliga,2021_2022
Malik Tillman,USA,"FW,MF",Bayern Munich,19,2002,1.2,2,1,0,1,1,0,1,0.0,1,5,1,4,2,4,1,0,Bundesliga,2021_2022
Timmy Tillman,GER,MF,Greuther Fürth,22,1999,22.3,43,26,17,18,8,19,42,45.2,23,33,4,29,12,55,26,0,Bundesliga,2021_2022
Umut Tohumcu,GER,MF,Hoffenheim,16,2004,0.1,0,0,0,0,0,0,0,,0,0,0,0,0,0,0,0,Bundesliga,2021_2022
Corentin Tolisso,FRA,MF,Bayern Munich,26,1994,7.8,11,5,1,9,1,7,17,41.2,10,5,1,4,9,20,10,0,Bundesliga,2021_2022
Tiago Tomás,POR,FW,Stuttgart,19,2002,11.9,8,4,0,7,1,0,6,0.0,6,3,0,3,4,12,1,0,Bundesliga,2021_2022
Jordan Torunarigha,GER,DF,Hertha BSC,23,1997,5.4,4,1,1,3,0,4,5,80.0,1,4,2,2,17,21,30,0,Bundesliga,2021_2022
Almamy Touré,MLI,"DF,MF",Eint Frankfurt,25,1996,5.6,12,9,8,3,1,4,17,23.5,13,10,3,7,5,17,19,0,Bundesliga,2021_2022
Lucas Tousart,FRA,MF,Hertha BSC,24,1997,21.8,42,25,15,22,5,10,34,29.4,24,30,6,24,35,77,55,0,Bundesliga,2021_2022
Kevin Trapp,GER,GK,Eint Frankfurt,31,1990,32.0,0,0,0,0,0,0,1,0.0,1,0,0,0,1,1,13,2,Bundesliga,2021_2022
Christopher Trimmel,AUT,"DF,FW",Union Berlin,34,1987,22.1,49,30,25,19,5,26,45,57.8,19,20,3,17,34,83,75,0,Bundesliga,2021_2022
Philipp Tschauner,GER,GK,RB Leipzig,35,1985,0.0,0,0,0,0,0,0,0,,0,0,0,0,0,0,0,0,Bundesliga,2021_2022
Tuta,BRA,DF,Eint Frankfurt,22,1999,24.3,46,28,20,22,4,26,47,55.3,21,43,15,28,41,87,76,1,Bundesliga,2021_2022
Anthony Ujah,NGA,"FW,MF",Union Berlin,30,1990,0.4,0,0,0,0,0,0,0,,0,0,0,0,0,0,0,0,Bundesliga,2021_2022
Sven Ulreich,GER,GK,Bayern Munich,32,1988,6.0,0,0,0,0,0,0,0,,0,0,0,0,0,0,1,0,Bundesliga,2021_2022
Dayot Upamecano,FRA,DF,Bayern Munich,22,1998,24.6,66,42,42,21,3,24,36,66.7,12,20,10,10,32,98,71,6,Bundesliga,2021_2022
Benjamin Uphoff,GER,GK,Freiburg,27,1993,2.0,0,0,0,0,0,0,0,,0,0,0,0,0,0,2,2,Bundesliga,2021_2022
Mark Uth,GER,"MF,FW",Köln,29,1991,22.5,32,20,9,14,9,15,49,30.6,34,27,1,26,14,46,13,0,Bundesliga,2021_2022
Ruben Vargas,SUI,"MF,FW",Augsburg,22,1998,22.0,28,21,7,14,7,11,30,36.7,19,9,1,8,16,44,13,0,Bundesliga,2021_2022
Sebastian Vasiliadis,GRE,MF,Arminia,23,1997,13.3,31,17,12,15,4,15,42,35.7,27,15,2,13,25,56,31,1,Bundesliga,2021_2022
Micky van de Ven,NED,DF,Wolfsburg,20,2001,2.1,4,4,3,1,0,0,1,0.0,1,4,1,3,2,6,8,0,Bundesliga,2021_2022
Vincent Vermeij,NED,MF,Freiburg,26,1994,0.0,0,0,0,0,0,0,0,,0,1,0,1,0,0,0,0,Bundesliga,2021_2022
Gabriel Vidovic,CRO,"FW,MF",Bayern Munich,17,2003,0.4,0,0,0,0,0,0,0,,0,0,0,0,0,0,0,0,Bundesliga,2021_2022
Nick Viergever,NED,DF,Greuther Fürth,31,1989,23.7,32,23,25,7,0,24,34,70.6,10,31,22,9,37,69,119,1,Bundesliga,2021_2022
Andreas Voglsammer,GER,"FW,MF",Union Berlin,29,1992,9.8,14,9,8,3,3,6,14,42.9,8,9,2,7,2,16,7,0,Bundesliga,2021_2022
Kevin Vogt,GER,DF,Hoffenheim,29,1991,28.5,21,12,15,6,0,11,21,52.4,10,18,7,11,13,34,101,1,Bundesliga,2021_2022
Aster Vranckx,BEL,MF,Wolfsburg,18,2002,12.7,34,13,14,16,4,14,26,53.8,12,19,7,12,13,47,16,0,Bundesliga,2021_2022
Luca Waldschmidt,GER,"MF,FW",Wolfsburg,25,1996,8.0,9,1,3,5,1,5,13,38.5,8,5,0,5,8,17,3,0,Bundesliga,2021_2022
Paul Wanner,GER,"FW,MF",Bayern Munich,15,2005,0.4,2,2,0,2,0,1,1,100.0,0,0,0,0,0,2,0,0,Bundesliga,2021_2022
Wout Weghorst,NED,FW,Wolfsburg,28,1992,17.3,13,7,3,3,7,7,17,41.2,10,10,3,7,2,15,11,1,Bundesliga,2021_2022
Noah Weißhaupt,GER,"MF,FW",Freiburg,19,2001,1.1,1,1,1,0,0,1,2,50.0,1,2,0,2,1,2,1,1,Bundesliga,2021_2022
Silvan Widmer,SUI,DF,Mainz 05,28,1993,32.4,60,28,32,20,8,36,61,59.0,25,44,16,28,43,103,59,2,Bundesliga,2021_2022
Jetro Willems,NED,DF,Greuther Fürth,27,1994,17.8,30,15,18,10,2,15,26,57.7,11,15,3,12,14,44,42,0,Bundesliga,2021_2022
Patrick Wimmer,AUT,"FW,MF",Arminia,20,2001,22.8,53,31,13,31,9,22,61,36.1,39,30,1,29,27,80,13,0,Bundesliga,2021_2022
Jonas Wind,DEN,"FW,MF",Wolfsburg,22,1999,13.1,10,6,1,7,2,1,4,25.0,3,8,3,5,6,16,13,0,Bundesliga,2021_2022
Marten Winkler,GER,MF,Hertha BSC,18,2002,0.3,0,0,0,0,0,0,0,,0,0,0,0,0,0,0,0,Bundesliga,2021_2022
Frederik Winther,DEN,DF,Augsburg,20,2001,3.6,7,2,7,0,0,5,6,83.3,1,4,1,3,8,15,21,0,Bundesliga,2021_2022
Florian Wirtz,GER,"MF,FW",Leverkusen,18,2003,20.6,25,10,6,16,3,10,28,35.7,18,12,1,11,13,38,4,0,Bundesliga,2021_2022
Axel Witsel,BEL,"MF,DF",Dortmund,32,1989,21.6,42,27,12,23,7,18,30,60.0,12,24,9,15,27,69,38,0,Bundesliga,2021_2022
Hannes Wolf,AUT,"FW,MF",Gladbach,22,1999,3.4,23,12,4,13,6,10,20,50.0,10,10,0,10,2,25,1,0,Bundesliga,2021_2022
Marius Wolf,GER,"DF,FW",Dortmund,26,1995,14.7,26,10,13,9,4,12,24,50.0,12,14,1,13,13,39,8,0,Bundesliga,2021_2022
Luca Wollschläger,GER,"FW,MF",Hertha BSC,18,2003,0.2,1,1,0,1,0,0,1,0.0,1,0,0,0,0,1,0,0,Bundesliga,2021_2022
Jeong Woo-yeong,KOR,"FW,MF",Freiburg,21,1999,19.8,15,9,6,7,2,5,15,33.3,10,8,1,7,7,22,11,0,Bundesliga,2021_2022
Joscha Wosz,GER,DF,RB Leipzig,19,2002,0.1,0,0,0,0,0,0,0,,0,0,0,0,0,0,0,0,Bundesliga,2021_2022
Dan-Axel Zagadou,FRA,DF,Dortmund,22,1999,10.6,13,7,11,1,1,7,10,70.0,3,14,4,10,15,28,38,2,Bundesliga,2021_2022
Denis Zakaria,SUI,"MF,DF",Gladbach,24,1996,15.5,23,14,9,10,4,12,35,34.3,23,25,5,20,19,42,22,1,Bundesliga,2021_2022
Deyovaisio Zeefuik,NED,DF,Hertha BSC,23,1998,6.3,11,10,6,4,1,6,12,50.0,6,12,4,8,11,22,21,1,Bundesliga,2021_2022
Robin Zentner,GER,GK,Mainz 05,26,1994,32.0,2,2,2,0,0,2,2,100.0,0,0,0,0,2,4,21,1,Bundesliga,2021_2022
Andi Zeqiri,SUI,"FW,MF",Augsburg,22,1999,11.3,14,7,3,5,6,3,12,25.0,9,10,1,9,2,16,12,0,Bundesliga,2021_2022
Simon Zoller,GER,FW,Bochum,30,1991,6.6,4,2,2,1,1,1,3,33.3,2,3,0,3,4,8,2,0,Bundesliga,2021_2022
Tammy Abraham,ENG,FW,Roma,23,1997,34.3,27,13,7,14,6,9,22,40.9,13,17,3,14,5,32,27,0,Serie_A,2021_2022
Francesco Acerbi,ITA,DF,Lazio,33,1988,28.2,25,12,15,9,1,12,19,63.2,7,37,28,9,34,59,92,0,Serie_A,2021_2022
Michel Aebischer,SUI,MF,Bologna,24,1997,4.9,14,5,5,8,1,6,11,54.5,5,4,1,3,6,20,3,0,Serie_A,2021_2022
Felix Afena-Gyan,GHA,"FW,MF",Roma,18,2003,7.4,10,3,1,6,3,4,7,57.1,3,4,0,4,3,13,0,0,Serie_A,2021_2022
Kevin Agudelo,COL,"MF,FW",Spezia,22,1998,13.7,44,26,13,26,5,7,20,35.0,13,22,0,22,8,52,6,0,Serie_A,2021_2022
Ola Aina,NGA,DF,Torino,24,1996,16.0,27,19,11,10,6,15,23,65.2,8,17,3,14,28,55,30,0,Serie_A,2021_2022
Marley Aké,FRA,"FW,MF",Juventus,20,2001,0.9,0,0,0,0,0,0,2,0.0,2,0,0,0,1,1,0,0,Serie_A,2021_2022
Jean-Daniel Akpa-Akpro,CIV,MF,Lazio,28,1992,3.5,17,10,7,9,1,7,12,58.3,5,4,2,2,2,19,6,0,Serie_A,2021_2022
Luis Alberto,ESP,MF,Lazio,28,1992,26.1,29,17,8,11,10,8,52,15.4,44,32,4,28,13,42,7,0,Serie_A,2021_2022
Giorgio Altare,ITA,DF,Cagliari,22,1998,16.3,39,28,18,18,3,21,26,80.8,5,17,5,12,30,69,70,0,Serie_A,2021_2022
Wisdom Amey,ITA,DF,Bologna,15,2005,0.8,3,2,1,1,1,2,3,66.7,1,2,0,2,3,6,1,0,Serie_A,2021_2022
Kelvin Amian,FRA,DF,Spezia,23,1998,29.4,66,42,43,18,5,30,41,73.2,11,39,21,18,32,98,75,0,Serie_A,2021_2022
Nadiem Amiri,GER,"MF,FW",Genoa,24,1996,7.6,6,4,2,2,2,2,9,22.2,7,7,0,7,0,6,0,0,Serie_A,2021_2022
Ethan Ampadu,WAL,"MF,DF",Venezia,20,2000,25.4,67,43,37,27,3,24,58,41.4,34,49,19,30,51,118,76,0,Serie_A,2021_2022
Sofyan Amrabat,MAR,MF,Fiorentina,24,1996,10.5,24,13,9,13,2,11,19,57.9,8,25,8,17,5,29,6,1,Serie_A,2021_2022
Felipe Anderson,BRA,FW,Lazio,28,1993,32.1,71,45,30,33,8,27,99,27.3,72,65,6,59,20,91,16,0,Serie_A,2021_2022
Ebenezer Annan,GHA,DF,Bologna,18,2002,0.3,1,1,1,0,0,0,0,,0,0,0,0,1,2,1,0,Serie_A,2021_2022
Cristian Ansaldi,ARG,DF,Torino,34,1986,7.7,20,9,11,7,2,10,13,76.9,3,9,1,8,6,26,10,0,Serie_A,2021_2022
Janis Antiste,FRA,FW,Spezia,18,2002,8.8,18,11,6,6,6,5,13,38.5,8,7,1,6,4,22,6,0,Serie_A,2021_2022
Mattia Aramu,ITA,"MF,FW",Venezia,26,1995,23.3,20,15,5,9,6,8,33,24.2,25,20,2,18,8,28,19,0,Serie_A,2021_2022
Marko Arnautović,AUT,FW,Bologna,32,1989,29.9,17,9,1,11,5,7,30,23.3,23,13,2,11,7,24,17,0,Serie_A,2021_2022
Tolgay Arslan,GER,MF,Udinese,30,1990,18.4,35,20,15,16,4,19,50,38.0,31,17,4,13,13,48,23,1,Serie_A,2021_2022
Kristoffer Askildsen,NOR,MF,Sampdoria,20,2001,8.4,18,6,7,11,0,9,19,47.4,10,14,7,7,15,33,15,0,Serie_A,2021_2022
Kristjan Asllani,ALB,MF,Empoli,19,2002,15.0,18,9,9,8,1,11,29,37.9,18,16,7,9,19,37,15,1,Serie_A,2021_2022
Emil Audero,ITA,GK,Sampdoria,24,1997,28.4,3,1,3,0,0,3,5,60.0,2,0,0,0,2,5,17,2,Serie_A,2021_2022
Tommaso Augello,ITA,DF,Sampdoria,26,1994,26.6,36,20,22,8,6,17,29,58.6,12,19,4,15,29,65,68,1,Serie_A,2021_2022
Ramzi Aya,ITA,DF,Salernitana,30,1990,1.5,1,1,1,0,0,1,1,100.0,0,0,0,0,0,1,4,0,Serie_A,2021_2022
Kaan Ayhan,TUR,DF,Sassuolo,26,1994,15.0,20,12,14,6,0,7,15,46.7,8,20,14,6,13,33,57,0,Serie_A,2021_2022
Milan Badelj,CRO,MF,Genoa,32,1989,31.6,64,37,25,30,9,34,80,42.5,46,39,7,32,85,149,43,0,Serie_A,2021_2022
Nicola Bagnolini,ITA,GK,Bologna,17,2004,0.0,0,0,0,0,0,0,0,,0,0,0,0,0,0,0,0,Serie_A,2021_2022
Issa Bah,LUX,FW,Venezia,19,2002,0.1,0,0,0,0,0,0,0,,0,0,0,0,0,0,0,0,Serie_A,2021_2022
Nedim Bajrami,ALB,"MF,FW",Empoli,22,1999,22.8,21,14,5,13,3,4,14,28.6,10,11,0,11,3,24,8,0,Serie_A,2021_2022
Tiemoué Bakayoko,FRA,MF,Milan,26,1994,5.6,19,13,9,7,3,5,16,31.3,11,8,1,7,9,28,10,2,Serie_A,2021_2022
Tommaso Baldanzi,ITA,FW,Empoli,18,2003,0.2,0,0,0,0,0,0,0,,0,1,0,1,0,0,0,0,Serie_A,2021_2022
Keita Baldé,SEN,FW,Cagliari,26,1995,13.7,8,4,1,5,2,1,10,10.0,9,6,0,6,4,12,6,0,Serie_A,2021_2022
Fodé Ballo-Touré,SEN,DF,Milan,24,1997,5.0,18,14,5,13,0,4,9,44.4,5,6,2,4,3,21,5,0,Serie_A,2021_2022
Filippo Bandinelli,ITA,MF,Empoli,26,1995,21.7,33,20,10,17,6,15,31,48.4,16,22,5,17,10,43,37,2,Serie_A,2021_2022
Mattia Bani,ITA,DF,Genoa,27,1993,13.5,23,13,17,6,0,14,18,77.8,4,19,11,8,20,43,76,0,Serie_A,2021_2022
Antonín Barák,CZE,"MF,FW",Hellas Verona,26,1994,26.0,18,8,9,8,1,5,17,29.4,12,32,5,27,6,24,26,0,Serie_A,2021_2022
Francesco Bardi,ITA,GK,Bologna,29,1992,2.0,0,0,0,0,0,0,0,,0,0,0,0,0,0,0,0,Serie_A,2021_2022
Nicolò Barella,ITA,MF,Inter,24,1997,32.4,63,42,17,35,11,29,55,52.7,26,26,2,24,21,84,8,2,Serie_A,2021_2022
Musa Barrow,GAM,"FW,MF",Bologna,22,1998,23.7,12,4,4,4,4,6,20,30.0,14,20,1,19,6,18,8,0,Serie_A,2021_2022
Daniele Baselli,ITA,"MF,FW",Torino,29,1992,1.7,3,3,2,0,1,2,6,33.3,4,0,0,0,1,4,2,0,Serie_A,2021_2022
Daniele Baselli,ITA,MF,Cagliari,29,1992,3.2,6,5,3,1,2,1,5,20.0,4,2,0,2,2,8,5,0,Serie_A,2021_2022
Toma Bašić,CRO,MF,Lazio,24,1996,10.9,12,8,3,9,0,5,17,29.4,12,13,4,9,4,16,21,0,Serie_A,2021_2022
Alessandro Bastoni,ITA,DF,Inter,22,1999,25.7,44,25,28,13,3,17,34,50.0,17,22,12,10,35,79,59,1,Serie_A,2021_2022
Simone Bastoni,ITA,"MF,DF",Spezia,24,1996,25.4,52,34,28,17,7,21,65,32.3,44,38,11,27,30,82,31,0,Serie_A,2021_2022
Rodrigo Becão,BRA,DF,Udinese,25,1996,34.8,81,46,49,30,2,34,60,56.7,26,45,20,25,42,123,89,3,Serie_A,2021_2022
Valon Behrami,SUI,"MF,FW",Genoa,36,1985,3.5,3,1,0,2,1,0,7,0.0,7,4,1,3,1,4,4,0,Serie_A,2021_2022
Vid Belec,SVN,GK,Salernitana,31,1990,21.5,0,0,0,0,0,0,0,,0,0,0,0,0,0,9,1,Serie_A,2021_2022
Raoul Bellanova,ITA,"DF,FW",Cagliari,21,2000,27.7,29,15,14,12,3,6,27,22.2,21,39,8,31,21,50,51,0,Serie_A,2021_2022
Andrea Belotti,ITA,FW,Torino,27,1993,15.2,7,3,2,2,3,3,12,25.0,9,12,4,8,2,9,9,0,Serie_A,2021_2022
Marco Benassi,ITA,"DF,MF",Fiorentina,26,1994,1.8,1,0,1,0,0,1,2,50.0,1,3,0,3,3,4,3,0,Serie_A,2021_2022
Marco Benassi,ITA,MF,Empoli,26,1994,4.2,6,3,3,2,1,1,10,10.0,9,4,0,4,3,9,6,0,Serie_A,2021_2022
Filip Benković,CRO,"DF,FW",Udinese,24,1997,0.1,0,0,0,0,0,0,0,,0,0,0,0,0,0,0,0,Serie_A,2021_2022
Ismaël Bennacer,ALG,MF,Milan,23,1997,16.9,44,30,22,15,7,21,50,42.0,29,20,4,16,25,69,15,0,Serie_A,2021_2022
Rodrigo Bentancur,URU,MF,Juventus,24,1997,12.8,32,18,11,18,3,7,20,35.0,13,15,2,13,26,58,15,1,Serie_A,2021_2022
Alessandro Berardi,ITA,GK,Hellas Verona,30,1991,1.0,0,0,0,0,0,0,0,,0,0,0,0,0,0,0,0,Serie_A,2021_2022
Domenico Berardi,ITA,FW,Sassuolo,26,1994,31.3,32,19,9,16,7,15,57,26.3,42,39,2,37,31,63,23,0,Serie_A,2021_2022
Bartosz Bereszyński,POL,DF,Sampdoria,29,1992,32.7,64,38,34,25,5,37,80,46.3,43,38,12,26,42,106,73,1,Serie_A,2021_2022
Etrit Berisha,ALB,GK,Torino,32,1989,10.0,0,0,0,0,0,0,0,,0,0,0,0,0,0,4,0,Serie_A,2021_2022
Federico Bernardeschi,ITA,"MF,FW",Juventus,27,1994,16.4,16,10,7,4,5,6,13,46.2,7,12,4,8,5,21,15,0,Serie_A,2021_2022
Nicolò Bertola,ITA,"MF,DF",Spezia,18,2003,0.4,3,2,3,0,0,3,4,75.0,1,0,0,0,3,6,1,0,Serie_A,2021_2022
Daniel Bessa,ITA,MF,Hellas Verona,28,1993,8.5,7,2,3,3,1,4,15,26.7,11,13,3,10,5,12,11,0,Serie_A,2021_2022
Beto,GNB,FW,Udinese,23,1998,24.1,21,6,2,14,5,9,19,47.4,10,16,1,15,5,26,25,1,Serie_A,2021_2022
Luis Binks,ENG,DF,Bologna,19,2001,7.2,8,4,7,1,0,4,6,66.7,2,6,5,1,17,25,33,1,Serie_A,2021_2022
Cristiano Biraghi,ITA,DF,Fiorentina,28,1992,35.0,37,24,17,15,5,22,53,41.5,31,28,10,18,19,56,31,1,Serie_A,2021_2022
Davide Biraschi,ITA,DF,Genoa,27,1994,10.3,31,16,19,9,3,17,24,70.8,7,16,9,7,16,47,26,0,Serie_A,2021_2022
Bjarki Bjarkason,ISL,MF,Venezia,21,2000,0.0,0,0,0,0,0,0,0,,0,0,0,0,0,0,0,0,Serie_A,2021_2022
Jeremie Boga,CIV,"FW,MF",Atalanta,24,1997,8.5,7,3,0,4,3,4,6,66.7,2,6,0,6,1,8,3,1,Serie_A,2021_2022
Jeremie Boga,CIV,"FW,MF",Sassuolo,24,1997,7.4,7,4,1,2,4,2,3,66.7,1,3,0,3,2,9,1,1,Serie_A,2021_2022
Luka Bogdan,CRO,DF,Salernitana,25,1996,4.4,6,3,6,0,0,4,8,50.0,4,3,2,1,6,12,21,0,Serie_A,2021_2022
Emil Bohinen,NOR,MF,Salernitana,22,1999,7.8,15,9,4,9,2,10,20,50.0,10,17,3,14,12,27,14,0,Serie_A,2021_2022
Giacomo Bonaventura,ITA,MF,Fiorentina,31,1989,25.2,33,17,12,16,5,21,46,45.7,25,20,2,18,14,47,9,1,Serie_A,2021_2022
Federico Bonazzoli,ITA,"FW,MF",Salernitana,24,1997,20.7,24,12,9,8,7,6,25,24.0,19,17,1,16,6,30,7,0,Serie_A,2021_2022
Kevin Bonifazi,ITA,DF,Bologna,25,1996,13.4,25,16,16,7,2,13,14,92.9,1,22,7,15,16,41,35,0,Serie_A,2021_2022
Leonardo Bonucci,ITA,DF,Juventus,34,1987,22.3,14,5,4,10,0,8,13,61.5,5,22,17,5,26,40,82,0,Serie_A,2021_2022
Mehdi Bourabia,MAR,MF,Spezia,29,1991,3.1,5,1,2,3,0,3,11,27.3,8,7,6,1,3,8,10,0,Serie_A,2021_2022
Edoardo Bove,ITA,"MF,DF",Roma,19,2002,0.8,1,1,1,0,0,0,2,0.0,2,1,0,1,1,2,0,0,Serie_A,2021_2022
Josip Brekalo,CRO,MF,Torino,23,1998,25.4,9,5,5,1,3,3,21,14.3,18,16,1,15,4,13,7,1,Serie_A,2021_2022
Gleison Bremer,BRA,DF,Torino,24,1997,32.1,49,24,27,22,0,18,28,64.3,10,54,23,31,105,154,137,0,Serie_A,2021_2022
Marcelo Brozović,CRO,MF,Inter,28,1992,32.6,77,45,34,35,8,34,68,50.0,34,28,10,18,37,114,36,2,Serie_A,2021_2022
Aleksander Buksa,POL,FW,Genoa,18,2003,0.7,0,0,0,0,0,0,1,0.0,1,0,0,0,0,0,1,0,Serie_A,2021_2022
Alessandro Buongiorno,ITA,DF,Torino,22,1999,13.1,20,9,9,8,3,9,13,69.2,4,12,6,6,31,51,44,0,Serie_A,2021_2022
Gianluca Busio,USA,MF,Venezia,19,2002,21.7,53,28,27,20,6,28,63,44.4,35,45,13,32,21,74,30,1,Serie_A,2021_2022
Arthur Cabral,BRA,FW,Fiorentina,23,1998,8.3,9,5,2,5,2,4,7,57.1,3,4,1,3,1,10,8,0,Serie_A,2021_2022
Jovane Cabral,CPV,FW,Lazio,23,1998,2.1,2,1,1,0,1,0,0,,0,1,1,0,1,3,1,0,Serie_A,2021_2022
Liberato Cacace,NZL,DF,Empoli,20,2000,5.2,15,6,8,4,3,8,8,100.0,0,7,2,5,8,23,9,0,Serie_A,2021_2022
Martín Cáceres,URU,DF,Cagliari,34,1987,9.2,13,7,5,5,3,4,12,33.3,8,12,3,9,14,27,21,0,Serie_A,2021_2022
Felipe Caicedo,ECU,FW,Genoa,32,1988,3.2,3,3,0,2,1,0,1,0.0,1,1,0,1,0,3,4,0,Serie_A,2021_2022
Felipe Caicedo,ECU,"FW,DF",Inter,32,1988,0.3,0,0,0,0,0,0,0,,0,1,0,1,0,0,0,0,Serie_A,2021_2022
Davide Calabria,ITA,DF,Milan,24,1996,23.5,62,37,31,23,8,37,72,51.4,35,25,5,20,23,85,40,1,Serie_A,2021_2022
Riccardo Calafiori,ITA,DF,Genoa,19,2002,0.9,1,0,0,0,1,1,2,50.0,1,2,1,1,2,3,4,0,Serie_A,2021_2022
Riccardo Calafiori,ITA,DF,Roma,19,2002,1.9,5,4,2,2,1,1,5,20.0,4,3,0,3,3,8,1,0,Serie_A,2021_2022
Mattia Caldara,ITA,DF,Venezia,27,1994,30.0,48,28,30,15,3,20,34,58.8,14,49,37,12,62,110,147,1,Serie_A,2021_2022
Hakan Çalhanoğlu,TUR,MF,Inter,27,1994,27.6,41,23,16,19,6,11,40,27.5,29,29,5,24,25,66,12,0,Serie_A,2021_2022
José Callejón,ESP,FW,Fiorentina,34,1987,14.4,15,6,6,6,3,13,31,41.9,18,6,0,6,3,18,1,1,Serie_A,2021_2022
Andrea Cambiaso,ITA,DF,Genoa,21,2000,19.9,46,20,28,14,4,18,32,56.3,14,33,8,25,23,69,37,1,Serie_A,2021_2022
Matteo Cancellieri,ITA,"MF,DF",Hellas Verona,19,2002,2.5,4,4,2,2,0,0,5,0.0,5,2,0,2,1,5,0,0,Serie_A,2021_2022
Antonio Candreva,ITA,"MF,FW",Sampdoria,34,1987,34.7,27,16,9,11,7,19,55,34.5,36,23,2,21,33,60,19,0,Serie_A,2021_2022
Leonardo Capezzi,ITA,MF,Salernitana,26,1995,1.9,3,1,0,3,0,1,4,25.0,3,8,4,4,0,3,2,0,Serie_A,2021_2022
Gianluca Caprari,ITA,"MF,FW",Hellas Verona,28,1993,30.4,43,25,10,22,11,17,51,33.3,34,32,0,32,4,47,7,0,Serie_A,2021_2022
Francesco Caputo,ITA,FW,Sampdoria,33,1987,31.0,5,2,1,3,1,1,6,16.7,5,5,0,5,2,7,10,0,Serie_A,2021_2022
Francesco Caputo,ITA,FW,Sassuolo,33,1987,1.7,0,0,0,0,0,0,0,,0,0,0,0,0,0,0,0,Serie_A,2021_2022
Andrea Carboni,ITA,DF,Cagliari,20,2001,24.6,53,24,33,16,4,19,42,45.2,23,42,15,27,27,80,87,0,Serie_A,2021_2022
Nicolò Casale,ITA,DF,Hellas Verona,23,1998,28.7,46,30,25,19,2,21,37,56.8,16,31,12,19,49,95,95,0,Serie_A,2021_2022
Francesco Cassata,ITA,MF,Genoa,24,1997,0.1,0,0,0,0,0,0,0,,0,0,0,0,0,0,0,0,Serie_A,2021_2022
Samu Castillejo,ESP,"FW,MF",Milan,26,1995,1.4,4,2,0,2,2,1,8,12.5,7,4,1,3,2,6,1,0,Serie_A,2021_2022
Gaetano Castrovilli,ITA,MF,Fiorentina,24,1997,15.5,25,17,15,6,4,12,23,52.2,11,18,4,14,11,36,6,0,Serie_A,2021_2022
Danilo Cataldi,ITA,MF,Lazio,26,1994,19.0,36,17,15,17,4,12,38,31.6,26,24,12,12,17,53,19,1,Serie_A,2021_2022
Pietro Ceccaroni,ITA,DF,Venezia,25,1995,34.7,55,31,33,18,4,25,36,69.4,11,45,32,13,30,85,143,0,Serie_A,2021_2022
Federico Ceccherini,ITA,DF,Hellas Verona,29,1992,26.2,32,16,19,10,3,19,33,57.6,14,13,8,5,50,82,76,1,Serie_A,2021_2022
Emil Ceide,NOR,"FW,MF",Sassuolo,19,2001,0.6,1,1,0,1,0,1,2,50.0,1,1,0,1,0,1,0,0,Serie_A,2021_2022
Luca Ceppitelli,ITA,DF,Cagliari,31,1989,16.1,23,12,13,10,0,16,27,59.3,11,21,14,7,25,48,54,0,Serie_A,2021_2022
Damir Ceter,COL,FW,Cagliari,23,1997,0.1,0,0,0,0,0,0,0,,0,0,0,0,0,0,0,0,Serie_A,2021_2022
Julian Chabot,GER,DF,Sampdoria,23,1998,5.4,12,10,8,4,0,8,10,80.0,2,7,4,3,9,21,28,1,Serie_A,2021_2022
Giorgio Chiellini,ITA,DF,Juventus,36,1984,15.0,22,13,17,4,1,7,13,53.8,6,24,18,6,22,44,59,0,Serie_A,2021_2022
Federico Chiesa,ITA,"MF,FW",Juventus,23,1997,9.6,26,19,9,9,8,12,26,46.2,14,7,0,7,4,30,3,0,Serie_A,2021_2022
Vlad Chiricheș,ROU,DF,Sassuolo,31,1989,25.6,28,15,19,9,0,10,21,47.6,11,34,21,13,41,69,71,4,Serie_A,2021_2022
Riccardo Ciervo,ITA,"MF,DF",Sampdoria,19,2002,2.5,8,3,4,3,1,2,6,33.3,4,1,0,1,2,10,2,0,Serie_A,2021_2022
Moustapha Cissé,GUI,FW,Atalanta,17,2003,0.4,1,0,0,1,0,0,3,0.0,3,0,0,0,0,1,0,0,Serie_A,2021_2022
Giorgio Cittadini,ITA,DF,Atalanta,19,2002,0.0,0,0,0,0,0,0,0,,0,0,0,0,1,1,0,0,Serie_A,2021_2022
Ebrima Colley,GAM,"FW,MF",Spezia,21,2000,4.4,6,1,3,2,1,1,7,14.3,6,8,0,8,3,9,2,0,Serie_A,2021_2022
Omar Colley,GAM,DF,Sampdoria,28,1992,30.5,47,36,32,14,1,22,32,68.8,10,31,19,12,80,127,135,2,Serie_A,2021_2022
Andrea Consigli,ITA,GK,Sassuolo,34,1987,36.9,0,0,0,0,0,0,2,0.0,2,0,0,0,0,0,23,3,Serie_A,2021_2022
Andrea Conti,ITA,"DF,MF",Sampdoria,27,1994,2.6,4,2,2,1,1,3,6,50.0,3,4,0,4,7,11,4,0,Serie_A,2021_2022
Andrea Conti,ITA,DF,Milan,27,1994,0.1,0,0,0,0,0,0,0,,0,0,0,0,0,0,0,0,Serie_A,2021_2022
Diego Coppola,ITA,DF,Hellas Verona,17,2003,2.8,8,4,4,4,0,3,3,100.0,0,5,1,4,4,12,5,0,Serie_A,2021_2022
Joaquín Correa,ARG,FW,Inter,26,1994,11.4,11,5,2,6,3,1,13,7.7,12,8,1,7,3,14,2,0,Serie_A,2021_2022
Lassana Coulibaly,MLI,MF,Salernitana,25,1996,25.9,58,32,29,26,3,24,62,38.7,38,40,13,27,22,80,27,0,Serie_A,2021_2022
Mamadou Coulibaly,SEN,MF,Salernitana,22,1999,9.0,15,12,8,5,2,7,20,35.0,13,9,0,9,11,26,9,0,Serie_A,2021_2022
Alessio Cragno,ITA,GK,Cagliari,27,1994,35.0,3,3,2,1,0,3,3,100.0,0,0,0,0,1,4,14,1,Serie_A,2021_2022
Domenico Criscito,ITA,DF,Genoa,34,1986,18.0,37,21,19,14,4,16,25,64.0,9,22,12,10,39,76,57,0,Serie_A,2021_2022
Bryan Cristante,ITA,MF,Roma,26,1995,29.8,79,39,31,39,9,37,69,53.6,32,31,5,26,40,119,45,0,Serie_A,2021_2022
Domen Črnigoj,SVN,MF,Venezia,25,1995,20.9,21,13,7,11,3,11,29,37.9,18,27,8,19,24,45,42,0,Serie_A,2021_2022
Giovanni Crociata,ITA,FW,Empoli,23,1997,0.2,0,0,0,0,0,0,1,0.0,1,0,0,0,0,0,0,0,Serie_A,2021_2022
Juan Cuadrado,COL,"DF,MF",Juventus,33,1988,27.6,48,23,30,13,5,30,55,54.5,25,23,5,18,29,77,34,0,Serie_A,2021_2022
Mickaël Cuisance,FRA,MF,Venezia,21,1999,10.2,23,9,7,12,4,10,28,35.7,18,14,0,14,12,35,5,0,Serie_A,2021_2022
Patrick Cutrone,ITA,FW,Empoli,23,1998,15.6,5,2,0,3,2,1,9,11.1,8,11,1,10,5,10,1,0,Serie_A,2021_2022
Danilo D'Ambrosio,ITA,DF,Inter,32,1988,11.1,30,15,21,8,1,11,22,50.0,11,21,10,11,8,38,20,0,Serie_A,2021_2022
Mikkel Damsgaard,DEN,"MF,FW",Sampdoria,21,2000,6.4,27,13,12,11,4,20,36,55.6,16,16,1,15,7,34,7,0,Serie_A,2021_2022
Danilo,BRA,"DF,MF",Juventus,30,1991,21.0,37,26,20,13,4,18,28,64.3,10,21,12,9,32,69,53,1,Serie_A,2021_2022
Ebrima Darboe,GAM,MF,Roma,20,2001,0.7,1,1,0,1,0,0,0,,0,0,0,0,1,2,0,1,Serie_A,2021_2022
Matteo Darmian,ITA,DF,Inter,31,1989,16.7,32,16,17,9,6,16,41,39.0,25,16,1,15,19,51,25,0,Serie_A,2021_2022
Paweł Dawidowicz,POL,DF,Hellas Verona,26,1995,13.3,30,18,16,10,4,16,25,64.0,9,14,11,3,21,51,53,0,Serie_A,2021_2022
Sebastien De Maio,FRA,DF,Udinese,34,1987,2.0,5,1,4,1,0,1,9,11.1,8,6,5,1,1,6,9,0,Serie_A,2021_2022
Tommaso De Nipoti,ITA,FW,Atalanta,18,2003,0.1,0,0,0,0,0,0,0,,0,0,0,0,0,0,0,0,Serie_A,2021_2022
Mattia De Sciglio,ITA,DF,Juventus,28,1992,13.0,24,12,7,9,8,11,24,45.8,13,10,0,10,10,34,30,0,Serie_A,2021_2022
Lorenzo De Silvestri,ITA,DF,Bologna,33,1988,25.5,23,14,13,8,2,9,31,29.0,22,25,7,18,26,49,52,0,Serie_A,2021_2022
Grégoire Defrel,MTQ,FW,Sassuolo,30,1991,15.1,15,9,4,8,3,6,16,37.5,10,11,1,10,4,19,11,0,Serie_A,2021_2022
Alessandro Deiola,ITA,MF,Cagliari,25,1995,23.7,47,22,15,25,7,23,58,39.7,35,28,10,18,26,73,45,0,Serie_A,2021_2022
Filippo Delli Carri,ITA,DF,Salernitana,22,1999,3.7,6,4,4,2,0,5,14,35.7,9,6,2,4,4,10,14,0,Serie_A,2021_2022
Merih Demiral,TUR,DF,Atalanta,23,1998,21.3,31,17,18,12,1,15,28,53.6,13,26,14,12,58,89,68,1,Serie_A,2021_2022
Diego Demme,GER,MF,Napoli,29,1991,7.7,21,12,4,13,4,10,21,47.6,11,11,2,9,9,30,2,0,Serie_A,2021_2022
Fabio Depaoli,ITA,DF,Hellas Verona,24,1997,7.8,12,7,6,4,2,1,7,14.3,6,9,2,7,8,20,14,0,Serie_A,2021_2022
Fabio Depaoli,ITA,"MF,DF",Sampdoria,24,1997,1.2,3,1,1,2,0,0,2,0.0,2,2,1,1,1,4,2,0,Serie_A,2021_2022
Mattia Destro,ITA,FW,Genoa,30,1991,19.4,9,4,1,4,4,1,6,16.7,5,14,1,13,2,11,16,0,Serie_A,2021_2022
Gerard Deulofeu,ESP,"FW,MF",Udinese,27,1994,29.1,11,6,2,3,6,7,29,24.1,22,14,0,14,9,20,4,0,Serie_A,2021_2022
Jacopo Dezi,ITA,MF,Venezia,29,1992,0.2,0,0,0,0,0,0,1,0.0,1,0,0,0,1,1,0,0,Serie_A,2021_2022
Samuel Di Carmine,ITA,FW,Hellas Verona,32,1988,0.4,0,0,0,0,0,0,0,,0,0,0,0,0,0,0,0,Serie_A,2021_2022
Federico Di Francesco,ITA,"FW,MF",Empoli,27,1994,15.2,16,5,2,8,6,9,23,39.1,14,17,1,16,9,25,11,0,Serie_A,2021_2022
Giovanni Di Lorenzo,ITA,DF,Napoli,27,1993,31.9,58,36,30,20,8,33,58,56.9,25,28,10,18,38,96,46,1,Serie_A,2021_2022
Francesco Di Mariano,ITA,FW,Venezia,25,1996,0.7,1,1,0,1,0,0,0,,0,2,1,1,0,1,0,0,Serie_A,2021_2022
Francesco Di Tacchio,ITA,MF,Salernitana,31,1990,13.9,17,7,5,10,2,9,25,36.0,16,16,8,8,22,39,25,0,Serie_A,2021_2022
Amadou Diawara,GUI,MF,Roma,24,1997,1.9,7,2,5,2,0,1,3,33.3,2,2,0,2,0,7,1,0,Serie_A,2021_2022
Brahim Díaz,MAR,MF,Milan,21,1999,20.6,23,17,3,11,9,8,22,36.4,14,11,0,11,8,31,4,0,Serie_A,2021_2022
Mitchell Dijks,NED,"DF,FW",Bologna,28,1993,7.7,15,6,6,6,3,5,12,41.7,7,11,2,9,3,18,10,1,Serie_A,2021_2022
Federico Dimarco,ITA,DF,Inter,23,1997,15.9,28,15,10,15,3,13,24,54.2,11,6,1,5,19,47,19,0,Serie_A,2021_2022
Filippo Distefano,ITA,FW,Fiorentina,17,2003,0.0,0,0,0,0,0,0,0,,0,0,0,0,0,0,0,0,Serie_A,2021_2022
Koffi Djidji,CIV,DF,Torino,28,1992,19.3,48,29,21,23,4,14,18,77.8,4,20,9,11,34,82,60,0,Serie_A,2021_2022
Berat Djimsiti,ALB,DF,Atalanta,28,1993,25.1,43,24,21,20,2,29,46,63.0,17,21,11,10,31,74,56,0,Serie_A,2021_2022
Nicolás Domínguez,ARG,MF,Bologna,23,1998,22.4,76,45,36,32,8,32,76,42.1,44,38,9,29,32,108,34,1,Serie_A,2021_2022
Bartłomiej Drągowski,POL,GK,Fiorentina,23,1997,6.2,0,0,0,0,0,0,0,,0,0,0,0,1,1,5,2,Serie_A,2021_2022
Radu Drăgușin,ROU,DF,Sampdoria,19,2002,6.9,4,3,2,2,0,2,6,33.3,4,8,4,4,10,14,33,0,Serie_A,2021_2022
Radu Drăgușin,ROU,DF,Salernitana,19,2002,5.4,5,4,2,3,0,4,10,40.0,6,7,3,4,13,18,17,0,Serie_A,2021_2022
Denzel Dumfries,NED,DF,Inter,25,1996,22.5,32,12,9,14,9,16,32,50.0,16,15,6,9,9,41,26,0,Serie_A,2021_2022
Alfred Duncan,GHA,MF,Fiorentina,28,1993,21.5,34,19,13,16,5,11,32,34.4,21,32,3,29,10,44,7,0,Serie_A,2021_2022
Paulo Dybala,ARG,"FW,MF",Juventus,27,1993,22.9,30,13,7,14,9,8,35,22.9,27,19,0,19,9,39,4,3,Serie_A,2021_2022
Edin Džeko,BIH,FW,Inter,35,1986,27.4,14,8,7,4,3,8,25,32.0,17,22,5,17,4,18,35,0,Serie_A,2021_2022
Tyronne Ebuehi,NGA,DF,Venezia,25,1995,12.6,28,12,16,8,4,10,18,55.6,8,13,3,10,16,44,38,1,Serie_A,2021_2022
Éderson,BRA,MF,Salernitana,22,1999,12.7,29,18,11,14,4,14,26,53.8,12,11,2,9,19,48,8,0,Serie_A,2021_2022
Albin Ekdal,SWE,MF,Sampdoria,32,1989,18.2,43,28,17,21,5,26,56,46.4,30,27,7,20,29,72,25,0,Serie_A,2021_2022
Caleb Ekuban,GHA,"FW,MF",Genoa,27,1994,19.1,19,12,2,12,5,7,23,30.4,16,19,5,14,9,28,6,0,Serie_A,2021_2022
Elif Elmas,MKD,"FW,MF",Napoli,21,1999,18.0,25,15,10,10,5,12,28,42.9,16,13,2,11,8,33,17,0,Serie_A,2021_2022
Martin Erlic,CRO,DF,Spezia,23,1998,28.6,28,16,18,10,0,10,18,55.6,8,54,39,15,28,56,122,1,Serie_A,2021_2022
Gonzalo Escalante,ARG,MF,Lazio,28,1993,0.1,1,0,1,0,0,1,1,100.0,0,2,1,1,1,2,0,0,Serie_A,2021_2022
Diego Falcinelli,ITA,FW,Bologna,30,1991,0.7,2,2,2,0,0,0,0,,0,0,0,0,1,3,1,0,Serie_A,2021_2022
Wladimiro Falcone,ITA,GK,Sampdoria,26,1995,9.5,0,0,0,0,0,0,0,,0,0,0,0,1,1,5,0,Serie_A,2021_2022
Paolo Faragò,ITA,MF,Cagliari,28,1993,0.2,1,1,1,0,0,0,0,,0,2,0,2,0,1,0,0,Serie_A,2021_2022
Davide Faraoni,ITA,DF,Hellas Verona,29,1991,28.6,62,40,38,21,3,29,62,46.8,33,38,5,33,23,85,62,1,Serie_A,2021_2022
Mohamed Fares,ALG,"DF,FW",Genoa,25,1996,6.5,4,2,1,3,0,0,4,0.0,4,8,3,5,8,12,11,0,Serie_A,2021_2022
Diego Farias,BRA,"MF,FW",Cagliari,31,1990,0.7,1,1,0,1,0,1,3,33.3,2,0,0,0,0,1,0,0,Serie_A,2021_2022
Andrea Favilli,ITA,FW,Genoa,24,1997,0.4,1,1,0,0,1,0,0,,0,0,0,0,0,1,2,0,Serie_A,2021_2022
Federico Fazio,ARG,DF,Salernitana,34,1987,15.9,17,11,10,6,1,9,12,75.0,3,21,16,5,27,44,67,1,Serie_A,2021_2022
Luiz Felipe,ITA,DF,Lazio,24,1997,27.7,41,23,21,16,4,20,34,58.8,14,40,33,7,33,74,102,1,Serie_A,2021_2022
Alex Ferrari,ITA,DF,Sampdoria,27,1994,18.3,40,22,28,9,3,19,33,57.6,14,31,22,9,39,79,63,1,Serie_A,2021_2022
Salvador Ferrer,ESP,"DF,MF",Spezia,23,1998,16.6,32,18,15,9,8,12,25,48.0,13,24,12,12,18,50,46,0,Serie_A,2021_2022
Riccardo Fiamozzi,ITA,DF,Empoli,28,1993,6.9,7,5,2,2,3,2,4,50.0,2,6,5,1,7,14,12,0,Serie_A,2021_2022
Luca Fiordilino,ITA,MF,Venezia,25,1996,7.3,21,13,11,6,4,13,27,48.1,14,14,4,10,11,32,12,0,Serie_A,2021_2022
Vincenzo Fiorillo,ITA,GK,Salernitana,31,1990,1.0,0,0,0,0,0,0,0,,0,0,0,0,0,0,1,0,Serie_A,2021_2022
Alessandro Florenzi,ITA,"DF,FW",Milan,30,1991,12.8,28,14,14,7,7,14,32,43.8,18,9,2,7,27,55,10,1,Serie_A,2021_2022
Fernando Forestieri,ITA,"FW,MF",Udinese,31,1990,0.6,0,0,0,0,0,0,1,0.0,1,1,0,1,0,0,1,0,Serie_A,2021_2022
Francesco Forte,ITA,FW,Venezia,28,1993,4.7,3,2,0,2,1,2,5,40.0,3,1,0,1,0,3,2,0,Serie_A,2021_2022
Gianluca Frabotta,ITA,"DF,MF",Hellas Verona,22,1999,0.2,0,0,0,0,0,0,1,0.0,1,1,0,1,1,1,0,0,Serie_A,2021_2022
Davide Frattesi,ITA,MF,Sassuolo,21,1999,31.7,46,16,26,18,2,26,52,50.0,26,44,12,32,29,75,62,1,Serie_A,2021_2022
Morten Frendrup,DEN,"DF,MF",Genoa,20,2001,7.7,40,24,19,13,8,13,29,44.8,16,19,2,17,17,57,7,1,Serie_A,2021_2022
Remo Freuler,SUI,MF,Atalanta,29,1992,26.3,69,39,22,33,14,30,70,42.9,40,48,8,40,35,104,26,1,Serie_A,2021_2022
Matteo Gabbia,ITA,DF,Milan,21,1999,6.0,4,3,1,3,0,0,4,0.0,4,2,2,0,8,12,12,0,Serie_A,2021_2022
Manolo Gabbiadini,ITA,"FW,MF",Sampdoria,29,1991,12.7,6,4,3,2,1,1,7,14.3,6,5,2,3,3,9,10,0,Serie_A,2021_2022
Gianluca Gaetano,ITA,MF,Napoli,21,2000,0.2,1,1,1,0,0,1,2,50.0,1,0,0,0,2,3,0,0,Serie_A,2021_2022
Luca Gagliano,ITA,"FW,DF",Cagliari,21,2000,0.1,0,0,0,0,0,0,0,,0,1,0,1,0,0,1,0,Serie_A,2021_2022
Roberto Gagliardini,ITA,MF,Inter,27,1994,7.2,12,6,7,4,1,1,13,7.7,12,14,5,9,9,21,7,0,Serie_A,2021_2022
Riccardo Gagliolo,SWE,DF,Salernitana,31,1990,12.6,23,12,16,4,3,16,27,59.3,11,15,8,7,28,51,52,0,Serie_A,2021_2022
Nicolas Galazzi,ITA,MF,Venezia,20,2000,0.2,2,1,1,0,1,0,1,0.0,1,0,0,0,0,2,0,0,Serie_A,2021_2022
Pablo Galdames Millán,CHI,MF,Genoa,24,1996,11.4,28,12,6,16,6,12,35,34.3,23,16,2,14,8,36,9,1,Serie_A,2021_2022
Luca Gemello,ITA,GK,Torino,21,2000,1.0,0,0,0,0,0,0,0,,0,0,0,0,0,0,0,0,Serie_A,2021_2022
Paolo Ghiglione,ITA,DF,Genoa,24,1997,6.7,17,12,8,6,3,9,14,64.3,5,11,5,6,10,27,12,1,Serie_A,2021_2022
Faouzi Ghoulam,ALG,DF,Napoli,30,1991,3.7,3,1,1,2,0,0,3,0.0,3,2,1,1,3,6,10,0,Serie_A,2021_2022
Sebastian Giovinco,ITA,MF,Sampdoria,34,1987,0.4,0,0,0,0,0,0,1,0.0,1,0,0,0,0,0,0,0,Serie_A,2021_2022
Olivier Giroud,FRA,FW,Milan,34,1986,21.0,15,11,4,6,5,3,17,17.6,14,13,4,9,3,18,19,0,Serie_A,2021_2022
Diego Godín,URU,DF,Cagliari,35,1986,9.1,18,7,13,3,2,10,15,66.7,5,7,5,2,13,31,46,0,Serie_A,2021_2022
Edoardo Goldaniga,ITA,DF,Cagliari,27,1993,10.4,12,5,7,5,0,4,11,36.4,7,8,5,3,22,34,23,0,Serie_A,2021_2022
Edoardo Goldaniga,ITA,"DF,MF",Sassuolo,27,1993,0.0,0,0,0,0,0,0,0,,0,0,0,0,0,0,0,0,Serie_A,2021_2022
Cedric Gondo,CIV,FW,Salernitana,24,1996,7.8,5,2,2,2,1,2,5,40.0,3,2,0,2,3,8,2,0,Serie_A,2021_2022
Nicolás González,ARG,FW,Fiorentina,23,1998,26.2,21,16,6,8,7,9,28,32.1,19,26,2,24,21,42,4,1,Serie_A,2021_2022
Robin Gosens,GER,DF,Atalanta,27,1994,5.1,7,3,3,4,0,4,8,50.0,4,4,0,4,9,16,1,0,Serie_A,2021_2022
Robin Gosens,GER,DF,Inter,27,1994,1.9,3,1,1,2,0,0,0,,0,5,2,3,3,6,3,0,Serie_A,2021_2022
Alberto Grassi,ITA,MF,Cagliari,26,1995,24.2,47,26,13,30,4,16,38,42.1,22,27,9,18,63,110,33,1,Serie_A,2021_2022
Koray Günter,GER,DF,Hellas Verona,26,1994,26.8,32,18,19,11,2,16,32,50.0,16,27,21,6,69,101,110,1,Serie_A,2021_2022
Albert Guðmundsson,ISL,"FW,MF",Genoa,24,1997,6.7,5,3,2,1,2,3,8,37.5,5,2,0,2,5,10,4,0,Serie_A,2021_2022
Emmanuel Gyasi,GHA,"FW,MF",Spezia,27,1994,33.7,47,30,31,9,7,21,41,51.2,20,22,4,18,16,63,43,1,Serie_A,2021_2022
Norbert Gyömbér,SVK,DF,Salernitana,29,1992,28.5,53,32,40,11,2,33,50,66.0,17,38,24,14,44,97,126,1,Serie_A,2021_2022
Nicolas Haas,SUI,MF,Empoli,25,1996,11.1,35,22,15,10,10,17,39,43.6,22,24,4,20,9,44,17,1,Serie_A,2021_2022
Samir Handanović,SVN,GK,Inter,37,1984,37.0,1,0,1,0,0,1,2,50.0,1,1,0,1,0,1,6,3,Serie_A,2021_2022
Ridgeciano Haps,SUR,DF,Venezia,28,1993,22.8,36,20,26,4,6,11,21,52.4,10,34,12,22,29,65,57,1,Serie_A,2021_2022
Abdou Harroui,NED,MF,Sassuolo,23,1998,5.0,11,4,4,7,0,8,11,72.7,3,14,0,14,4,15,5,0,Serie_A,2021_2022
Hans Hateboer,NED,"DF,MF",Atalanta,27,1994,15.4,22,14,10,8,4,11,26,42.3,15,11,1,10,7,29,20,0,Serie_A,2021_2022
Silvan Hefti,SUI,DF,Genoa,23,1997,14.3,50,30,23,22,5,32,58,55.2,26,20,4,16,20,70,34,1,Serie_A,2021_2022
Liam Henderson,SCO,MF,Empoli,25,1996,22.4,22,13,7,8,7,9,31,29.0,22,14,4,10,9,31,13,0,Serie_A,2021_2022
Dalbert Henrique,BRA,"DF,MF",Cagliari,27,1993,23.1,43,23,23,16,4,11,35,31.4,24,28,5,23,24,67,34,0,Serie_A,2021_2022
Matheus Henrique,BRA,MF,Sassuolo,23,1997,12.0,10,3,6,3,1,6,24,25.0,18,14,2,12,7,17,12,1,Serie_A,2021_2022
Thomas Henry,FRA,FW,Venezia,26,1994,23.5,9,4,2,3,4,5,13,38.5,8,11,5,6,2,11,25,0,Serie_A,2021_2022
Theo Hernández,FRA,DF,Milan,23,1997,30.1,53,35,34,14,5,29,40,72.5,11,16,3,13,23,76,29,3,Serie_A,2021_2022
Hernani,BRA,"MF,FW",Genoa,27,1994,7.6,20,10,8,9,3,13,32,40.6,19,17,4,13,13,33,5,1,Serie_A,2021_2022
Daan Heymans,BEL,"MF,FW",Venezia,22,1999,2.8,3,1,1,2,0,1,5,20.0,4,7,3,4,4,7,3,0,Serie_A,2021_2022
Aaron Hickey,SCO,DF,Bologna,19,2002,31.3,46,29,24,15,7,20,30,66.7,10,36,13,23,29,75,44,0,Serie_A,2021_2022
Martin Hongla,CMR,MF,Hellas Verona,23,1998,7.2,14,8,5,6,3,4,8,50.0,4,6,2,4,4,18,16,1,Serie_A,2021_2022
Sydney van Hooijdonk,NED,"FW,MF",Bologna,21,2000,0.4,0,0,0,0,0,0,1,0.0,1,1,0,1,0,0,0,0,Serie_A,2021_2022
Petko Hristov,BUL,DF,Spezia,22,1999,13.9,17,10,11,6,0,10,16,62.5,6,29,23,6,19,36,47,0,Serie_A,2021_2022
Elseid Hysaj,ALB,DF,Lazio,27,1994,22.5,46,30,25,17,4,29,45,64.4,16,18,6,12,24,70,34,1,Serie_A,2021_2022
Roger Ibanez,BRA,DF,Roma,22,1998,32.1,54,32,31,19,4,26,43,60.5,17,26,7,19,62,116,104,2,Serie_A,2021_2022
Zlatan Ibrahimović,SWE,FW,Milan,39,1981,11.3,0,0,0,0,0,0,2,0.0,2,2,1,1,3,3,9,0,Serie_A,2021_2022
Igor,BRA,DF,Fiorentina,23,1998,24.9,53,31,34,16,3,30,40,75.0,10,37,19,18,31,84,46,4,Serie_A,2021_2022
Jonathan Ikone,FRA,FW,Fiorentina,23,1998,7.2,7,3,2,3,2,3,10,30.0,7,10,2,8,1,8,2,0,Serie_A,2021_2022
Ivan Ilić,SRB,MF,Hellas Verona,20,2001,28.1,39,18,16,19,4,20,54,37.0,34,34,12,22,22,61,55,0,Serie_A,2021_2022
Josip Iličić,SVN,"MF,FW",Atalanta,33,1988,9.3,7,7,3,2,2,4,17,23.5,13,6,1,5,3,10,1,0,Serie_A,2021_2022
Ciro Immobile,ITA,FW,Lazio,31,1990,30.1,10,5,4,4,2,1,15,6.7,14,7,1,6,3,13,16,0,Serie_A,2021_2022
Lorenzo Insigne,ITA,FW,Napoli,30,1991,25.4,23,14,8,12,3,8,44,18.2,36,30,1,29,20,43,3,1,Serie_A,2021_2022
Ardian Ismajli,ALB,DF,Empoli,24,1996,14.1,13,9,8,4,1,5,14,35.7,9,21,11,10,24,37,80,0,Serie_A,2021_2022
Armando Izzo,ITA,DF,Torino,29,1992,5.8,16,9,14,2,0,9,11,81.8,2,5,4,1,17,33,21,0,Serie_A,2021_2022
Mato Jajalo,BIH,MF,Udinese,33,1988,7.0,24,14,14,7,3,11,23,47.8,12,7,0,7,11,35,5,0,Serie_A,2021_2022
Paweł Jaroszyński,POL,DF,Salernitana,26,1994,5.7,10,5,7,3,0,5,7,71.4,2,4,0,4,10,20,19,0,Serie_A,2021_2022
Juan Jesus,BRA,DF,Napoli,30,1991,14.2,25,17,14,11,0,12,18,66.7,6,21,16,5,9,34,34,0,Serie_A,2021_2022
Dennis Johnsen,NOR,"FW,MF",Venezia,23,1998,16.1,14,10,8,4,2,6,18,33.3,12,14,1,13,5,19,3,0,Serie_A,2021_2022
Kaio Jorge,BRA,"MF,FW",Juventus,19,2002,1.3,2,1,0,2,0,1,3,33.3,2,1,0,1,0,2,2,0,Serie_A,2021_2022
Flavio Junior Bianchi,ITA,"FW,MF",Genoa,21,2000,3.5,2,2,1,0,1,0,2,0.0,2,0,0,0,0,2,0,0,Serie_A,2021_2022
Hamed Junior Traorè,CIV,"FW,MF",Sassuolo,21,2000,19.7,32,18,8,14,10,10,46,21.7,36,22,2,20,12,44,6,1,Serie_A,2021_2022
Nikola Kalinić,CRO,FW,Hellas Verona,33,1988,4.5,2,0,0,1,1,1,2,50.0,1,2,0,2,0,2,2,0,Serie_A,2021_2022
Yayah Kallon,SLE,"FW,MF",Genoa,20,2001,7.1,15,11,5,6,4,3,11,27.3,8,7,1,6,1,16,5,0,Serie_A,2021_2022
Pierre Kalulu,FRA,DF,Milan,21,2000,21.6,61,36,36,21,4,17,22,77.3,5,36,15,21,26,87,54,0,Serie_A,2021_2022
Dimitrije Kamenović,SRB,DF,Lazio,21,2000,0.5,1,1,1,0,0,1,1,100.0,0,0,0,0,2,3,1,0,Serie_A,2021_2022
Rick Karsdorp,NED,"DF,FW",Roma,26,1995,32.0,53,38,33,13,7,28,50,56.0,22,22,5,17,34,87,26,1,Serie_A,2021_2022
Denso Kasius,NED,"DF,FW",Bologna,18,2002,2.0,9,7,5,3,1,2,5,40.0,3,4,0,4,3,12,4,0,Serie_A,2021_2022
Grigoris Kastanos,CYP,"MF,FW",Salernitana,23,1998,15.0,30,19,9,19,2,7,23,30.4,16,21,5,16,22,52,8,0,Serie_A,2021_2022
Moise Kean,ITA,FW,Juventus,21,2000,12.2,9,4,2,5,2,6,16,37.5,10,5,0,5,3,12,8,1,Serie_A,2021_2022
Wajdi Kechrida,TUN,"DF,MF",Salernitana,25,1995,10.6,9,6,6,3,0,8,13,61.5,5,10,2,8,8,17,15,0,Serie_A,2021_2022
Dimitrios Keramitsis,GRE,MF,Roma,17,2004,0.0,0,0,0,0,0,0,0,,0,0,0,0,0,0,0,0,Serie_A,2021_2022
Franck Kessié,CIV,MF,Milan,24,1996,25.6,41,23,12,24,5,17,26,65.4,9,39,10,29,23,64,22,0,Serie_A,2021_2022
Jakub Kiwior,POL,MF,Spezia,21,2000,21.8,50,27,25,19,6,26,57,45.6,31,38,15,23,40,90,53,0,Serie_A,2021_2022
Sofian Kiyine,MAR,"MF,FW",Venezia,23,1997,13.8,24,14,9,11,4,12,32,37.5,20,15,1,14,10,34,9,0,Serie_A,2021_2022
Simon Kjær,DEN,DF,Milan,32,1989,8.9,20,12,9,8,3,6,12,50.0,6,17,13,4,9,29,39,0,Serie_A,2021_2022
Aleksandr Kokorin,RUS,"FW,MF",Fiorentina,30,1991,0.6,1,1,1,0,0,0,0,,0,1,0,1,0,1,0,0,Serie_A,2021_2022
Aleksandar Kolarov,SRB,DF,Inter,35,1985,0.5,1,1,1,0,0,1,1,100.0,0,0,0,0,1,2,2,0,Serie_A,2021_2022
Teun Koopmeiners,NED,MF,Atalanta,23,1998,23.6,40,24,10,19,11,22,54,40.7,32,31,2,29,15,55,19,0,Serie_A,2021_2022
Kalidou Koulibaly,SEN,DF,Napoli,30,1991,26.7,39,23,31,6,2,25,38,65.8,13,41,25,16,29,68,90,1,Serie_A,2021_2022
Christos Kourfalidis,GRE,"MF,FW",Cagliari,18,2002,0.2,0,0,0,0,0,0,1,0.0,1,1,0,1,0,0,0,0,Serie_A,2021_2022
Viktor Kovalenko,UKR,MF,Spezia,25,1996,14.7,16,10,7,8,1,9,21,42.9,12,16,3,13,13,29,8,0,Serie_A,2021_2022
Julian Kristoffersen,NOR,FW,Salernitana,24,1997,0.1,0,0,0,0,0,0,0,,0,0,0,0,0,0,0,0,Serie_A,2021_2022
Rade Krunić,BIH,"MF,FW",Milan,27,1993,15.7,33,18,16,14,3,15,31,48.4,16,19,2,17,16,49,17,0,Serie_A,2021_2022
Dejan Kulusevski,SWE,"FW,MF",Juventus,21,2000,8.6,15,12,9,6,0,8,21,38.1,13,14,0,14,5,20,5,0,Serie_A,2021_2022
Marash Kumbulla,ALB,DF,Roma,21,2000,11.4,21,13,13,7,1,8,15,53.3,7,17,8,9,16,37,26,0,Serie_A,2021_2022
Giorgos Kyriakopoulos,GRE,"DF,FW",Sassuolo,25,1996,21.9,30,14,19,7,4,19,38,50.0,19,32,9,23,11,41,52,0,Serie_A,2021_2022
Andrea La Mantia,ITA,"FW,MF",Empoli,30,1991,5.4,2,0,0,0,2,1,2,50.0,1,3,1,2,1,3,6,0,Serie_A,2021_2022
Sam Lammers,NED,"FW,MF",Atalanta,24,1997,0.4,1,0,0,0,1,0,0,,0,0,0,0,0,1,0,0,Serie_A,2021_2022
Kevin Lasagna,ITA,"MF,FW",Hellas Verona,28,1992,13.2,13,7,4,5,4,4,15,26.7,11,16,0,16,3,16,7,0,Serie_A,2021_2022
Darko Lazović,SRB,DF,Hellas Verona,30,1990,30.7,36,23,20,8,8,21,39,53.8,18,28,4,24,19,55,49,1,Serie_A,2021_2022
Manuel Lazzari,ITA,DF,Lazio,27,1993,18.5,28,14,13,15,0,16,26,61.5,10,10,2,8,12,40,16,1,Serie_A,2021_2022
Patrick Leal,USA,FW,Venezia,18,2003,0.0,0,0,0,0,0,0,1,0.0,1,0,0,0,0,0,0,0,Serie_A,2021_2022
Rafael Leão,POR,FW,Milan,22,1999,28.9,17,7,3,9,5,10,20,50.0,10,12,1,11,12,29,8,0,Serie_A,2021_2022
Lucas Leiva,BRA,MF,Lazio,34,1987,18.9,55,30,26,25,4,15,53,28.3,38,27,10,17,28,83,37,0,Serie_A,2021_2022
Luca Lezzerini,ITA,GK,Venezia,26,1995,5.5,0,0,0,0,0,0,0,,0,1,0,1,0,0,0,0,Serie_A,2021_2022
Ben Lhassine Kone,CIV,MF,Torino,21,2000,0.9,3,3,1,2,0,1,2,50.0,1,0,0,0,1,4,1,0,Serie_A,2021_2022
Matthijs de Ligt,NED,DF,Juventus,21,1999,29.7,34,19,21,13,0,15,18,83.3,3,31,21,10,26,60,103,0,Serie_A,2021_2022
Anderson Lima,BRA,MF,Lazio,21,1999,0.7,2,0,1,1,0,0,2,0.0,2,1,0,1,2,4,1,0,Serie_A,2021_2022
Karol Linetty,POL,"MF,FW",Torino,26,1995,10.0,14,8,3,4,7,6,18,33.3,12,8,0,8,3,17,2,0,Serie_A,2021_2022
Stanislav Lobotka,SVK,MF,Napoli,26,1994,18.7,39,24,16,20,3,14,36,38.9,22,9,1,8,12,51,13,1,Serie_A,2021_2022
Manuel Locatelli,ITA,MF,Juventus,23,1998,24.0,44,25,21,16,7,21,47,44.7,26,43,21,22,22,66,33,0,Serie_A,2021_2022
Maxime Lopez,FRA,MF,Sassuolo,23,1997,32.6,69,36,40,27,2,35,87,40.2,52,33,7,26,42,111,38,1,Serie_A,2021_2022
Matteo Lovato,ITA,DF,Atalanta,21,2000,3.4,5,4,4,1,0,0,1,0.0,1,4,2,2,7,12,8,0,Serie_A,2021_2022
Matteo Lovato,ITA,DF,Cagliari,21,2000,13.8,23,15,13,10,0,8,20,40.0,12,21,10,11,28,51,43,0,Serie_A,2021_2022
Hirving Lozano,MEX,FW,Napoli,26,1995,17.9,28,20,12,11,5,8,30,26.7,22,24,0,24,9,37,9,0,Serie_A,2021_2022
José Luis Palomino,ARG,DF,Atalanta,31,1990,29.7,78,40,42,33,3,32,50,64.0,18,43,21,22,100,178,80,2,Serie_A,2021_2022
Saša Lukić,SRB,MF,Torino,24,1996,33.1,51,34,17,27,7,19,43,44.2,24,34,6,28,24,75,41,0,Serie_A,2021_2022
Sebastiano Luperto,ITA,DF,Empoli,24,1996,21.8,29,17,17,10,2,10,20,50.0,10,32,26,6,45,74,132,0,Serie_A,2021_2022
Charalambos Lykogiannis,GRE,"DF,FW",Cagliari,27,1993,20.2,19,12,16,1,2,11,20,55.0,9,18,8,10,31,50,73,0,Serie_A,2021_2022
Niki Mäenpää,FIN,GK,Venezia,36,1985,16.5,0,0,0,0,0,0,0,,0,0,0,0,0,0,8,2,Serie_A,2021_2022
Giulio Maggiore,ITA,MF,Spezia,23,1998,31.3,58,32,20,32,6,31,77,40.3,46,30,5,25,29,87,33,0,Serie_A,2021_2022
Francesco Magnanelli,ITA,MF,Sassuolo,36,1984,3.0,5,4,4,1,0,1,9,11.1,8,3,1,2,1,6,3,0,Serie_A,2021_2022
Giangiacomo Magnani,ITA,DF,Hellas Verona,25,1995,5.9,10,7,5,5,0,8,16,50.0,8,5,3,2,10,20,46,0,Serie_A,2021_2022
Giangiacomo Magnani,ITA,DF,Sampdoria,25,1995,2.7,4,2,4,0,0,1,1,100.0,0,2,2,0,7,11,12,0,Serie_A,2021_2022
Mike Maignan,FRA,GK,Milan,26,1995,32.0,2,1,2,0,0,2,2,100.0,0,0,0,0,1,3,4,2,Serie_A,2021_2022
Ainsley Maitland-Niles,ENG,DF,Roma,23,1997,5.4,8,6,5,0,3,5,14,35.7,9,7,0,7,6,14,7,0,Serie_A,2021_2022
Jean-Victor Makengo,FRA,MF,Udinese,23,1998,26.1,30,21,7,17,6,15,29,51.7,14,26,6,20,19,49,17,0,Serie_A,2021_2022
Nikola Maksimović,SRB,DF,Genoa,29,1991,12.4,14,6,10,4,0,7,9,77.8,2,17,11,6,12,26,61,1,Serie_A,2021_2022
Kévin Malcuit,MAR,"DF,MF",Napoli,30,1991,3.2,4,2,4,0,0,2,2,100.0,0,3,0,3,8,12,6,0,Serie_A,2021_2022
Daniel Maldini,ITA,MF,Milan,19,2001,1.6,8,3,4,3,1,2,6,33.3,4,4,0,4,1,9,0,0,Serie_A,2021_2022
Youssef Maleh,MAR,MF,Fiorentina,22,1998,11.3,27,16,8,13,6,12,25,48.0,13,14,1,13,6,33,2,0,Serie_A,2021_2022
Ruslan Malinovskyi,UKR,"MF,FW",Atalanta,28,1993,17.7,18,10,3,10,5,5,19,26.3,14,27,3,24,5,23,1,0,Serie_A,2021_2022
Rey Manaj,ALB,FW,Spezia,24,1997,19.6,19,12,3,11,5,6,26,23.1,20,16,0,16,4,23,13,0,Serie_A,2021_2022
Gianluca Mancini,ITA,DF,Roma,25,1996,32.0,41,25,22,18,1,18,33,54.5,15,38,19,19,39,80,69,0,Serie_A,2021_2022
Leonardo Mancuso,ITA,FW,Empoli,29,1992,4.7,1,1,0,1,0,0,6,0.0,6,2,0,2,1,2,2,0,Serie_A,2021_2022
Rolando Mandragora,ITA,MF,Torino,24,1997,14.7,21,10,3,16,2,12,21,57.1,9,18,4,14,10,31,13,0,Serie_A,2021_2022
Kostas Manolas,GRE,DF,Napoli,30,1991,3.5,2,2,1,1,0,2,3,66.7,1,2,1,1,4,6,10,1,Serie_A,2021_2022
Riccardo Marchizza,ITA,DF,Empoli,23,1998,15.0,21,15,11,8,2,11,16,68.8,5,15,6,9,10,31,24,0,Serie_A,2021_2022
Gian Marco Ferrari,ITA,DF,Sassuolo,29,1992,34.7,16,11,10,6,0,10,23,43.5,13,37,27,10,43,59,114,2,Serie_A,2021_2022
Davide Marfella,ITA,GK,Napoli,21,1999,0.1,0,0,0,0,0,0,0,,0,0,0,0,0,0,0,0,Serie_A,2021_2022
Pablo Marí,ESP,DF,Udinese,27,1993,14.9,16,8,8,6,2,8,16,50.0,8,18,12,6,21,37,72,0,Serie_A,2021_2022
Răzvan Marin,ROU,MF,Cagliari,25,1996,31.3,42,21,16,22,4,24,54,44.4,30,23,5,18,10,52,17,1,Serie_A,2021_2022
Lautaro Martínez,ARG,FW,Inter,23,1997,25.4,20,10,3,10,7,6,11,54.5,5,21,1,20,18,38,6,0,Serie_A,2021_2022
Lucas Martínez Quarta,ARG,DF,Fiorentina,25,1996,15.9,36,25,23,11,2,21,34,61.8,13,22,9,13,19,55,46,0,Serie_A,2021_2022
Adam Marušić,MNE,DF,Lazio,28,1992,30.2,30,18,16,12,2,13,32,40.6,19,19,8,11,41,71,71,0,Serie_A,2021_2022
Andrea Masiello,ITA,DF,Genoa,35,1986,5.7,5,3,4,1,0,4,7,57.1,3,8,4,4,11,16,20,1,Serie_A,2021_2022
Aleš Matějů,CZE,DF,Venezia,25,1996,8.1,16,12,10,5,1,13,29,44.8,16,10,6,4,9,25,15,0,Serie_A,2021_2022
Borja Mayoral,ESP,"FW,DF",Roma,24,1997,1.1,0,0,0,0,0,0,0,,0,0,0,0,0,0,0,0,Serie_A,2021_2022
Pasquale Mazzocchi,ITA,DF,Venezia,26,1995,13.8,18,8,11,4,3,10,26,38.5,16,11,8,3,21,39,31,1,Serie_A,2021_2022
Pasquale Mazzocchi,ITA,DF,Salernitana,26,1995,14.1,28,19,15,11,2,14,34,41.2,20,5,0,5,11,39,31,0,Serie_A,2021_2022
Ibrahima Mbaye,SEN,DF,Bologna,26,1994,1.2,1,1,1,0,0,1,2,50.0,1,1,1,0,1,2,6,0,Serie_A,2021_2022
Weston McKennie,USA,MF,Juventus,22,1998,15.2,20,11,11,7,2,8,26,30.8,18,17,8,9,23,43,20,0,Serie_A,2021_2022
Gary Medel,CHI,DF,Bologna,33,1987,31.4,39,23,27,11,1,16,36,44.4,20,30,21,9,44,83,112,0,Serie_A,2021_2022
Filippo Melegoni,ITA,"MF,FW",Genoa,22,1999,10.9,20,12,5,8,7,8,16,50.0,8,10,1,9,11,31,8,1,Serie_A,2021_2022
Arthur Melo,BRA,MF,Juventus,24,1996,10.7,25,12,10,14,1,13,24,54.2,11,11,2,9,7,32,8,1,Serie_A,2021_2022
Alex Meret,ITA,GK,Napoli,24,1997,6.9,0,0,0,0,0,0,0,,0,0,0,0,0,0,3,1,Serie_A,2021_2022
Yıldırım Mert Çetin,TUR,MF,Hellas Verona,24,1997,0.5,1,0,1,0,0,1,1,100.0,0,0,0,0,0,1,2,0,Serie_A,2021_2022
Dries Mertens,BEL,"FW,MF",Napoli,34,1987,15.4,16,7,1,11,4,3,16,18.8,13,8,2,6,9,25,2,0,Serie_A,2021_2022
Junior Messias,BRA,"FW,MF",Milan,30,1991,15.9,34,18,11,14,9,15,34,44.1,19,11,1,10,17,51,17,0,Serie_A,2021_2022
Kingsley Michael,NGA,MF,Bologna,21,1999,0.8,4,1,2,2,0,1,2,50.0,1,2,1,1,1,5,1,1,Serie_A,2021_2022
Valentin Mihaila,ROU,"MF,FW",Atalanta,21,2000,0.8,1,1,0,1,0,0,1,0.0,1,2,0,2,0,1,0,0,Serie_A,2021_2022
Mikael,BRA,"FW,MF",Salernitana,22,1999,1.0,1,1,0,1,0,0,0,,0,0,0,0,0,1,1,0,Serie_A,2021_2022
Hilmir Mikaelsson,ISL,FW,Venezia,17,2004,0.2,2,0,0,1,1,0,0,,0,0,0,0,0,2,0,0,Serie_A,2021_2022
Nikola Milenković,SRB,DF,Fiorentina,23,1997,32.5,54,32,31,20,3,29,34,85.3,5,30,15,15,39,93,94,0,Serie_A,2021_2022
Sergej Milinković-Savić,SRB,MF,Lazio,26,1995,34.4,67,44,20,32,15,29,67,43.3,38,50,9,41,34,101,43,1,Serie_A,2021_2022
Vanja Milinković-Savić,SRB,GK,Torino,24,1997,27.0,0,0,0,0,0,0,1,0.0,1,0,0,0,0,0,7,2,Serie_A,2021_2022
Aleksei Miranchuk,RUS,"MF,FW",Atalanta,25,1995,8.6,11,7,3,7,1,4,12,33.3,8,3,0,3,1,12,7,0,Serie_A,2021_2022
Fabio Miretti,ITA,MF,Juventus,17,2003,3.6,4,2,2,2,0,2,9,22.2,7,3,1,2,2,6,3,0,Serie_A,2021_2022
Henrikh Mkhitaryan,ARM,"MF,FW",Roma,32,1989,27.7,45,29,11,27,7,17,52,32.7,35,33,2,31,22,67,33,0,Serie_A,2021_2022
Marco Modolo,ITA,DF,Venezia,32,1989,4.4,6,3,4,2,0,2,5,40.0,3,6,6,0,4,10,26,0,Serie_A,2021_2022
Nahuel Molina,ARG,DF,Udinese,23,1998,29.3,41,24,17,21,3,16,48,33.3,32,24,3,21,22,63,44,2,Serie_A,2021_2022
Cristian Molinaro,ITA,DF,Venezia,38,1983,6.1,12,9,10,2,0,5,7,71.4,2,7,2,5,6,18,20,0,Serie_A,2021_2022
Lorenzo Montipò,ITA,GK,Hellas Verona,25,1996,34.0,0,0,0,0,0,0,0,,0,0,0,0,1,1,16,3,Serie_A,2021_2022
Álvaro Morata,ESP,FW,Juventus,28,1992,25.6,18,9,4,9,5,8,31,25.8,23,26,1,25,5,23,24,0,Serie_A,2021_2022
Raúl Moro,ESP,FW,Lazio,18,2002,2.2,3,3,0,2,1,1,5,20.0,4,2,0,2,0,3,0,0,Serie_A,2021_2022
Andrei Motoc,MDA,DF,Salernitana,19,2002,1.0,1,1,0,1,0,0,0,,0,2,2,0,2,3,1,0,Serie_A,2021_2022
Lys Mousset,FRA,"MF,FW",Salernitana,25,1996,1.8,1,0,0,1,0,0,0,,0,2,0,2,0,1,0,0,Serie_A,2021_2022
Samuel Mráz,SVK,FW,Spezia,24,1997,0.6,0,0,0,0,0,0,0,,0,1,0,1,0,0,0,0,Serie_A,2021_2022
Mert Müldür,TUR,DF,Sassuolo,22,1999,22.7,52,35,43,7,2,27,49,55.1,22,25,6,19,24,76,44,1,Serie_A,2021_2022
Luis Muriel,COL,"FW,MF",Atalanta,30,1991,17.1,15,4,2,7,6,3,19,15.8,16,12,0,12,4,19,5,0,Serie_A,2021_2022
Vedat Muriqi,KVX,FW,Lazio,27,1994,2.4,1,0,1,0,0,0,5,0.0,5,0,0,0,0,1,2,0,Serie_A,2021_2022
Nicola Murru,ITA,DF,Sampdoria,26,1994,10.9,22,17,10,11,1,8,13,61.5,5,17,3,14,7,29,20,1,Serie_A,2021_2022
Juan Musso,ARG,GK,Atalanta,27,1994,32.6,1,1,1,0,0,0,0,,0,0,0,0,0,1,17,1,Serie_A,2021_2022
Joakim Mæhle,DEN,"DF,MF",Atalanta,24,1997,16.3,21,11,6,9,6,12,27,44.4,15,18,2,16,14,35,13,0,Serie_A,2021_2022
Nahitan Nández,URU,"MF,DF",Cagliari,25,1995,16.9,39,21,16,15,8,18,33,54.5,15,16,1,15,9,48,15,1,Serie_A,2021_2022
Nani,POR,"MF,FW",Venezia,34,1986,3.2,2,1,1,1,0,0,1,0.0,1,1,0,1,2,4,0,1,Serie_A,2021_2022
Matija Nastasić,SRB,DF,Fiorentina,28,1993,2.4,1,1,1,0,0,1,1,100.0,0,1,1,0,5,6,11,0,Serie_A,2021_2022
Ilija Nestorovski,MKD,FW,Udinese,31,1990,2.1,0,0,0,0,0,0,3,0.0,3,0,0,0,0,0,4,0,Serie_A,2021_2022
Aurélien Nguiamba,FRA,MF,Spezia,22,1999,0.6,3,2,1,2,0,2,3,66.7,1,2,1,1,0,3,1,0,Serie_A,2021_2022
Dimitris Nikolaou,GRE,DF,Spezia,22,1998,36.0,39,26,29,7,3,22,34,64.7,12,48,24,24,49,88,132,1,Serie_A,2021_2022
Jean-Pierre Nsame,CMR,FW,Venezia,28,1993,2.7,1,1,0,0,1,0,0,,0,0,0,0,0,1,1,0,Serie_A,2021_2022
Bram Nuytinck,NED,DF,Udinese,31,1990,22.6,38,24,24,13,1,15,34,44.1,19,42,31,11,22,60,101,0,Serie_A,2021_2022
Simeon Nwankwo,NGA,FW,Salernitana,29,1992,9.4,5,5,0,4,1,4,10,40.0,6,8,3,5,3,8,10,0,Serie_A,2021_2022
M'Bala Nzola,ANG,FW,Spezia,24,1996,11.9,2,2,0,0,2,1,6,16.7,5,8,0,8,0,2,13,0,Serie_A,2021_2022
Adam Obert,SVK,"DF,MF",Cagliari,18,2002,3.0,8,5,6,2,0,5,6,83.3,1,6,4,2,4,12,11,0,Serie_A,2021_2022
Joel Obi,NGA,"MF,DF",Salernitana,30,1991,12.7,23,14,5,14,4,5,12,41.7,7,17,6,11,10,33,7,0,Serie_A,2021_2022
Brian Oddei,ITA,FW,Sassuolo,18,2002,0.1,0,0,0,0,0,0,0,,0,0,0,0,0,0,0,0,Serie_A,2021_2022
Álvaro Odriozola,ESP,DF,Fiorentina,25,1995,19.3,25,15,12,6,7,15,32,46.9,17,17,6,11,8,33,25,2,Serie_A,2021_2022
Stefano Okaka,ITA,FW,Udinese,31,1989,0.2,0,0,0,0,0,0,0,,0,2,0,2,0,0,1,0,Serie_A,2021_2022
David Okereke,NGA,"FW,MF",Venezia,23,1997,22.8,16,10,4,9,3,3,20,15.0,17,19,3,16,10,26,20,0,Serie_A,2021_2022
Christian Oliva,URU,MF,Cagliari,25,1996,0.5,2,2,2,0,0,1,4,25.0,3,0,0,0,0,2,0,0,Serie_A,2021_2022
Sérgio Oliveira,POR,MF,Roma,29,1992,9.9,27,14,11,14,2,15,30,50.0,15,13,0,13,10,37,7,0,Serie_A,2021_2022
Riccardo Orsolini,ITA,"FW,MF",Bologna,24,1997,19.8,21,13,9,11,1,13,29,44.8,16,9,4,5,5,26,14,0,Serie_A,2021_2022
Victor Osimhen,NGA,FW,Napoli,22,1998,22.0,10,5,1,2,7,2,6,33.3,4,16,3,13,3,13,17,0,Serie_A,2021_2022
David Ospina,COL,GK,Napoli,32,1988,31.0,0,0,0,0,0,0,0,,0,0,0,0,1,1,11,1,Serie_A,2021_2022
Adam Ounas,ALG,"MF,FW",Napoli,24,1996,3.6,6,1,0,3,3,3,7,42.9,4,3,0,3,2,8,3,0,Serie_A,2021_2022
Daniele Padelli,ITA,GK,Udinese,35,1985,3.0,0,0,0,0,0,0,0,,0,0,0,0,0,0,2,1,Serie_A,2021_2022
Simone Pafundi,ITA,FW,Udinese,15,2006,0.3,0,0,0,0,0,0,1,0.0,1,0,0,0,0,0,0,0,Serie_A,2021_2022
Martin Palumbo,NOR,FW,Juventus,19,2002,0.1,0,0,0,0,0,0,1,0.0,1,0,0,0,0,0,0,0,Serie_A,2021_2022
Goran Pandev,MKD,"FW,MF",Genoa,38,1983,9.4,2,0,1,0,1,0,9,0.0,9,3,1,2,2,4,0,0,Serie_A,2021_2022
Ivor Pandur,CRO,GK,Hellas Verona,21,2000,3.0,0,0,0,0,0,0,0,,0,0,0,0,0,0,2,0,Serie_A,2021_2022
Fabiano Parisi,ITA,DF,Empoli,20,2000,16.4,35,19,25,5,5,13,31,41.9,18,30,10,20,22,57,42,0,Serie_A,2021_2022
Mario Pašalić,CRO,"MF,FW",Atalanta,26,1995,22.2,27,12,8,13,6,12,30,40.0,18,27,6,21,20,47,14,0,Serie_A,2021_2022
Patric,ESP,DF,Lazio,28,1993,18.3,21,15,17,4,0,9,20,45.0,11,22,11,11,12,33,44,2,Serie_A,2021_2022
Rui Patrício,POR,GK,Roma,33,1988,38.0,0,0,0,0,0,0,0,,0,1,0,1,0,0,10,3,Serie_A,2021_2022
Leonardo Pavoletti,ITA,FW,Cagliari,32,1988,16.9,10,6,2,5,3,3,9,33.3,6,9,5,4,2,12,12,0,Serie_A,2021_2022
Pedro,ESP,FW,Lazio,34,1987,22.6,36,23,8,19,9,16,47,34.0,31,18,2,16,6,42,8,0,Serie_A,2021_2022
João Pedro,ITA,FW,Cagliari,29,1992,36.9,15,12,2,8,5,4,18,22.2,14,23,5,18,8,23,18,1,Serie_A,2021_2022
Gianluca Pegolo,ITA,GK,Sassuolo,40,1981,1.0,0,0,0,0,0,0,0,,0,0,0,0,0,0,0,1,Serie_A,2021_2022
Pietro Pellegri,ITA,FW,Torino,20,2001,2.4,1,1,0,1,0,0,4,0.0,4,0,0,0,0,1,5,0,Serie_A,2021_2022
Pietro Pellegri,ITA,FW,Milan,20,2001,1.5,2,2,0,1,1,0,1,0.0,1,0,0,0,0,2,1,0,Serie_A,2021_2022
Lorenzo Pellegrini,ITA,MF,Roma,25,1996,25.4,35,14,10,17,8,16,60,26.7,44,29,1,28,27,62,20,0,Serie_A,2021_2022
Luca Pellegrini,ITA,DF,Juventus,22,1999,12.3,23,10,13,5,5,12,19,63.2,7,9,1,8,5,28,23,0,Serie_A,2021_2022
Federico Peluso,ITA,DF,Sassuolo,37,1984,0.1,1,1,0,1,0,1,1,100.0,0,0,0,0,0,1,0,0,Serie_A,2021_2022
Gastón Pereiro,URU,"FW,MF",Cagliari,26,1995,10.8,13,5,7,4,2,5,18,27.8,13,12,1,11,1,14,8,0,Serie_A,2021_2022
Dor Peretz,ISR,MF,Venezia,26,1995,6.5,27,18,8,16,3,13,25,52.0,12,8,4,4,8,35,11,0,Serie_A,2021_2022
Roberto Pereyra,ARG,"MF,FW",Udinese,30,1991,19.9,18,12,7,6,5,7,23,30.4,16,26,5,21,12,30,11,0,Serie_A,2021_2022
Carles Pérez,ESP,"MF,FW",Roma,23,1998,6.2,8,3,3,1,4,3,12,25.0,9,10,0,10,2,10,2,0,Serie_A,2021_2022
Nehuén Pérez,ARG,DF,Udinese,21,2000,18.8,44,21,21,21,2,16,25,64.0,9,27,9,18,21,65,47,0,Serie_A,2021_2022
Mattia Perin,ITA,GK,Juventus,28,1992,4.5,0,0,0,0,0,0,0,,0,0,0,0,0,0,3,0,Serie_A,2021_2022
Ivan Perišić,CRO,DF,Inter,32,1989,31.3,38,22,18,11,9,28,50,56.0,22,39,7,32,47,85,42,0,Serie_A,2021_2022
Diego Perotti,ARG,"MF,FW",Salernitana,33,1988,3.2,11,5,7,1,3,4,13,30.8,9,1,0,1,2,13,6,0,Serie_A,2021_2022
Mario Perrone,ITA,DF,Salernitana,18,2003,0.2,0,0,0,0,0,0,0,,0,0,0,0,0,0,0,0,Serie_A,2021_2022
Matteo Pessina,ITA,"MF,FW",Atalanta,24,1997,16.0,27,14,10,11,6,14,33,42.4,19,22,3,19,13,40,7,0,Serie_A,2021_2022
Andrea Petagna,ITA,FW,Napoli,26,1995,6.5,3,3,0,3,0,1,4,25.0,3,1,0,1,0,3,5,0,Serie_A,2021_2022
Giuseppe Pezzella,ITA,"DF,MF",Atalanta,23,1997,11.9,28,13,15,7,6,8,18,44.4,10,13,5,8,9,37,16,0,Serie_A,2021_2022
Krzysztof Piątek,POL,FW,Fiorentina,26,1995,8.1,5,4,1,1,3,2,3,66.7,1,6,0,6,2,7,8,0,Serie_A,2021_2022
Roberto Piccoli,ITA,FW,Genoa,20,2001,2.4,1,1,0,1,0,0,0,,0,0,0,0,1,2,1,1,Serie_A,2021_2022
Roberto Piccoli,ITA,FW,Atalanta,20,2001,2.2,2,0,0,0,2,0,2,0.0,2,1,0,1,0,2,0,0,Serie_A,2021_2022
Andrea Pinamonti,ITA,FW,Empoli,22,1999,31.9,11,6,0,7,4,2,18,11.1,16,24,3,21,7,18,23,0,Serie_A,2021_2022
Carlo Pinsoglio,ITA,GK,Juventus,31,1990,0.5,0,0,0,0,0,0,0,,0,0,0,0,0,0,0,0,Serie_A,2021_2022
Riccardo Pinzi,ITA,FW,Udinese,17,2003,0.0,0,0,0,0,0,0,0,,0,0,0,0,0,0,0,0,Serie_A,2021_2022
Marko Pjaca,CRO,MF,Torino,26,1995,12.8,7,4,1,4,2,3,8,37.5,5,10,2,8,4,11,2,0,Serie_A,2021_2022
Tommaso Pobega,ITA,MF,Torino,22,1999,24.9,48,30,17,20,11,21,40,52.5,19,32,3,29,25,73,38,0,Serie_A,2021_2022
Suf Podgoreanu,ISR,FW,Spezia,19,2002,1.3,2,0,1,1,0,1,4,25.0,3,2,0,2,1,3,3,0,Serie_A,2021_2022
Matteo Politano,ITA,FW,Napoli,27,1993,18.3,24,12,8,11,5,15,54,27.8,39,11,2,9,13,37,5,0,Serie_A,2021_2022
Manolo Portanova,ITA,"FW,MF",Genoa,21,2000,14.7,46,28,9,26,11,14,34,41.2,20,26,2,24,17,63,22,0,Serie_A,2021_2022
Dennis Praet,BEL,MF,Torino,27,1994,17.1,19,10,6,8,5,8,22,36.4,14,12,1,11,3,22,4,0,Serie_A,2021_2022
Mateusz Praszelik,POL,MF,Hellas Verona,20,2000,0.3,0,0,0,0,0,0,0,,0,0,0,0,0,0,0,0,Serie_A,2021_2022
Ivan Provedel,ITA,GK,Spezia,27,1994,30.7,0,0,0,0,0,0,1,0.0,1,0,0,0,2,2,10,2,Serie_A,2021_2022
Erick Pulgar,CHI,MF,Fiorentina,27,1994,3.8,6,6,4,2,0,4,9,44.4,5,5,1,4,5,11,2,1,Serie_A,2021_2022
Ignacio Pussetto,ARG,"FW,MF",Udinese,25,1995,13.4,17,9,2,9,6,2,10,20.0,8,18,2,16,4,21,13,0,Serie_A,2021_2022
Niklas Pyyhtiä,FIN,MF,Bologna,17,2003,0.2,0,0,0,0,0,0,1,0.0,1,0,0,0,0,0,0,0,Serie_A,2021_2022
Fabio Quagliarella,ITA,FW,Sampdoria,38,1983,18.5,6,2,2,2,2,2,15,13.3,13,14,1,13,3,9,12,0,Serie_A,2021_2022
Adrien Rabiot,FRA,MF,Juventus,26,1995,25.4,64,43,32,24,8,15,34,44.1,19,34,8,26,20,84,41,1,Serie_A,2021_2022
Ivan Radovanović,SRB,"DF,MF",Salernitana,32,1988,11.7,11,7,8,3,0,7,19,36.8,12,14,7,7,7,18,29,0,Serie_A,2021_2022
Ionuț Radu,ROU,GK,Inter,24,1997,1.0,0,0,0,0,0,0,0,,0,0,0,0,0,0,0,1,Serie_A,2021_2022
Ștefan Radu,ROU,DF,Lazio,34,1986,6.2,9,6,3,6,0,5,9,55.6,4,7,2,5,5,14,15,0,Serie_A,2021_2022
Boris Radunović,SRB,GK,Cagliari,25,1996,3.0,0,0,0,0,0,0,0,,0,0,0,0,0,0,0,0,Serie_A,2021_2022
Antonio Raimondo,ITA,FW,Bologna,17,2004,0.8,0,0,0,0,0,0,1,0.0,1,1,0,1,0,0,1,0,Serie_A,2021_2022
Aaron Ramsey,WAL,MF,Juventus,30,1990,1.1,0,0,0,0,0,0,0,,0,0,0,0,1,1,0,0,Serie_A,2021_2022
Luca Ranieri,ITA,DF,Salernitana,22,1999,23.4,38,21,23,11,4,19,33,57.6,14,18,8,10,22,60,67,0,Serie_A,2021_2022
Andrea Ranocchia,ITA,DF,Inter,33,1988,3.8,8,4,5,1,2,1,3,33.3,2,4,3,1,4,12,16,0,Serie_A,2021_2022
Giacomo Raspadori,ITA,"MF,FW",Sassuolo,21,2000,30.4,29,18,5,15,9,11,38,28.9,27,29,3,26,9,38,11,0,Serie_A,2021_2022
Nicola Ravaglia,ITA,GK,Sampdoria,32,1988,0.1,0,0,0,0,0,0,0,,0,0,0,0,0,0,0,0,Serie_A,2021_2022
Ante Rebić,CRO,FW,Milan,27,1993,9.9,14,8,3,6,5,7,20,35.0,13,14,0,14,3,17,3,1,Serie_A,2021_2022
Arkadiusz Reca,POL,DF,Spezia,26,1995,19.7,31,19,21,3,7,20,30,66.7,10,20,7,13,32,63,47,2,Serie_A,2021_2022
Pepe Reina,ESP,GK,Lazio,38,1982,15.0,0,0,0,0,0,0,1,0.0,1,0,0,0,0,0,1,1,Serie_A,2021_2022
Panagiotis Retsos,GRE,DF,Hellas Verona,22,1998,0.6,0,0,0,0,0,0,2,0.0,2,0,0,0,2,2,3,0,Serie_A,2021_2022
Bryan Reynolds,USA,DF,Roma,20,2001,0.0,0,0,0,0,0,0,1,0.0,1,0,0,0,0,0,1,0,Serie_A,2021_2022
Franck Ribéry,FRA,"MF,FW",Salernitana,38,1983,15.8,17,10,6,6,5,8,13,61.5,5,12,0,12,3,20,1,0,Serie_A,2021_2022
Samuele Ricci,ITA,MF,Torino,19,2001,8.0,8,4,4,2,2,2,5,40.0,3,7,1,6,14,22,9,0,Serie_A,2021_2022
Samuele Ricci,ITA,MF,Empoli,19,2001,17.0,33,19,17,13,3,20,34,58.8,14,24,5,19,31,64,18,0,Serie_A,2021_2022
Tomás Rincón,VEN,MF,Torino,33,1988,1.8,2,2,2,0,0,0,3,0.0,3,3,1,2,2,4,4,0,Serie_A,2021_2022
Tomás Rincón,VEN,MF,Sampdoria,33,1988,13.0,22,13,9,10,3,13,34,38.2,21,15,2,13,18,40,11,0,Serie_A,2021_2022
Ricardo Rodríguez,SUI,DF,Torino,28,1992,27.5,36,21,11,23,2,18,33,54.5,15,22,8,14,41,77,48,1,Serie_A,2021_2022
Marko Rog,CRO,MF,Cagliari,26,1995,3.5,5,3,1,2,2,1,8,12.5,7,6,1,5,1,6,3,0,Serie_A,2021_2022
Rogério,BRA,DF,Sassuolo,23,1998,19.2,21,13,12,5,4,15,22,68.2,7,20,8,12,18,39,42,1,Serie_A,2021_2022
Alessio Romagnoli,ITA,DF,Milan,26,1995,15.7,24,14,14,10,0,14,18,77.8,4,21,12,9,19,43,45,0,Serie_A,2021_2022
Simone Romagnoli,ITA,DF,Empoli,31,1990,16.6,28,12,14,12,2,15,20,75.0,5,34,28,6,9,37,86,0,Serie_A,2021_2022
Luka Romero,ARG,FW,Lazio,16,2004,0.9,2,1,0,1,1,0,2,0.0,2,0,0,0,1,3,0,0,Serie_A,2021_2022
Sergio Romero,ARG,GK,Venezia,34,1987,16.0,2,2,2,0,0,2,2,100.0,0,0,0,0,1,3,10,0,Serie_A,2021_2022
Cristiano Ronaldo,POR,FW,Juventus,36,1985,0.3,1,0,0,1,0,1,1,100.0,0,0,0,0,0,1,0,0,Serie_A,2021_2022
Marten de Roon,NED,"MF,DF",Atalanta,30,1991,28.3,69,42,33,29,7,34,62,54.8,28,36,2,34,45,114,41,0,Serie_A,2021_2022
Francesco Rossi,ITA,GK,Atalanta,30,1991,0.4,0,0,0,0,0,0,0,,0,0,0,0,0,0,0,0,Serie_A,2021_2022
Nicolò Rovella,ITA,MF,Genoa,19,2001,16.3,37,26,16,14,7,15,40,37.5,25,21,1,20,20,57,20,0,Serie_A,2021_2022
Amir Rrahmani,KVX,DF,Napoli,27,1994,32.5,21,11,15,5,1,15,19,78.9,4,36,25,11,19,40,89,0,Serie_A,2021_2022
Ruan,BRA,DF,Sassuolo,22,1999,2.4,7,4,7,0,0,3,4,75.0,1,6,5,1,2,9,24,1,Serie_A,2021_2022
Daniele Rugani,ITA,DF,Juventus,27,1994,9.8,8,5,4,4,0,4,7,57.1,3,9,4,5,11,19,47,0,Serie_A,2021_2022
Matteo Ruggeri,ITA,DF,Salernitana,19,2002,7.5,8,4,5,2,1,7,10,70.0,3,6,1,5,2,10,25,0,Serie_A,2021_2022
Mário Rui,POR,DF,Napoli,30,1991,33.2,68,43,32,28,8,39,84,46.4,45,31,7,24,40,108,50,0,Serie_A,2021_2022
Fabián Ruiz Peña,ESP,MF,Napoli,25,1996,26.5,55,33,22,29,4,29,67,43.3,38,34,1,33,22,77,32,0,Serie_A,2021_2022
Alessandro Russo,ITA,MF,Salernitana,17,2003,0.3,1,0,1,0,0,0,1,0.0,1,0,0,0,0,1,1,0,Serie_A,2021_2022
Stefano Sabelli,ITA,DF,Genoa,28,1993,3.9,6,3,3,2,1,3,9,33.3,6,5,1,4,3,9,12,0,Serie_A,2021_2022
Abdelhamid Sabiri,MAR,"MF,FW",Sampdoria,24,1996,9.9,34,18,10,15,9,7,25,28.0,18,10,2,8,7,41,3,0,Serie_A,2021_2022
Alexis Saelemaekers,BEL,FW,Milan,22,1999,20.7,43,22,12,17,14,15,51,29.4,36,19,0,19,15,58,8,0,Serie_A,2021_2022
Jacopo Sala,ITA,MF,Spezia,29,1991,9.8,22,11,10,10,2,13,30,43.3,17,6,0,6,14,36,11,0,Serie_A,2021_2022
Eddie Salcedo,ITA,"MF,FW",Spezia,19,2001,4.8,1,1,0,0,1,0,1,0.0,1,2,1,1,0,1,7,1,Serie_A,2021_2022
Lazar Samardzic,SRB,"MF,FW",Udinese,19,2002,5.4,13,9,4,7,2,7,26,26.9,19,6,0,6,2,15,2,0,Serie_A,2021_2022
Luigi Samele,ITA,FW,Sassuolo,19,2002,0.1,0,0,0,0,0,0,0,,0,0,0,0,0,0,1,0,Serie_A,2021_2022
Antonio Sanabria,PAR,FW,Torino,25,1996,20.0,3,2,0,1,2,1,4,25.0,3,11,4,7,2,5,10,0,Serie_A,2021_2022
Alexis Sánchez,CHI,FW,Inter,32,1988,9.8,9,8,0,6,3,2,11,18.2,9,4,0,4,2,11,3,0,Serie_A,2021_2022
Alex Sandro,BRA,DF,Juventus,30,1991,19.8,27,16,15,9,3,11,25,44.0,14,17,6,11,27,54,40,0,Serie_A,2021_2022
Nicola Sansone,ITA,"FW,MF",Bologna,29,1991,10.0,13,7,5,6,2,3,15,20.0,12,1,0,1,4,17,2,0,Serie_A,2021_2022
Federico Santander,PAR,"FW,DF",Bologna,30,1991,0.7,2,1,1,1,0,1,1,100.0,0,0,0,0,0,2,0,0,Serie_A,2021_2022
Samir Santos,BRA,DF,Udinese,26,1994,15.8,36,16,22,13,1,15,25,60.0,10,21,7,14,42,78,62,0,Serie_A,2021_2022
Riccardo Saponara,ITA,FW,Fiorentina,29,1991,14.3,10,2,1,6,3,6,16,37.5,10,5,0,5,1,11,3,0,Serie_A,2021_2022
Giacomo Satalino,ITA,GK,Sassuolo,22,1999,0.1,0,0,0,0,0,0,0,,0,0,0,0,0,0,0,0,Serie_A,2021_2022
Martin Satriano,URU,"FW,MF",Inter,20,2001,0.4,1,0,0,0,1,1,1,100.0,0,0,0,0,0,1,0,0,Serie_A,2021_2022
Giorgio Scalvini,ITA,"DF,MF",Atalanta,17,2003,8.5,22,11,13,8,1,9,19,47.4,10,12,1,11,22,44,16,0,Serie_A,2021_2022
Gianluca Scamacca,ITA,FW,Sassuolo,22,1999,23.8,19,14,2,5,12,5,21,23.8,16,16,1,15,5,24,22,1,Serie_A,2021_2022
Andrea Schiavone,ITA,MF,Salernitana,28,1993,6.3,14,8,5,9,0,10,23,43.5,13,13,3,10,8,22,12,0,Serie_A,2021_2022
David Schnegg,AUT,DF,Venezia,22,1998,1.6,2,0,1,1,0,1,3,33.3,2,4,0,4,3,5,6,0,Serie_A,2021_2022
Jerdy Schouten,NED,MF,Bologna,24,1997,15.5,25,17,10,12,3,9,22,40.9,13,22,5,17,33,58,29,1,Serie_A,2021_2022
Demba Seck,SEN,"MF,FW",Torino,20,2001,1.6,2,1,0,2,0,0,0,,0,0,0,0,0,2,0,0,Serie_A,2021_2022
Adrian Šemper,CRO,GK,Genoa,23,1998,1.0,0,0,0,0,0,0,0,,0,0,0,0,0,0,0,0,Serie_A,2021_2022
Stefano Sensi,ITA,"MF,FW",Sampdoria,25,1995,8.4,18,9,10,6,2,10,23,43.5,13,2,0,2,6,24,4,0,Serie_A,2021_2022
Stefano Sensi,ITA,"MF,FW",Inter,25,1995,1.9,4,3,1,3,0,2,4,50.0,2,2,0,2,0,4,2,0,Serie_A,2021_2022
Luigi Sepe,ITA,GK,Salernitana,30,1991,15.5,0,0,0,0,0,0,0,,0,0,0,0,1,1,3,0,Serie_A,2021_2022
Laurens Serpe,ITA,DF,Genoa,20,2001,0.5,1,0,1,0,0,1,2,50.0,1,0,0,0,0,1,1,0,Serie_A,2021_2022
Stephan El Shaarawy,ITA,"FW,DF",Roma,28,1992,11.7,13,8,4,9,0,4,6,66.7,2,10,2,8,11,24,8,0,Serie_A,2021_2022
Aimar Sher,SWE,MF,Spezia,18,2002,0.5,2,1,1,1,0,0,1,0.0,1,1,0,1,3,5,1,0,Serie_A,2021_2022
Eldor Shomurodov,UZB,"FW,MF",Roma,26,1995,8.7,5,4,0,4,1,1,10,10.0,9,8,0,8,2,7,5,0,Serie_A,2021_2022
Alassane Sidibe,CIV,MF,Atalanta,19,2002,0.1,1,1,1,0,0,0,0,,0,0,0,0,0,1,0,0,Serie_A,2021_2022
Arnór Sigurðsson,ISL,"FW,MF",Venezia,22,1999,2.0,1,1,0,1,0,1,2,50.0,1,2,0,2,1,2,0,0,Serie_A,2021_2022
Adrien Silva,POR,MF,Sampdoria,32,1989,12.0,24,12,14,5,5,9,33,27.3,24,15,5,10,23,47,23,0,Serie_A,2021_2022
Marco Silvestri,ITA,GK,Udinese,30,1991,35.0,0,0,0,0,0,0,1,0.0,1,0,0,0,1,1,11,1,Serie_A,2021_2022
Giovanni Simeone,ARG,FW,Hellas Verona,26,1995,29.5,27,15,6,12,9,9,39,23.1,30,37,3,34,6,33,23,0,Serie_A,2021_2022
Giovanni Simeone,ARG,FW,Cagliari,26,1995,0.1,0,0,0,0,0,0,0,,0,0,0,0,0,0,0,0,Serie_A,2021_2022
Wilfried Singo,CIV,DF,Torino,20,2000,29.0,55,35,24,24,7,24,34,70.6,10,26,6,20,23,78,47,0,Serie_A,2021_2022
Salvatore Sirigu,ITA,GK,Genoa,34,1987,37.0,1,1,1,0,0,1,2,50.0,1,0,0,0,0,1,19,2,Serie_A,2021_2022
Leo Skiri Østigård,NOR,DF,Genoa,21,1999,13.0,16,9,8,7,1,9,11,81.8,2,17,10,7,8,24,55,1,Serie_A,2021_2022
Łukasz Skorupski,POL,GK,Bologna,30,1991,36.0,0,0,0,0,0,0,1,0.0,1,0,0,0,0,0,17,0,Serie_A,2021_2022
Andreas Skov Olsen,DEN,"FW,DF",Bologna,21,1999,8.3,12,10,4,4,4,5,11,45.5,6,9,1,8,3,15,11,0,Serie_A,2021_2022
Milan Škriniar,SVK,DF,Inter,26,1995,35.0,47,27,26,17,4,24,42,57.1,18,36,25,11,25,72,90,1,Serie_A,2021_2022
Chris Smalling,ENG,DF,Roma,31,1989,23.2,36,23,28,8,0,18,25,72.0,7,32,24,8,26,62,92,1,Serie_A,2021_2022
Brandon Soppy,FRA,"DF,MF",Udinese,19,2002,8.6,20,9,8,10,2,11,16,68.8,5,10,2,8,5,25,9,1,Serie_A,2021_2022
Roberto Soriano,ITA,MF,Bologna,30,1991,29.1,57,30,27,22,8,17,56,30.4,39,37,3,34,22,79,32,0,Serie_A,2021_2022
Riccardo Sottil,ITA,FW,Fiorentina,22,1999,13.8,9,4,4,4,1,3,9,33.3,6,3,0,3,1,10,2,0,Serie_A,2021_2022
Matìas Soulé,ARG,FW,Juventus,18,2003,0.1,0,0,0,0,0,0,1,0.0,1,0,0,0,0,0,0,0,Serie_A,2021_2022
Adama Soumaoro,FRA,DF,Bologna,29,1992,25.2,15,5,5,8,2,4,9,44.4,5,22,16,6,34,49,95,0,Serie_A,2021_2022
Leonardo Spinazzola,ITA,DF,Roma,28,1993,1.4,0,0,0,0,0,0,1,0.0,1,4,1,3,0,0,3,0,Serie_A,2021_2022
Marco Sportiello,ITA,GK,Atalanta,29,1992,5.0,0,0,0,0,0,0,0,,0,0,0,0,0,0,2,0,Serie_A,2021_2022
Luca Stanga,ITA,DF,Milan,19,2002,0.0,1,0,0,1,0,0,0,,0,0,0,0,0,1,0,0,Serie_A,2021_2022
Riccardo Stivanello,ITA,DF,Bologna,17,2004,0.5,1,1,1,0,0,1,1,100.0,0,2,2,0,0,1,6,0,Serie_A,2021_2022
Petar Stojanović,SVN,DF,Empoli,25,1995,30.4,96,63,55,32,9,59,114,51.8,55,39,13,26,27,123,65,1,Serie_A,2021_2022
Thomas Strakosha,ALB,GK,Lazio,26,1995,23.0,0,0,0,0,0,0,0,,0,0,0,0,0,0,7,2,Serie_A,2021_2022
Stefan Strandberg,NOR,DF,Salernitana,31,1990,10.4,13,8,10,3,0,8,11,72.7,3,15,13,2,9,22,49,0,Serie_A,2021_2022
Dávid Strelec,SVK,"FW,MF",Spezia,20,2001,5.6,4,4,1,2,1,2,9,22.2,7,8,1,7,2,6,1,0,Serie_A,2021_2022
Kevin Strootman,NED,MF,Cagliari,31,1990,7.1,8,4,2,4,2,5,12,41.7,7,11,2,9,10,18,15,0,Serie_A,2021_2022
Jens Stryger Larsen,DEN,DF,Udinese,30,1991,7.6,5,2,3,1,1,2,3,66.7,1,2,0,2,4,9,17,0,Serie_A,2021_2022
Leo Štulac,SVN,MF,Empoli,26,1994,9.3,13,6,5,6,2,7,19,36.8,12,6,2,4,8,21,15,0,Serie_A,2021_2022
Stefano Sturaro,ITA,MF,Genoa,28,1993,19.6,43,26,16,16,11,22,48,45.8,26,25,1,24,15,58,29,2,Serie_A,2021_2022
Isaac Success,NGA,"FW,MF",Udinese,25,1996,10.1,5,2,0,3,2,1,5,20.0,4,2,0,2,2,7,6,0,Serie_A,2021_2022
Vladyslav Supriaha,UKR,FW,Sampdoria,21,2000,0.2,0,0,0,0,0,0,1,0.0,1,0,0,0,0,0,0,0,Serie_A,2021_2022
Bosko Sutalo,CRO,DF,Hellas Verona,21,2000,10.2,20,13,11,6,3,8,16,50.0,8,10,5,5,17,37,39,0,Serie_A,2021_2022
Mattias Svanberg,SWE,MF,Bologna,22,1999,28.5,39,15,15,16,8,16,54,29.6,38,31,9,22,28,67,34,0,Serie_A,2021_2022
Michael Svoboda,AUT,DF,Venezia,22,1998,13.7,33,17,26,6,1,18,32,56.3,14,27,15,12,10,43,61,5,Serie_A,2021_2022
Wojciech Szczęsny,POL,GK,Juventus,31,1990,33.0,1,1,1,0,0,1,2,50.0,1,0,0,0,0,1,8,1,Serie_A,2021_2022
Adrien Tameze,CMR,"MF,DF",Hellas Verona,27,1994,28.6,52,29,24,21,7,20,59,33.9,39,40,5,35,52,104,41,0,Serie_A,2021_2022
Ciprian Tătărușanu,ROU,GK,Milan,35,1986,6.0,0,0,0,0,0,0,1,0.0,1,0,0,0,0,0,2,1,Serie_A,2021_2022
Filippo Terracciano,ITA,DF,Hellas Verona,18,2003,0.1,0,0,0,0,0,0,0,,0,0,0,0,0,0,1,0,Serie_A,2021_2022
Pietro Terracciano,ITA,GK,Fiorentina,31,1990,31.8,0,0,0,0,0,0,4,0.0,4,0,0,0,2,2,20,1,Serie_A,2021_2022
Aleksa Terzić,SRB,DF,Fiorentina,21,1999,3.0,8,5,3,3,2,4,7,57.1,3,7,0,7,4,12,5,0,Serie_A,2021_2022
Tanner Tessmann,USA,MF,Venezia,19,2001,7.6,11,5,4,6,1,5,14,35.7,9,19,9,10,5,16,22,0,Serie_A,2021_2022
Arthur Theate,BEL,DF,Bologna,21,2000,26.9,33,19,26,3,4,14,31,45.2,17,29,16,13,42,75,69,0,Serie_A,2021_2022
Morten Thorsby,NOR,MF,Sampdoria,25,1996,32.7,46,26,15,23,8,28,56,50.0,28,37,12,25,25,71,39,0,Serie_A,2021_2022
Jeremy Toljan,GER,DF,Sassuolo,26,1994,15.5,18,10,12,4,2,13,20,65.0,7,12,5,7,12,30,41,0,Serie_A,2021_2022
Rafael Tolói,ITA,DF,Atalanta,30,1990,16.0,38,15,12,15,11,24,39,61.5,15,23,11,12,26,64,35,0,Serie_A,2021_2022
Takehiro Tomiyasu,JPN,DF,Bologna,22,1998,0.1,0,0,0,0,0,0,0,,0,1,0,1,1,1,0,0,Serie_A,2021_2022
Fikayo Tomori,ENG,DF,Milan,23,1997,30.2,73,44,36,34,3,18,26,69.2,8,37,23,14,45,118,84,1,Serie_A,2021_2022
Sandro Tonali,ITA,MF,Milan,21,2000,28.9,54,37,23,25,6,21,41,51.2,20,26,8,18,34,88,19,0,Serie_A,2021_2022
Lorenzo Tonelli,ITA,DF,Empoli,31,1990,9.7,17,9,11,4,2,6,13,46.2,7,14,8,6,19,36,28,2,Serie_A,2021_2022
Ernesto Torregrossa,VEN,FW,Sampdoria,29,1992,1.3,2,1,1,0,1,1,2,50.0,1,0,0,0,0,2,1,0,Serie_A,2021_2022
Lucas Torreira,URU,MF,Fiorentina,25,1996,24.4,37,29,13,21,3,18,40,45.0,22,18,1,17,26,63,18,0,Serie_A,2021_2022
Abdoulaye Touré,GUI,MF,Genoa,27,1994,4.8,12,4,3,8,1,5,11,45.5,6,6,1,5,4,16,6,0,Serie_A,2021_2022
Simone Trimboli,ITA,MF,Sampdoria,19,2002,0.7,2,1,2,0,0,2,2,100.0,0,0,0,0,2,4,0,0,Serie_A,2021_2022
Axel Tuanzebe,COD,DF,Napoli,23,1997,0.1,0,0,0,0,0,0,0,,0,1,1,0,0,0,0,0,Serie_A,2021_2022
Destiny Udogie,ITA,DF,Udinese,18,2002,27.5,64,40,30,27,7,33,60,55.0,27,39,6,33,27,91,42,0,Serie_A,2021_2022
Maximilian Ullmann,AUT,DF,Venezia,25,1996,2.7,0,0,0,0,0,0,1,0.0,1,4,0,4,2,2,7,0,Serie_A,2021_2022
Kacper Urbanski,POL,MF,Bologna,16,2004,0.5,3,2,1,2,0,2,2,100.0,0,2,0,2,0,3,0,0,Serie_A,2021_2022
Antonio Vacca,ITA,MF,Venezia,31,1990,11.8,36,20,24,10,2,14,36,38.9,22,16,8,8,20,56,16,0,Serie_A,2021_2022
Zinho Vanheusden,BEL,DF,Genoa,22,1999,11.0,18,6,12,5,1,8,14,57.1,6,19,14,5,23,41,42,0,Serie_A,2021_2022
Johan Vásquez,MEX,DF,Genoa,22,1998,25.3,79,46,44,32,3,48,75,64.0,27,32,10,22,42,121,85,0,Serie_A,2021_2022
Denis Vavro,SVK,DF,Lazio,25,1996,0.1,0,0,0,0,0,0,0,,0,0,0,0,0,0,0,0,Serie_A,2021_2022
Matías Vecino,URU,MF,Inter,29,1991,4.2,7,5,2,3,2,3,9,33.3,6,10,1,9,4,11,7,0,Serie_A,2021_2022
Miguel Veloso,POR,MF,Hellas Verona,35,1986,14.9,23,15,4,17,2,10,16,62.5,6,18,5,13,11,34,18,1,Serie_A,2021_2022
Lorenzo Venuti,ITA,DF,Fiorentina,26,1995,17.5,25,10,13,10,2,14,24,58.3,10,13,4,9,5,30,27,0,Serie_A,2021_2022
Daniele Verde,ITA,"FW,MF",Spezia,25,1996,21.7,11,4,8,2,1,9,20,45.0,11,17,2,15,18,29,8,0,Serie_A,2021_2022
Simone Verdi,ITA,"MF,FW",Torino,29,1992,0.5,1,1,0,1,0,0,0,,0,0,0,0,0,1,0,0,Serie_A,2021_2022
Simone Verdi,ITA,"FW,MF",Salernitana,29,1992,9.2,12,8,5,2,5,9,20,45.0,11,4,0,4,3,15,1,0,Serie_A,2021_2022
Jordan Veretout,FRA,MF,Roma,28,1993,25.8,34,25,20,12,2,15,39,38.5,24,12,1,11,27,61,22,1,Serie_A,2021_2022
Edoardo Vergani,ITA,"FW,MF",Salernitana,20,2001,1.1,2,2,2,0,0,0,0,,0,2,2,0,0,2,2,0,Serie_A,2021_2022
Valerio Verre,ITA,"MF,FW",Sampdoria,27,1994,4.7,7,5,1,4,2,4,9,44.4,5,7,0,7,0,7,5,0,Serie_A,2021_2022
Valerio Verre,ITA,MF,Empoli,27,1994,3.4,4,2,3,1,0,2,7,28.6,5,2,0,2,1,5,0,0,Serie_A,2021_2022
Freddie Veseli,ALB,DF,Salernitana,28,1992,6.6,7,2,4,3,0,5,6,83.3,1,10,5,5,4,11,19,0,Serie_A,2021_2022
Guglielmo Vicario,ITA,GK,Empoli,24,1996,38.0,1,1,1,0,0,1,1,100.0,0,1,0,1,1,2,21,1,Serie_A,2021_2022
Arturo Vidal,CHI,MF,Inter,34,1987,8.2,26,10,16,9,1,9,26,34.6,17,13,5,8,7,33,7,1,Serie_A,2021_2022
Ronaldo Vieira,ENG,MF,Sampdoria,23,1998,5.5,10,6,6,4,0,5,10,50.0,5,5,2,3,6,16,5,1,Serie_A,2021_2022
Luca Vignali,ITA,"DF,MF",Spezia,25,1996,0.9,1,1,0,1,0,0,3,0.0,3,0,0,0,1,2,1,0,Serie_A,2021_2022
Emanuel Vignato,ITA,"MF,DF",Bologna,20,2000,6.6,12,7,5,7,0,6,13,46.2,7,2,0,2,2,14,5,0,Serie_A,2021_2022
Matías Viña,URU,"DF,FW",Roma,23,1997,17.4,46,30,27,14,5,29,59,49.2,30,26,3,23,25,71,33,0,Serie_A,2021_2022
Nicolas Viola,ITA,MF,Bologna,31,1989,1.1,2,2,1,1,0,1,2,50.0,1,1,1,0,0,2,1,0,Serie_A,2021_2022
Mattia Viti,ITA,DF,Empoli,19,2002,16.6,28,16,16,9,3,15,24,62.5,9,28,25,3,29,57,69,1,Serie_A,2021_2022
Dušan Vlahović,SRB,FW,Fiorentina,21,2000,20.6,5,0,0,2,3,2,11,18.2,9,6,2,4,1,6,16,0,Serie_A,2021_2022
Dušan Vlahović,SRB,FW,Juventus,21,2000,12.0,0,0,0,0,0,0,4,0.0,4,3,0,3,0,0,7,0,Serie_A,2021_2022
Mërgim Vojvoda,KVX,DF,Torino,26,1995,22.0,38,23,23,11,4,20,36,55.6,16,27,8,19,20,58,51,0,Serie_A,2021_2022
Cristian Volpato,ITA,"FW,MF",Roma,17,2003,0.4,1,1,0,0,1,1,1,100.0,0,0,0,0,0,1,0,0,Serie_A,2021_2022
Stefan de Vrij,NED,DF,Inter,29,1992,26.8,38,29,22,16,0,12,17,70.6,5,17,8,9,32,70,52,0,Serie_A,2021_2022
Walace,BRA,MF,Udinese,26,1995,33.0,83,49,37,38,8,50,113,44.2,63,51,5,46,54,137,32,1,Serie_A,2021_2022
Sebastian Walukiewicz,POL,DF,Cagliari,21,2000,3.4,9,5,7,2,0,3,5,60.0,2,5,2,3,7,16,14,0,Serie_A,2021_2022
Magnus Warming,DEN,"MF,FW",Torino,21,2000,0.6,1,1,0,1,0,0,0,,0,2,0,2,0,1,0,0,Serie_A,2021_2022
Kelvin Yeboah,ITA,"FW,MF",Genoa,21,2000,9.4,14,7,5,7,2,9,19,47.4,10,22,1,21,1,15,7,0,Serie_A,2021_2022
Gerard Yepes,ESP,"MF,DF",Sampdoria,18,2002,0.2,1,0,0,1,0,1,1,100.0,0,1,0,1,0,1,0,0,Serie_A,2021_2022
Maya Yoshida,JPN,DF,Sampdoria,32,1988,20.3,17,10,8,9,0,8,15,53.3,7,27,20,7,28,45,72,1,Serie_A,2021_2022
Mattia Zaccagni,ITA,MF,Hellas Verona,26,1995,2.0,3,1,1,0,2,1,2,50.0,1,1,0,1,4,7,0,0,Serie_A,2021_2022
Mattia Zaccagni,ITA,FW,Lazio,26,1995,20.8,33,16,10,13,10,11,19,57.9,8,17,2,15,20,53,5,0,Serie_A,2021_2022
Denis Zakaria,SUI,MF,Juventus,24,1996,6.6,11,7,3,6,2,3,11,27.3,8,16,3,13,11,22,7,0,Serie_A,2021_2022
Nicola Zalewski,POL,DF,Roma,19,2002,8.8,32,19,17,11,4,21,35,60.0,14,18,1,17,16,48,4,0,Serie_A,2021_2022
Andre-Frank Zambo Anguissa,CMR,MF,Napoli,25,1995,21.4,50,26,24,17,9,25,51,49.0,26,31,5,26,24,74,33,1,Serie_A,2021_2022
Nicolò Zaniolo,ITA,"FW,MF",Roma,22,1999,21.9,24,15,0,15,9,6,28,21.4,22,19,0,19,7,31,6,0,Serie_A,2021_2022
Alessandro Zanoli,ITA,DF,Napoli,20,2000,5.1,10,7,6,3,1,3,5,60.0,2,2,1,1,4,14,16,0,Serie_A,2021_2022
Mattia Zanotti,ITA,DF,Inter,18,2003,0.1,1,0,1,0,0,0,1,0.0,1,0,0,0,0,1,0,0,Serie_A,2021_2022
Duván Zapata,COL,FW,Atalanta,30,1991,19.1,6,2,0,4,2,4,8,50.0,4,8,1,7,3,9,5,0,Serie_A,2021_2022
Gabriele Zappa,ITA,DF,Cagliari,21,1999,12.7,21,9,12,6,3,6,24,25.0,18,15,5,10,14,35,28,0,Serie_A,2021_2022
Davide Zappacosta,ITA,DF,Atalanta,29,1992,26.1,32,22,12,13,7,19,37,51.4,18,32,2,30,12,44,22,0,Serie_A,2021_2022
Simone Zaza,ITA,"FW,DF",Torino,30,1991,1.4,2,2,1,1,0,1,1,100.0,0,3,0,3,0,2,3,0,Serie_A,2021_2022
Marvin Zeegelaar,NED,DF,Udinese,30,1990,7.1,15,11,6,8,1,5,14,35.7,9,12,4,8,12,27,22,1,Serie_A,2021_2022
Piotr Zieliński,POL,MF,Napoli,27,1994,23.2,19,12,5,9,5,6,21,28.6,15,13,2,11,8,27,4,0,Serie_A,2021_2022
David Zima,CZE,DF,Torino,20,2000,14.6,20,12,8,11,1,9,20,45.0,11,15,13,2,23,43,42,0,Serie_A,2021_2022
Jeroen Zoet,NED,GK,Spezia,30,1991,7.0,1,0,1,0,0,1,1,100.0,0,0,0,0,0,1,4,0,Serie_A,2021_2022
Nadir Zortea,ITA,"DF,MF",Salernitana,22,1999,15.7,21,15,9,7,5,11,19,57.9,8,14,2,12,7,28,33,0,Serie_A,2021_2022
Petar Zovko,BIH,GK,Spezia,19,2002,0.3,0,0,0,0,0,0,0,,0,0,0,0,0,0,1,0,Serie_A,2021_2022
Szymon Żurkowski,POL,MF,Empoli,23,1997,25.6,58,33,24,21,13,29,68,42.6,39,43,10,33,35,93,32,1,Serie_A,2021_2022
Milan Đurić,BIH,FW,Salernitana,31,1990,24.1,1,1,0,1,0,1,3,33.3,2,6,1,5,2,3,32,0,Serie_A,2021_2022
Filip Đuričić,SRB,"MF,FW",Sassuolo,29,1992,7.5,13,10,7,1,5,5,13,38.5,8,7,1,6,4,17,1,0,Serie_A,2021_2022
Rodrigo Abascal,URU,DF,Boavista,27,1994,26.5,74,45,44,28,2,46,75,61.3,29,36,14,22,43,117,103,0,Primeira_Liga,2021_2022
Giorgi Aburjania,GEO,MF,Gil Vicente FC,26,1995,8.6,22,13,8,13,1,6,25,24.0,19,9,3,6,8,30,8,0,Primeira_Liga,2021_2022
Antonio Adán,ESP,GK,Sporting CP,34,1987,33.0,1,0,1,0,0,1,1,100.0,0,0,0,0,2,3,11,0,Primeira_Liga,2021_2022
João Afonso Crispim,BRA,MF,Gil Vicente FC,26,1995,0.2,1,1,0,1,0,0,3,0.0,3,0,0,0,0,1,0,0,Primeira_Liga,2021_2022
João Afonso,POR,DF,Santa Clara,31,1990,12.4,14,8,9,5,0,10,18,55.6,8,13,11,2,17,31,57,0,Primeira_Liga,2021_2022
Lucas Áfrico,BRA,DF,Estoril,26,1995,10.7,4,2,2,2,0,2,5,40.0,3,13,10,3,12,16,40,1,Primeira_Liga,2021_2022
Salvador Agra,POR,"FW,MF",Tondela,29,1991,29.0,26,14,13,11,2,10,28,35.7,18,9,2,7,11,37,12,0,Primeira_Liga,2021_2022
Mohamed Aidara,CIV,DF,Vizela,24,1996,15.0,13,8,11,2,0,7,16,43.8,9,21,11,10,23,36,83,0,Primeira_Liga,2021_2022
Chima Akas,NGA,DF,B-SAD,27,1994,19.5,29,20,13,15,1,15,28,53.6,13,25,12,13,26,55,53,0,Primeira_Liga,2021_2022
Alex,BRA,DF,Famalicão,22,1999,16.4,32,22,22,9,1,16,27,59.3,11,25,20,5,17,49,65,1,Primeira_Liga,2021_2022
Ali Alipour,IRN,FW,Marítimo,25,1995,20.0,14,10,3,9,2,1,9,11.1,8,16,2,14,2,16,14,0,Primeira_Liga,2021_2022
Allano,BRA,"FW,MF",Santa Clara,26,1995,12.1,25,16,13,8,4,7,19,36.8,12,26,5,21,10,35,9,0,Primeira_Liga,2021_2022
André Almeida,POR,DF,Benfica,30,1990,8.9,18,9,6,8,4,10,18,55.6,8,12,3,9,3,21,11,0,Primeira_Liga,2021_2022
Domingos André Ribeiro Almeida,POR,"MF,FW",Vitória,21,2000,20.2,42,21,15,20,7,14,38,36.8,24,19,4,15,17,59,11,0,Primeira_Liga,2021_2022
Baptiste Aloé,FRA,DF,Arouca,27,1994,0.7,1,0,0,1,0,1,1,100.0,0,0,0,0,3,4,4,0,Primeira_Liga,2021_2022
Omri Altman,ISR,MF,Arouca,27,1994,1.5,4,1,0,3,1,2,2,100.0,0,2,1,1,2,6,1,0,Primeira_Liga,2021_2022
Alejandro Alvarado Jr.,USA,"MF,FW",Vizela,18,2003,0.7,4,4,0,4,0,3,3,100.0,0,0,0,0,0,4,1,0,Primeira_Liga,2021_2022
Marcelo Alves,BRA,DF,Tondela,23,1998,8.1,6,5,5,1,0,3,5,60.0,2,13,11,2,6,12,32,0,Primeira_Liga,2021_2022
Ricardo Miguel Martins Alves,POR,"DF,MF",Tondela,30,1991,9.2,17,7,9,7,1,10,13,76.9,3,10,4,6,10,27,30,1,Primeira_Liga,2021_2022
Pedro Amador,POR,"MF,DF",Moreirense,22,1998,13.3,25,13,19,5,1,13,22,59.1,9,14,3,11,22,47,25,0,Primeira_Liga,2021_2022
Amarildo,BRA,DF,Famalicão,22,1999,0.0,0,0,0,0,0,0,0,,0,0,0,0,0,0,0,0,Primeira_Liga,2021_2022
André Amaro,POR,DF,Vitória,18,2002,6.3,8,6,8,0,0,6,10,60.0,4,6,3,3,6,14,19,0,Primeira_Liga,2021_2022
Artur Jorge Marques Amorim,POR,DF,Moreirense,26,1994,22.2,26,18,14,11,1,15,24,62.5,9,23,12,11,34,60,87,1,Primeira_Liga,2021_2022
Anderson,BRA,"FW,MF",Portimonense,23,1998,11.4,18,11,6,8,4,7,19,36.8,12,13,0,13,5,23,3,0,Primeira_Liga,2021_2022
Léo Andrade,BRA,DF,Marítimo,23,1998,14.3,28,20,21,7,0,14,20,70.0,6,30,21,9,20,48,78,0,Primeira_Liga,2021_2022
Rodri Andrade,POR,MF,Marítimo,19,2001,0.1,0,0,0,0,0,0,0,,0,0,0,0,1,1,0,0,Primeira_Liga,2021_2022
André André,POR,MF,Vitória,31,1989,10.4,23,15,5,11,7,10,19,52.6,9,9,5,4,8,31,3,0,Primeira_Liga,2021_2022
Mauro Andrés Caballero,PAR,FW,Arouca,26,1994,0.0,0,0,0,0,0,0,0,,0,0,0,0,0,0,0,0,Primeira_Liga,2021_2022
Andrew,BRA,GK,Gil Vicente FC,20,2001,10.0,0,0,0,0,0,0,0,,0,0,0,0,0,0,4,1,Primeira_Liga,2021_2022
Iván Angulo,COL,"FW,MF",Portimonense,22,1999,26.2,38,23,17,13,8,17,36,47.2,19,23,1,22,24,62,27,0,Primeira_Liga,2021_2022
Antony,BRA,"FW,MF",Arouca,19,2001,7.4,21,12,11,6,4,9,20,45.0,11,9,0,9,7,28,3,0,Primeira_Liga,2021_2022
Vitorino Antunes,POR,DF,Paços,34,1987,28.2,51,29,29,19,3,31,54,57.4,23,19,6,13,31,82,67,0,Primeira_Liga,2021_2022
Bilel Aouacheria,FRA,"FW,MF",Gil Vicente FC,27,1994,7.1,7,3,1,4,2,2,3,66.7,1,5,0,5,4,11,5,0,Primeira_Liga,2021_2022
Wilinton Aponzá,COL,"FW,MF",Portimonense,21,2000,8.3,5,1,1,3,1,3,5,60.0,2,6,0,6,1,6,7,0,Primeira_Liga,2021_2022
Brian Araújo,FRA,GK,Gil Vicente FC,21,2000,1.0,0,0,0,0,0,0,0,,0,0,0,0,0,0,0,0,Primeira_Liga,2021_2022
Henrique Araújo,POR,FW,Benfica,19,2002,1.4,0,0,0,0,0,0,0,,0,0,0,0,0,0,0,0,Primeira_Liga,2021_2022
Guilherme Araújo Soares,POR,DF,Braga,20,2001,0.5,0,0,0,0,0,0,1,0.0,1,1,1,0,1,1,1,0,Primeira_Liga,2021_2022
Tiago Araújo,POR,"DF,FW",Arouca,20,2001,5.3,12,8,9,3,0,7,15,46.7,8,8,2,6,2,14,13,0,Primeira_Liga,2021_2022
Tomás Araújo,POR,DF,Benfica,19,2002,1.1,0,0,0,0,0,0,1,0.0,1,3,0,3,0,0,5,0,Primeira_Liga,2021_2022
Telmo Arcanjo,CPV,"MF,FW",Tondela,20,2001,1.4,3,3,1,2,0,0,0,,0,2,0,2,0,3,0,0,Primeira_Liga,2021_2022
Arthur,BRA,"FW,MF",Estoril,23,1998,24.4,32,19,9,14,9,8,25,32.0,17,20,1,19,15,47,17,0,Primeira_Liga,2021_2022
Gustavo Assuncao,POR,MF,Famalicão,21,2000,6.7,21,13,10,10,1,12,24,50.0,12,6,1,5,5,26,13,0,Primeira_Liga,2021_2022
Javier Avilés,ESP,"MF,FW",Tondela,23,1997,1.7,3,2,1,1,1,3,5,60.0,2,3,0,3,1,4,0,0,Primeira_Liga,2021_2022
Chidozie Awaziem,NGA,DF,Boavista,24,1997,3.0,4,2,2,2,0,2,2,100.0,0,3,3,0,2,6,19,0,Primeira_Liga,2021_2022
Abdoulaye Ba,SEN,DF,Arouca,30,1991,14.9,21,11,17,4,0,10,17,58.8,7,13,7,6,29,50,64,0,Primeira_Liga,2021_2022
Abdoulaye Ba,SEN,DF,Moreirense,30,1991,1.0,4,2,3,1,0,3,3,100.0,0,1,0,1,1,5,3,0,Primeira_Liga,2021_2022
Marco Baixinho,POR,DF,Paços,32,1989,24.3,20,12,16,3,1,9,22,40.9,13,34,21,13,45,65,68,1,Primeira_Liga,2021_2022
Ibrahima Bamba,CIV,MF,Vitória,19,2002,3.3,8,4,2,5,1,5,6,83.3,1,4,0,4,9,17,6,0,Primeira_Liga,2021_2022
Daniel Bandeira,POR,MF,Vitória,21,2000,0.2,0,0,0,0,0,0,1,0.0,1,0,0,0,0,0,1,0,Primeira_Liga,2021_2022
Simon Banza,COD,FW,Famalicão,24,1996,25.9,16,10,4,7,5,5,14,35.7,9,14,2,12,9,25,32,0,Primeira_Liga,2021_2022
Yves Baraye,SEN,"FW,MF",B-SAD,29,1992,11.8,16,5,8,4,4,9,16,56.3,7,20,2,18,13,29,10,0,Primeira_Liga,2021_2022
Rafael Barbosa,POR,"MF,FW",Tondela,25,1996,19.2,18,8,4,9,5,7,23,30.4,16,12,1,11,9,27,4,0,Primeira_Liga,2021_2022
Romário Baró,POR,MF,Estoril,21,2000,4.3,7,2,2,3,2,3,8,37.5,5,2,1,1,2,9,3,0,Primeira_Liga,2021_2022
Oscar Barreto,COL,"FW,MF",Santa Clara,28,1993,3.9,13,8,6,4,3,6,12,50.0,6,8,0,8,4,17,3,0,Primeira_Liga,2021_2022
Gil Bastião Dias,POR,"DF,FW",Benfica,24,1996,7.3,19,11,9,6,4,8,16,50.0,8,9,0,9,12,31,5,0,Primeira_Liga,2021_2022
Luís Bastos,POR,DF,Paços,19,2001,3.4,11,6,8,3,0,8,15,53.3,7,1,1,0,6,17,6,0,Primeira_Liga,2021_2022
Dylan Batubinsika,COD,DF,Famalicão,25,1996,16.7,22,14,15,7,0,10,15,66.7,5,20,17,3,41,63,76,1,Primeira_Liga,2021_2022
Clésio Baúque,MOZ,"DF,FW",Marítimo,26,1994,5.3,9,7,7,1,1,4,8,50.0,4,4,0,4,8,17,9,0,Primeira_Liga,2021_2022
Bebeto,BRA,"DF,MF",Tondela,31,1990,15.4,69,49,41,24,4,44,73,60.3,29,27,2,25,31,100,29,0,Primeira_Liga,2021_2022
Alireza Beiranvand,IRN,GK,Boavista,28,1992,7.5,0,0,0,0,0,0,1,0.0,1,0,0,0,1,1,9,1,Primeira_Liga,2021_2022
Stefano Beltrame,ITA,MF,Marítimo,28,1993,15.4,11,4,4,5,2,3,13,23.1,10,15,2,13,18,29,7,0,Primeira_Liga,2021_2022
Gilson Benchimol,CPV,FW,Estoril,19,2001,0.1,0,0,0,0,0,0,0,,0,0,0,0,1,1,0,0,Primeira_Liga,2021_2022
Berna,POR,MF,Braga,18,2002,0.0,0,0,0,0,0,0,0,,0,0,0,0,0,0,0,0,Primeira_Liga,2021_2022
Paulo Bernardo,POR,MF,Benfica,19,2002,8.7,26,13,6,16,4,13,28,46.4,15,15,4,11,8,34,5,0,Primeira_Liga,2021_2022
Beto,GNB,FW,Portimonense,23,1998,3.0,0,0,0,0,0,0,2,0.0,2,4,0,4,0,0,4,0,Primeira_Liga,2021_2022
Aylton Boa Morte,POR,"FW,MF",Portimonense,27,1993,12.3,10,6,3,2,5,7,19,36.8,12,7,0,7,6,16,8,0,Primeira_Liga,2021_2022
Kennedy Boateng,TOG,DF,Santa Clara,24,1996,23.3,43,35,34,9,0,25,31,80.6,6,14,9,5,35,78,107,2,Primeira_Liga,2021_2022
Kiko Bondoso,POR,FW,Vizela,25,1995,30.2,33,18,8,16,9,18,51,35.3,33,18,4,14,16,49,18,0,Primeira_Liga,2021_2022
Trova Boni,BFA,MF,B-SAD,21,1999,4.9,13,6,7,6,0,7,13,53.8,6,4,2,2,9,22,6,0,Primeira_Liga,2021_2022
Toni Borevkovic,CRO,DF,Vitória,24,1997,22.1,21,11,18,3,0,13,25,52.0,12,15,9,6,35,56,69,3,Primeira_Liga,2021_2022
Gonçalo Borges,POR,MF,Porto,20,2001,0.1,1,0,0,0,1,0,0,,0,0,0,0,0,1,0,0,Primeira_Liga,2021_2022
Neto Borges,BRA,"DF,MF",Tondela,24,1996,23.7,53,35,34,17,2,24,41,58.5,17,23,5,18,49,102,67,0,Primeira_Liga,2021_2022
Pedro Borges,BRA,MF,Tondela,24,1997,22.1,66,40,29,34,3,24,63,38.1,39,33,6,27,28,94,31,0,Primeira_Liga,2021_2022
Mohamed Bouldini,MAR,FW,Santa Clara,25,1995,1.7,2,1,0,1,1,1,1,100.0,0,2,2,0,0,2,2,0,Primeira_Liga,2021_2022
Rafael Bracalli,BRA,GK,Boavista,40,1981,26.5,2,1,2,0,0,1,2,50.0,1,0,0,0,3,5,19,1,Primeira_Liga,2021_2022
Victor Braga,BRA,GK,Arouca,29,1992,23.1,0,0,0,0,0,0,2,0.0,2,0,0,0,0,0,19,2,Primeira_Liga,2021_2022
Daniel Bragança,POR,MF,Sporting CP,22,1999,8.7,25,15,10,12,3,15,27,55.6,12,10,0,10,17,42,1,0,Primeira_Liga,2021_2022
Pedro Brazão,POR,"MF,FW",Famalicão,18,2002,4.2,5,5,4,1,0,4,10,40.0,6,8,1,7,2,7,1,0,Primeira_Liga,2021_2022
Brunão,BRA,MF,Arouca,24,1997,0.2,0,0,0,0,0,0,0,,0,0,0,0,1,1,1,0,Primeira_Liga,2021_2022
Bruninho,BRA,FW,Arouca,22,1999,3.3,4,2,0,2,2,1,2,50.0,1,6,0,6,1,5,1,0,Primeira_Liga,2021_2022
David Bruno,POR,DF,Estoril,29,1992,13.5,11,8,9,1,1,6,13,46.2,7,13,9,4,16,27,28,0,Primeira_Liga,2021_2022
Matheus Bueno,BRA,"MF,FW",Gil Vicente FC,23,1998,7.3,9,7,4,3,2,2,4,50.0,2,7,1,6,3,12,3,0,Primeira_Liga,2021_2022
André Bukia,COD,"FW,MF",Arouca,26,1995,28.5,24,12,9,8,7,18,34,52.9,16,22,0,22,15,39,9,0,Primeira_Liga,2021_2022
Leonardo Buta,POR,DF,Braga,19,2002,1.5,1,0,0,1,0,1,1,100.0,0,2,1,1,4,5,3,0,Primeira_Liga,2021_2022
Adrián Butzke,ESP,FW,Paços,22,1999,6.4,1,1,0,1,0,1,2,50.0,1,0,0,0,1,2,7,0,Primeira_Liga,2021_2022
Jovane Cabral,CPV,"MF,FW",Sporting CP,23,1998,3.8,5,2,0,3,2,1,6,16.7,5,4,0,4,1,6,1,0,Primeira_Liga,2021_2022
Paulo Henrique Rodrigues Cabral,POR,DF,Santa Clara,24,1996,13.9,14,5,12,2,0,7,11,63.6,4,12,6,6,11,25,28,0,Primeira_Liga,2021_2022
Jhonder Cádiz,VEN,"FW,DF",Famalicão,26,1995,5.0,4,3,1,2,1,1,4,25.0,3,3,0,3,2,6,2,0,Primeira_Liga,2021_2022
João Caiado,POR,FW,Gil Vicente FC,22,1999,0.0,0,0,0,0,0,0,0,,0,0,0,0,0,0,0,0,Primeira_Liga,2021_2022
Juan Calero,COL,FW,Gil Vicente FC,22,1998,1.6,0,0,0,0,0,0,3,0.0,3,1,0,1,1,1,2,0,Primeira_Liga,2021_2022
Diogo Calila,POR,"DF,MF",B-SAD,22,1998,21.3,28,16,21,7,0,20,28,71.4,8,26,11,15,17,45,58,0,Primeira_Liga,2021_2022
Rafael Camacho,POR,"FW,MF",B-SAD,21,2000,9.8,7,7,2,3,2,4,6,66.7,2,4,0,4,2,9,7,0,Primeira_Liga,2021_2022
Abel Camará,GNB,FW,B-SAD,31,1990,17.3,18,12,7,8,3,7,20,35.0,13,15,5,10,8,26,10,0,Primeira_Liga,2021_2022
Ibrahima Camará,GUI,MF,Moreirense,22,1999,18.9,30,16,8,18,4,10,32,31.3,22,9,3,6,12,42,12,0,Primeira_Liga,2021_2022
Gastón Campi,ARG,DF,Arouca,30,1991,4.0,3,3,1,2,0,0,4,0.0,4,4,3,1,8,11,8,0,Primeira_Liga,2021_2022
Fali Candé,GNB,DF,Portimonense,23,1998,14.6,31,20,23,8,0,18,28,64.3,10,9,6,3,5,36,45,0,Primeira_Liga,2021_2022
Francis Cann,GHA,"FW,MF",Vizela,23,1998,2.4,7,3,3,2,2,0,7,0.0,7,2,1,1,3,10,1,0,Primeira_Liga,2021_2022
Reggie Cannon,USA,DF,Boavista,23,1998,19.0,43,30,34,7,2,25,32,78.1,7,17,9,8,37,80,37,0,Primeira_Liga,2021_2022
Fábio Cardoso,POR,DF,Porto,27,1994,12.0,8,4,4,4,0,7,10,70.0,3,11,9,2,10,18,34,0,Primeira_Liga,2021_2022
Carlinhos,BRA,MF,Portimonense,27,1994,25.4,41,24,23,15,3,16,42,38.1,26,27,8,19,16,57,15,1,Primeira_Liga,2021_2022
Carlos,BRA,FW,Santa Clara,25,1995,2.0,5,2,2,3,0,2,3,66.7,1,1,0,1,0,5,2,0,Primeira_Liga,2021_2022
Luíz Carlos,BRA,MF,Paços,36,1985,28.9,66,49,21,38,7,29,76,38.2,47,32,14,18,28,94,33,0,Primeira_Liga,2021_2022
João Carlos Teixeira,POR,"FW,MF",Famalicão,28,1993,8.8,9,3,0,5,4,4,11,36.4,7,9,1,8,4,13,6,0,Primeira_Liga,2021_2022
Zé Carlos,POR,DF,Gil Vicente FC,23,1998,27.3,57,35,30,19,8,27,50,54.0,23,27,11,16,41,98,73,0,Primeira_Liga,2021_2022
David Carmo,ANG,DF,Braga,22,1999,11.0,7,4,5,2,0,3,9,33.3,6,11,8,3,13,20,38,0,Primeira_Liga,2021_2022
Carraça,POR,"DF,MF",B-SAD,28,1993,24.5,34,28,17,11,6,22,45,48.9,23,19,7,12,27,61,53,0,Primeira_Liga,2021_2022
Anderson Carvalho,BRA,MF,Santa Clara,31,1990,21.1,63,40,21,36,6,25,62,40.3,37,15,3,12,42,105,24,0,Primeira_Liga,2021_2022
Duarte Carvalho,POR,MF,Estoril,19,2002,0.2,1,1,0,1,0,0,0,,0,0,0,0,0,1,0,0,Primeira_Liga,2021_2022
Vitor Carvalho,BRA,MF,Gil Vicente FC,24,1997,24.8,53,27,18,29,6,22,54,40.7,32,28,8,20,33,86,50,1,Primeira_Liga,2021_2022
Cassiano,BRA,FW,Vizela,32,1989,17.7,22,10,3,13,6,6,16,37.5,10,17,3,14,5,27,9,0,Primeira_Liga,2021_2022
Mateo Cassierra,COL,FW,B-SAD,24,1997,1.9,2,2,0,2,0,1,1,100.0,0,0,0,0,0,2,0,0,Primeira_Liga,2021_2022
Moises Castillo,COL,"DF,FW",Marítimo,20,2001,0.2,0,0,0,0,0,0,0,,0,1,1,0,0,0,0,0,Primeira_Liga,2021_2022
André Castro,POR,MF,Braga,33,1988,12.8,25,11,4,13,8,8,27,29.6,19,20,5,15,10,35,11,0,Primeira_Liga,2021_2022
Fernando Castro,BRA,GK,Arouca,24,1997,6.9,0,0,0,0,0,0,0,,0,0,0,0,0,0,4,0,Primeira_Liga,2021_2022
Tomás Castro,POR,MF,B-SAD,22,1999,0.6,4,3,2,1,1,2,5,40.0,3,0,0,0,0,4,0,0,Primeira_Liga,2021_2022
Geny Catamo,MOZ,DF,Sporting CP,20,2001,0.3,1,0,0,1,0,0,0,,0,0,0,0,1,2,0,0,Primeira_Liga,2021_2022
Geny Catamo,MOZ,"FW,MF",Vitória,20,2001,2.5,1,1,0,1,0,1,2,50.0,1,2,0,2,0,1,1,1,Primeira_Liga,2021_2022
Charles,BRA,GK,Vizela,27,1994,14.0,1,0,1,0,0,1,4,25.0,3,0,0,0,1,2,9,2,Primeira_Liga,2021_2022
Francisco Chico,POR,"MF,FW",B-SAD,23,1998,6.1,9,4,4,3,2,5,10,50.0,5,7,2,5,5,14,3,0,Primeira_Liga,2021_2022
Fábio China,POR,DF,Marítimo,29,1992,6.4,12,6,5,6,1,5,8,62.5,3,6,1,5,9,21,22,1,Primeira_Liga,2021_2022
Chiquinho,POR,FW,Estoril,21,2000,9.3,24,16,11,8,5,9,21,42.9,12,6,1,5,5,29,4,0,Primeira_Liga,2021_2022
Chiquinho,POR,"MF,FW",Braga,26,1995,2.3,0,0,0,0,0,0,3,0.0,3,1,1,0,1,1,2,0,Primeira_Liga,2021_2022
André Clóvis,BRA,FW,Estoril,23,1997,9.7,5,2,1,3,1,2,6,33.3,4,9,2,7,6,11,4,0,Primeira_Liga,2021_2022
Sebastián Coates,URU,DF,Sporting CP,30,1990,29.3,42,28,25,17,0,27,39,69.2,12,28,19,9,42,84,65,4,Primeira_Liga,2021_2022
Racine Coly,SEN,DF,Estoril,25,1995,1.9,1,1,1,0,0,0,3,0.0,3,2,0,2,0,1,3,0,Primeira_Liga,2021_2022
Francisco Conceição,POR,"MF,FW",Porto,18,2002,5.5,9,7,1,4,4,5,11,45.5,6,4,0,4,1,10,1,0,Primeira_Liga,2021_2022
Rodrigo Conceição,POR,"DF,MF",Moreirense,21,2000,4.3,11,9,8,3,0,7,14,50.0,7,1,1,0,3,14,12,0,Primeira_Liga,2021_2022
Abdu Conté,POR,"DF,MF",Moreirense,23,1998,15.3,23,10,19,4,0,12,16,75.0,4,8,2,6,7,30,18,0,Primeira_Liga,2021_2022
Jeriel Córdova,VEN,"FW,MF",Boavista,19,2002,2.3,4,4,2,1,1,1,2,50.0,1,2,0,2,0,4,1,0,Primeira_Liga,2021_2022
Jesús Corona,MEX,"DF,MF",Porto,28,1993,4.3,3,1,0,3,0,1,2,50.0,1,2,0,2,7,10,3,0,Primeira_Liga,2021_2022
Rui Filipe Cunha Correia,POR,MF,Santa Clara,26,1995,13.4,17,8,11,5,1,9,27,33.3,18,7,2,5,19,36,15,0,Primeira_Liga,2021_2022
Bruno Xavier Almeida Costa,POR,"MF,DF",Porto,24,1997,7.5,15,8,3,11,1,8,16,50.0,8,9,1,8,8,23,5,0,Primeira_Liga,2021_2022
Diogo Costa,POR,GK,Porto,21,1999,33.0,0,0,0,0,0,0,0,,0,0,0,0,0,0,8,2,Primeira_Liga,2021_2022
Edgar Costa,POR,"MF,FW",Marítimo,34,1987,14.4,21,14,6,12,3,8,20,40.0,12,10,2,8,6,27,5,1,Primeira_Liga,2021_2022
Matheus Costa,BRA,DF,Marítimo,26,1995,21.1,41,26,36,3,2,18,27,66.7,9,24,12,12,24,65,81,0,Primeira_Liga,2021_2022
Murilo Costa,BRA,"FW,MF",Gil Vicente FC,26,1994,9.4,13,5,5,7,1,6,15,40.0,9,10,0,10,8,21,7,0,Primeira_Liga,2021_2022
Diogo Costa Rodrigues,POR,MF,Portimonense,21,1999,0.1,0,0,0,0,0,0,0,,0,0,0,0,0,0,0,0,Primeira_Liga,2021_2022
Rui Costa,POR,FW,Santa Clara,25,1996,21.8,14,9,7,4,3,9,27,33.3,18,5,1,4,7,21,10,0,Primeira_Liga,2021_2022
Tomás Costa Silva,POR,"FW,MF",Vizela,21,1999,0.4,1,1,1,0,0,0,0,,0,1,0,1,2,3,0,0,Primeira_Liga,2021_2022
Vitor Costa,BRA,DF,Marítimo,27,1994,28.4,100,63,60,37,3,57,95,60.0,38,35,9,26,46,146,78,1,Primeira_Liga,2021_2022
Costinha,POR,FW,Santa Clara,28,1992,0.9,2,1,1,0,1,2,3,66.7,1,0,0,0,0,2,0,0,Primeira_Liga,2021_2022
Filipe Couto,POR,MF,Marítimo,27,1994,0.2,0,0,0,0,0,0,0,,0,0,0,0,0,0,0,0,Primeira_Liga,2021_2022
Yan Couto,BRA,"DF,MF",Braga,19,2002,20.0,31,19,19,9,3,17,35,48.6,18,29,5,24,23,54,15,0,Primeira_Liga,2021_2022
Crespo,POR,"MF,FW",Estoril,24,1996,2.9,9,4,3,6,0,4,8,50.0,4,5,2,3,2,11,2,0,Primeira_Liga,2021_2022
Sandro Cruz,ANG,DF,Benfica,20,2001,1.8,4,4,3,1,0,2,5,40.0,3,3,1,2,2,6,8,0,Primeira_Liga,2021_2022
Crysan,BRA,FW,Santa Clara,25,1996,15.9,23,17,4,13,6,11,29,37.9,18,25,4,21,7,30,13,0,Primeira_Liga,2021_2022
Lucas Cunha,BRA,DF,Gil Vicente FC,24,1997,32.0,14,8,8,6,0,9,14,64.3,5,31,24,7,29,43,124,4,Primeira_Liga,2021_2022
Sessi D'Almeida,BEN,MF,Tondela,25,1995,2.4,6,5,0,5,1,2,3,66.7,1,4,1,3,3,9,2,0,Primeira_Liga,2021_2022
Oday Dabbagh,PLE,"FW,MF",Arouca,22,1998,7.6,5,5,3,1,1,1,9,11.1,8,8,1,7,4,9,6,0,Primeira_Liga,2021_2022
Julien Dacosta,FRA,"DF,MF",Portimonense,25,1996,4.4,12,7,7,4,1,7,12,58.3,5,6,3,3,2,14,11,0,Primeira_Liga,2021_2022
Renat Dadaşov,AZE,FW,Tondela,22,1999,16.0,9,2,3,2,4,3,13,23.1,10,18,3,15,4,13,18,0,Primeira_Liga,2021_2022
Dalberson,BRA,GK,Famalicão,24,1997,2.0,0,0,0,0,0,0,1,0.0,1,0,0,0,0,0,0,0,Primeira_Liga,2021_2022
Daniel,BRA,FW,Tondela,25,1996,17.7,11,5,4,3,4,6,18,33.3,12,12,2,10,2,13,21,0,Primeira_Liga,2021_2022
Tiago Dantas,POR,MF,Tondela,20,2000,12.2,13,10,8,5,0,10,20,50.0,10,7,3,4,11,24,3,0,Primeira_Liga,2021_2022
Or Dasa,ISR,"MF,FW",Arouca,22,1998,0.6,0,0,0,0,0,0,2,0.0,2,0,0,0,0,0,1,0,Primeira_Liga,2021_2022
Hernán De La Fuente,ARG,"DF,MF",Famalicão,24,1997,10.3,19,14,9,6,4,13,28,46.4,15,14,3,11,15,34,15,0,Primeira_Liga,2021_2022
Juan Delgado,CHI,"DF,FW",Paços,28,1993,21.9,47,27,21,17,9,28,68,41.2,40,30,2,28,19,66,31,1,Primeira_Liga,2021_2022
Denílson,BRA,FW,Paços,26,1995,20.1,5,2,1,3,1,4,12,33.3,8,9,0,9,3,8,20,0,Primeira_Liga,2021_2022
Jordan van der Gaag,NED,"MF,FW",B-SAD,22,1999,2.0,4,3,3,0,1,0,4,0.0,4,2,0,2,0,4,2,0,Primeira_Liga,2021_2022
Lamine Diaby,FRA,"MF,FW",Paços,24,1996,2.5,12,6,5,7,0,6,9,66.7,3,7,2,5,10,22,10,0,Primeira_Liga,2021_2022
Luis Díaz,COL,"MF,FW",Porto,24,1997,16.6,12,5,2,6,4,5,13,38.5,8,11,0,11,4,16,6,0,Primeira_Liga,2021_2022
Marcelo Djaló,GNB,DF,Boavista,27,1993,0.6,0,0,0,0,0,0,1,0.0,1,0,0,0,0,0,2,0,Primeira_Liga,2021_2022
Matchoi Djaló,POR,"MF,FW",Paços,18,2003,7.9,12,7,2,8,2,5,14,35.7,9,9,1,8,2,14,2,0,Primeira_Liga,2021_2022
Ivan Dolček,CRO,"DF,MF",Famalicão,21,2000,2.2,5,3,3,2,0,4,5,80.0,1,0,0,0,5,10,6,0,Primeira_Liga,2021_2022
Bruno Duarte,BRA,"FW,MF",Vitória,25,1996,11.2,6,4,1,4,1,1,8,12.5,7,4,0,4,4,10,15,0,Primeira_Liga,2021_2022
Marcus Edwards,ENG,"MF,FW",Sporting CP,22,1998,5.8,5,4,1,3,1,1,8,12.5,7,4,0,4,1,6,0,0,Primeira_Liga,2021_2022
Marcus Edwards,ENG,FW,Vitória,22,1998,14.3,11,3,7,3,1,6,13,46.2,7,1,0,1,2,13,1,0,Primeira_Liga,2021_2022
Ricardo Esgaio,POR,"DF,MF",Sporting CP,28,1993,16.3,39,27,18,16,5,20,47,42.6,27,25,5,20,14,53,22,0,Primeira_Liga,2021_2022
Tiago Esgaio,POR,DF,Arouca,25,1995,10.2,13,7,7,6,0,5,14,35.7,9,18,3,15,12,25,20,0,Primeira_Liga,2021_2022
Tiago Esgaio,POR,DF,Braga,25,1995,0.8,3,2,1,2,0,1,1,100.0,0,0,0,0,1,4,0,0,Primeira_Liga,2021_2022
Dario Essugo,POR,MF,Sporting CP,16,2005,0.5,1,1,1,0,0,0,0,,0,0,0,0,4,5,0,0,Primeira_Liga,2021_2022
Gonçalo Esteves,POR,"DF,FW",Sporting CP,17,2004,1.6,3,2,2,1,0,2,2,100.0,0,2,0,2,0,3,3,0,Primeira_Liga,2021_2022
Luís Esteves,POR,MF,Vitória,23,1998,0.4,1,1,1,0,0,0,2,0.0,2,0,0,0,0,1,0,0,Primeira_Liga,2021_2022
Paulo Estrela Moreira,POR,MF,Portimonense,22,1999,0.1,0,0,0,0,0,0,0,,0,0,0,0,0,0,0,0,Primeira_Liga,2021_2022
Oscar Estupiñan,COL,FW,Vitória,24,1996,24.1,12,7,1,4,7,2,15,13.3,13,16,2,14,2,14,21,0,Primeira_Liga,2021_2022
Friday Etim,NGA,"FW,MF",Vizela,19,2002,0.2,1,0,0,0,1,0,0,,0,0,0,0,0,1,0,0,Primeira_Liga,2021_2022
Stephen Eustáquio,CAN,MF,Paços,24,1996,16.4,37,23,17,14,6,25,60,41.7,35,14,5,9,28,65,24,0,Primeira_Liga,2021_2022
Stephen Eustáquio,CAN,MF,Porto,24,1996,1.0,5,5,2,1,2,5,5,100.0,0,2,1,1,3,8,1,1,Primeira_Liga,2021_2022
Evanilson,BRA,FW,Porto,21,1999,22.5,22,17,2,9,11,6,13,46.2,7,22,1,21,5,27,13,0,Primeira_Liga,2021_2022
Ewerton,BRA,MF,Portimonense,28,1992,8.1,15,10,5,8,2,3,19,15.8,16,8,1,7,8,23,6,0,Primeira_Liga,2021_2022
Fabiano,BRA,"DF,MF",Braga,21,2000,15.8,38,25,18,14,6,21,30,70.0,9,13,3,10,23,61,40,0,Primeira_Liga,2021_2022
Miguel Falé,POR,"FW,MF",Braga,17,2004,2.8,5,1,2,3,0,3,5,60.0,2,3,0,3,0,5,0,0,Primeira_Liga,2021_2022
Zouhair Feddal,MAR,DF,Sporting CP,32,1989,11.2,10,5,8,2,0,5,11,45.5,6,8,4,4,12,22,31,0,Primeira_Liga,2021_2022
Luiz Felipe,BRA,GK,B-SAD,24,1997,32.0,0,0,0,0,0,0,0,,0,1,0,1,2,2,26,0,Primeira_Liga,2021_2022
Volnei Feltes,BRA,DF,Estoril,21,2000,1.7,0,0,0,0,0,0,1,0.0,1,5,3,2,2,2,9,0,Primeira_Liga,2021_2022
Gedson Fernandes,POR,MF,Benfica,22,1999,0.6,4,2,2,0,2,1,2,50.0,1,0,0,0,1,5,3,0,Primeira_Liga,2021_2022
Ivanildo Fernandes,CPV,DF,Vizela,25,1996,15.1,18,13,15,3,0,10,14,71.4,4,13,7,6,11,29,73,0,Primeira_Liga,2021_2022
Jorge Filipe Oliveira Fernandes,POR,DF,Vitória,24,1997,13.6,32,21,22,9,1,21,31,67.7,10,17,8,9,21,53,55,0,Primeira_Liga,2021_2022
Lucas Fernandes,BRA,MF,Portimonense,23,1997,15.8,17,7,8,8,1,7,27,25.9,20,13,2,11,12,29,4,0,Primeira_Liga,2021_2022
Ricardo Fernandes,POR,GK,Santa Clara,26,1994,5.9,0,0,0,0,0,0,1,0.0,1,0,0,0,0,0,3,1,Primeira_Liga,2021_2022
Roger Fernandes,GNB,"MF,DF",Braga,15,2005,1.3,1,0,0,1,0,0,6,0.0,6,2,0,2,2,3,2,0,Primeira_Liga,2021_2022
Rúben Fernandes,POR,DF,Gil Vicente FC,35,1986,32.8,5,3,3,2,0,3,8,37.5,5,27,24,3,30,35,124,2,Primeira_Liga,2021_2022
Fernando,BRA,FW,Porto,28,1993,0.1,0,0,0,0,0,0,0,,0,0,0,0,0,0,0,0,Primeira_Liga,2021_2022
Nahuel Ferraresi,VEN,DF,Estoril,22,1998,22.1,44,22,30,13,1,21,34,61.8,13,21,10,11,30,74,79,2,Primeira_Liga,2021_2022
André Ferreira,POR,GK,Paços,25,1996,32.0,4,2,4,0,0,4,4,100.0,0,0,0,0,1,5,14,1,Primeira_Liga,2021_2022
Filipe Ferreira,POR,"DF,MF",Boavista,30,1990,15.8,19,11,10,5,4,8,24,33.3,16,21,5,16,27,46,33,0,Primeira_Liga,2021_2022
Fernando Ferreira Fonseca,POR,DF,Paços,24,1997,16.6,28,13,12,11,5,21,39,53.8,18,8,2,6,27,55,35,0,Primeira_Liga,2021_2022
Hélder Ferreira,POR,"FW,MF",Paços,24,1997,17.5,24,13,10,7,7,13,24,54.2,11,18,3,15,11,35,16,1,Primeira_Liga,2021_2022
João Ferreira,POR,DF,Vitória,20,2001,10.9,22,13,11,9,2,10,24,41.7,14,17,7,10,17,39,36,0,Primeira_Liga,2021_2022
Joel Ferreira,POR,DF,Arouca,29,1992,0.5,0,0,0,0,0,0,0,,0,0,0,0,2,2,1,0,Primeira_Liga,2021_2022
Daniel Figueira,POR,GK,Estoril,23,1998,24.0,0,0,0,0,0,0,0,,0,0,0,0,0,0,6,2,Primeira_Liga,2021_2022
Diogo Figueiras,POR,DF,Famalicão,30,1991,14.1,40,26,19,15,6,25,46,54.3,21,18,4,14,18,58,21,0,Primeira_Liga,2021_2022
Tiago Fonseca Morais,POR,"MF,FW",Boavista,17,2003,3.4,4,1,1,2,1,1,9,11.1,8,2,0,2,3,7,0,1,Primeira_Liga,2021_2022
Rui Fonte,POR,FW,Estoril,31,1990,14.2,11,8,1,7,3,6,18,33.3,12,4,1,3,5,16,22,0,Primeira_Liga,2021_2022
Rui Fonte,POR,DF,Braga,31,1990,0.1,2,2,0,2,0,0,0,,0,1,0,1,0,2,0,0,Primeira_Liga,2021_2022
André Franco,POR,MF,Estoril,23,1998,28.0,34,19,13,15,6,15,30,50.0,15,18,2,16,16,50,30,0,Primeira_Liga,2021_2022
Gonçalo Franco,POR,MF,Moreirense,20,2000,12.7,28,17,17,7,4,7,21,33.3,14,21,2,19,16,44,8,0,Primeira_Liga,2021_2022
Fransérgio,BRA,MF,Braga,30,1990,1.6,1,1,0,1,0,0,1,0.0,1,2,1,1,1,2,1,0,Primeira_Liga,2021_2022
Žiga Frelih,SVN,GK,Gil Vicente FC,23,1998,19.0,0,0,0,0,0,0,0,,0,0,0,0,3,3,12,0,Primeira_Liga,2021_2022
Godfried Frimpong,NED,"DF,MF",Moreirense,22,1999,6.5,11,7,5,5,1,6,6,100.0,0,10,3,7,9,20,16,0,Primeira_Liga,2021_2022
Kanya Fujimoto,JPN,"MF,FW",Gil Vicente FC,22,1999,26.6,22,12,4,15,3,7,20,35.0,13,25,9,16,10,32,10,0,Primeira_Liga,2021_2022
Rodolfo Furtado,POR,GK,Santa Clara,23,1997,0.1,0,0,0,0,0,0,0,,0,0,0,0,0,0,0,0,Primeira_Liga,2021_2022
Nicolás Gaitán,ARG,MF,Paços,33,1988,3.3,8,5,3,3,2,3,11,27.3,8,0,0,0,0,8,2,0,Primeira_Liga,2021_2022
Jefferson Galego,BRA,"MF,FW",Moreirense,24,1997,1.0,3,2,1,1,1,3,4,75.0,1,3,0,3,1,4,1,0,Primeira_Liga,2021_2022
Galeno,BRA,"MF,DF",Braga,23,1997,10.6,22,14,8,11,3,13,27,48.1,14,10,1,9,9,31,9,1,Primeira_Liga,2021_2022
Galeno,BRA,"MF,FW",Porto,23,1997,3.5,3,3,0,1,2,1,5,20.0,4,6,0,6,2,5,5,0,Primeira_Liga,2021_2022
Nino Galović,CRO,DF,Arouca,29,1992,10.3,6,5,5,1,0,2,5,40.0,3,7,4,3,15,21,47,0,Primeira_Liga,2021_2022
João Gamboa,POR,MF,Estoril,24,1996,23.5,22,11,5,14,3,9,24,37.5,15,44,27,17,38,60,61,1,Primeira_Liga,2021_2022
Pedro Ganchas,POR,DF,Paços,21,2000,1.6,0,0,0,0,0,0,0,,0,0,0,0,5,5,5,0,Primeira_Liga,2021_2022
Javi García,ESP,"DF,MF",Boavista,34,1987,13.8,10,4,6,4,0,5,10,50.0,5,10,10,0,19,29,35,0,Primeira_Liga,2021_2022
Geovani,BRA,"FW,MF",Famalicão,20,2001,0.8,8,6,6,1,1,6,8,75.0,2,1,0,1,0,8,0,0,Primeira_Liga,2021_2022
Francisco Geraldes,POR,MF,Estoril,26,1995,18.2,30,14,11,12,7,19,41,46.3,22,17,3,14,14,44,10,0,Primeira_Liga,2021_2022
Gilberto,BRA,"DF,MF",Benfica,28,1993,15.0,48,30,28,14,6,33,43,76.7,10,23,3,20,20,68,30,1,Primeira_Liga,2021_2022
Henrique Gomes,POR,DF,Gil Vicente FC,25,1995,2.6,3,2,2,1,0,1,1,100.0,0,2,2,0,2,5,7,0,Primeira_Liga,2021_2022
Rodrigo Gomes,POR,"MF,DF",Braga,18,2003,8.2,13,7,7,4,2,8,16,50.0,8,11,0,11,6,19,9,0,Primeira_Liga,2021_2022
Sana Gomes,GNB,DF,Portimonense,19,2002,4.1,10,4,8,2,0,7,11,63.6,4,3,1,2,0,10,10,0,Primeira_Liga,2021_2022
Luis Gómez,COL,"MF,FW",Santa Clara,21,1999,0.7,2,0,1,0,1,1,2,50.0,1,2,1,1,0,2,0,0,Primeira_Liga,2021_2022
Nuno Gonçalo Moreira,POR,FW,Vizela,22,1999,18.8,32,17,13,15,4,11,37,29.7,26,15,2,13,20,52,15,0,Primeira_Liga,2021_2022
Diogo Gonçalves,POR,"MF,FW",Benfica,24,1997,9.6,14,11,6,5,3,6,12,50.0,6,16,1,15,5,19,4,0,Primeira_Liga,2021_2022
Ivo Gonçalves,POR,GK,Vizela,37,1984,1.0,0,0,0,0,0,0,0,,0,0,0,0,0,0,0,0,Primeira_Liga,2021_2022
Jota Gonçalves,POR,DF,Tondela,21,2000,4.1,6,3,6,0,0,5,7,71.4,2,6,2,4,3,9,18,0,Primeira_Liga,2021_2022
Pedro Gonçalves,POR,"MF,FW",Sporting CP,23,1998,22.4,29,16,10,10,9,12,41,29.3,29,15,2,13,14,43,2,0,Primeira_Liga,2021_2022
Cristian González,URU,DF,Santa Clara,25,1996,14.9,21,14,16,4,1,12,20,60.0,8,13,9,4,20,41,60,0,Primeira_Liga,2021_2022
Mario González,ESP,FW,Braga,25,1996,6.2,1,0,0,1,0,1,7,14.3,6,5,2,3,0,1,2,0,Primeira_Liga,2021_2022
Jean Gorby,FRA,MF,Braga,19,2002,2.3,5,2,3,1,1,2,5,40.0,3,2,0,2,2,7,2,0,Primeira_Liga,2021_2022
Kenji Gorré,CUW,"FW,MF",Boavista,26,1994,18.5,22,8,7,13,2,12,20,60.0,8,13,1,12,8,30,6,0,Primeira_Liga,2021_2022
Tiago Gouveia,POR,"FW,MF",Benfica,20,2001,1.0,2,1,0,2,0,1,4,25.0,3,1,0,1,2,4,1,0,Primeira_Liga,2021_2022
Álex Grimaldo,ESP,"DF,MF",Benfica,25,1995,25.8,50,36,27,17,6,28,53,52.8,25,29,6,23,29,79,35,0,Primeira_Liga,2021_2022
Marko Grujić,SRB,MF,Porto,25,1996,9.9,27,15,9,14,4,19,34,55.9,15,11,2,9,16,43,16,0,Primeira_Liga,2021_2022
Gui Guedes,POR,MF,Vitória,19,2002,0.7,3,1,2,1,0,1,3,33.3,2,2,0,2,0,3,1,0,Primeira_Liga,2021_2022
Rafik Guitane,FRA,"FW,MF",Marítimo,22,1999,21.2,19,12,7,7,5,9,22,40.9,13,20,0,20,6,25,2,0,Primeira_Liga,2021_2022
Raphael Guzzo,POR,MF,Vizela,26,1995,9.1,12,4,5,4,3,6,18,33.3,12,11,3,8,10,22,18,0,Primeira_Liga,2021_2022
Emmanuel Hackman,TOG,DF,Gil Vicente FC,26,1995,7.4,11,6,4,7,0,4,12,33.3,8,11,6,5,11,22,26,0,Primeira_Liga,2021_2022
Yanis Hamache,ALG,"MF,DF",Boavista,22,1999,20.5,35,21,20,13,2,14,33,42.4,19,25,6,19,22,57,41,1,Primeira_Liga,2021_2022
Tomás Händel,POR,MF,Vitória,20,2000,11.5,10,4,2,8,0,6,20,30.0,14,9,2,7,13,23,17,0,Primeira_Liga,2021_2022
Boubacar Hanne,POR,"FW,MF",Gil Vicente FC,22,1999,2.8,5,4,2,3,0,0,5,0.0,5,2,0,2,0,5,1,0,Primeira_Liga,2021_2022
Norbert Haymamba,CMR,GK,Arouca,22,1999,3.0,0,0,0,0,0,0,2,0.0,2,0,0,0,0,0,3,1,Primeira_Liga,2021_2022
Henrique,BRA,"FW,MF",Marítimo,27,1993,8.9,16,13,10,4,2,3,13,23.1,10,15,0,15,14,30,5,0,Primeira_Liga,2021_2022
Danny Henriques,NED,DF,B-SAD,24,1997,21.9,15,9,13,2,0,8,20,40.0,12,32,21,11,24,39,77,2,Primeira_Liga,2021_2022
Manu Hernando,ESP,DF,Tondela,23,1998,17.8,13,9,10,2,1,5,12,41.7,7,15,11,4,30,43,78,0,Primeira_Liga,2021_2022
Lukáš Horníček,CZE,GK,Braga,19,2002,1.0,0,0,0,0,0,0,0,,0,0,0,0,0,0,1,0,Primeira_Liga,2021_2022
André Horta,POR,MF,Braga,24,1996,17.4,29,14,9,14,6,11,41,26.8,30,15,2,13,7,36,4,1,Primeira_Liga,2021_2022
Ricardo Horta,POR,"FW,MF",Braga,26,1994,31.0,43,28,15,13,15,19,58,32.8,39,29,1,28,13,56,8,0,Primeira_Liga,2021_2022
Abbas Ibrahim,NGA,"MF,FW",Paços,23,1998,2.0,6,3,2,4,0,2,5,40.0,3,3,2,1,3,9,2,2,Primeira_Liga,2021_2022
Abdulwahab Ibrahim,GHA,MF,Famalicão,22,1999,0.0,0,0,0,0,0,0,0,,0,0,0,0,0,0,0,0,Primeira_Liga,2021_2022
Tiago Ilori,POR,DF,Boavista,28,1993,5.6,4,3,4,0,0,2,4,50.0,2,5,4,1,15,19,28,0,Primeira_Liga,2021_2022
Giannelli Imbula,COD,"MF,FW",Portimonense,28,1992,1.5,6,3,2,3,1,4,5,80.0,1,2,0,2,0,6,0,0,Primeira_Liga,2021_2022
Gonçalo Inácio,POR,DF,Sporting CP,19,2001,27.5,38,18,24,13,1,19,29,65.5,10,17,11,6,26,64,68,1,Primeira_Liga,2021_2022
Ismael,POR,"MF,DF",Moreirense,22,1999,4.2,3,2,2,1,0,1,5,20.0,4,3,1,2,5,8,4,0,Primeira_Liga,2021_2022
Ivan Jaime Pajuelo,ESP,"MF,FW",Famalicão,20,2000,14.0,12,6,0,8,4,5,13,38.5,8,11,1,10,11,23,5,1,Primeira_Liga,2021_2022
Nikola Jambor,CRO,MF,Moreirense,25,1995,1.1,0,0,0,0,0,0,1,0.0,1,1,0,1,1,1,0,0,Primeira_Liga,2021_2022
Nicolas Janvier,FRA,MF,Vitória,22,1998,12.1,17,13,3,12,2,11,23,47.8,12,12,2,10,11,28,10,0,Primeira_Liga,2021_2022
Jean,BRA,MF,Gil Vicente FC,26,1994,0.1,2,2,2,0,0,1,2,50.0,1,1,0,1,0,2,1,0,Primeira_Liga,2021_2022
Jefferson,BRA,MF,Moreirense,27,1994,11.0,20,15,10,9,1,11,22,50.0,11,7,1,6,11,31,7,1,Primeira_Liga,2021_2022
Jeimes,BRA,GK,Paços,20,2001,1.9,0,0,0,0,0,0,1,0.0,1,0,0,0,0,0,4,1,Primeira_Liga,2021_2022
Anderson Jesus,BRA,DF,Vizela,26,1995,17.0,13,11,11,2,0,10,19,52.6,9,18,13,5,28,41,76,1,Primeira_Liga,2021_2022
Joãozinho,POR,DF,Estoril,32,1989,32.1,47,33,27,13,7,28,46,60.9,18,36,14,22,30,77,67,0,Primeira_Liga,2021_2022
Henrique Jocú,POR,MF,Portimonense,19,2001,6.6,14,6,5,8,1,7,16,43.8,9,4,0,4,3,17,4,0,Primeira_Liga,2021_2022
Diederrick Joel,CMR,FW,Marítimo,27,1993,16.9,13,5,3,9,1,3,11,27.3,8,15,0,15,8,21,16,0,Primeira_Liga,2021_2022
Jójó,nan,DF,B-SAD,20,2001,0.5,2,0,1,1,0,0,2,0.0,2,1,1,0,1,3,2,0,Primeira_Liga,2021_2022
Igor Julião,BRA,DF,Vizela,26,1994,11.1,19,11,12,3,4,12,17,70.6,5,10,1,9,9,28,18,0,Primeira_Liga,2021_2022
Luiz Lúcio Reis Júnior,BRA,GK,Famalicão,20,2001,31.0,1,0,1,0,0,1,3,33.3,2,0,0,0,0,1,33,2,Primeira_Liga,2021_2022
Renato Junior,BRA,FW,Portimonense,19,2002,3.8,2,1,0,1,1,1,4,25.0,3,7,0,7,0,2,3,0,Primeira_Liga,2021_2022
Welinton Júnior,BRA,FW,Portimonense,28,1993,9.3,4,3,3,0,1,2,7,28.6,5,2,1,1,6,10,6,0,Primeira_Liga,2021_2022
Zainadine Júnior,MOZ,DF,Marítimo,33,1988,31.8,35,24,26,8,1,18,25,72.0,7,40,34,6,55,90,130,1,Primeira_Liga,2021_2022
Junior Kadile,FRA,"MF,FW",Famalicão,18,2002,0.5,0,0,0,0,0,0,0,,0,0,0,0,1,1,1,0,Primeira_Liga,2021_2022
Eduardo Kau,BRA,DF,B-SAD,22,1999,1.0,0,0,0,0,0,0,0,,0,1,1,0,0,0,4,1,Primeira_Liga,2021_2022
Kewin,BRA,GK,Moreirense,25,1995,15.0,1,1,1,0,0,1,1,100.0,0,0,0,0,0,1,13,1,Primeira_Liga,2021_2022
Hamidou Keyta,FRA,"FW,MF",Santa Clara,26,1994,0.8,1,0,0,0,1,0,2,0.0,2,2,0,2,0,1,1,0,Primeira_Liga,2021_2022
Naoufel Khacef,ALG,"DF,FW",Tondela,23,1997,9.6,17,10,10,5,2,9,22,40.9,13,4,0,4,14,31,16,0,Primeira_Liga,2021_2022
Kobamelo Kodisang,RSA,FW,Braga,21,1999,0.2,0,0,0,0,0,0,0,,0,0,0,0,0,0,0,0,Primeira_Liga,2021_2022
Philippe Koffi,CIV,FW,Paços,19,2002,0.3,0,0,0,0,0,0,0,,0,0,0,0,0,0,0,0,Primeira_Liga,2021_2022
Koffi Kouao,CIV,DF,Vizela,23,1998,21.0,57,39,41,11,5,35,53,66.0,18,12,1,11,39,96,47,0,Primeira_Liga,2021_2022
Eboue Kouassi,CIV,MF,Arouca,23,1997,16.3,20,11,8,12,0,11,20,55.0,9,12,4,8,12,32,30,1,Primeira_Liga,2021_2022
Stanislav Kritsyuk,RUS,GK,Gil Vicente FC,30,1990,4.0,0,0,0,0,0,0,0,,0,0,0,0,0,0,2,0,Primeira_Liga,2021_2022
Matías Lacava,VEN,"FW,MF",Tondela,18,2002,0.2,4,4,3,1,0,2,2,100.0,0,0,0,0,2,6,0,0,Primeira_Liga,2021_2022
Derik Lacerda,BRA,"FW,MF",Moreirense,21,1999,8.7,20,14,9,6,5,6,15,40.0,9,12,2,10,7,27,8,0,Primeira_Liga,2021_2022
Rúben Lameiras,POR,"FW,MF",Vitória,26,1994,17.0,20,11,10,8,2,13,28,46.4,15,15,0,15,5,25,6,0,Primeira_Liga,2021_2022
Achraf Lazaar,MAR,DF,Portimonense,29,1992,2.7,7,6,6,0,1,3,7,42.9,4,2,1,1,5,12,14,0,Primeira_Liga,2021_2022
Valentino Lazaro,AUT,"DF,MF",Benfica,25,1996,11.4,13,9,4,7,2,8,17,47.1,9,17,2,15,11,24,14,0,Primeira_Liga,2021_2022
Antoine Léautey,FRA,FW,Gil Vicente FC,25,1996,16.2,14,9,2,9,3,5,15,33.3,10,12,0,12,10,24,1,0,Primeira_Liga,2021_2022
Diogo Leite,POR,DF,Braga,22,1999,20.6,29,20,17,11,1,16,26,61.5,10,30,15,15,31,60,70,1,Primeira_Liga,2021_2022
Helton Leite,BRA,GK,Benfica,30,1990,2.0,0,0,0,0,0,0,0,,0,0,0,0,0,0,2,0,Primeira_Liga,2021_2022
André Filipe Rio Liberal,POR,FW,Gil Vicente FC,18,2002,0.1,0,0,0,0,0,0,0,,0,1,0,1,0,0,0,0,Primeira_Liga,2021_2022
Licá,POR,"FW,DF",B-SAD,32,1988,4.6,3,1,1,1,1,1,7,14.3,6,5,0,5,3,6,3,0,Primeira_Liga,2021_2022
Nuno Lima,POR,DF,Paços,20,2001,10.8,20,11,17,3,0,15,28,53.6,13,16,10,6,13,33,44,1,Primeira_Liga,2021_2022
Rúben Lima,POR,"DF,MF",Famalicão,31,1989,6.1,12,5,6,6,0,3,7,42.9,4,3,1,2,13,25,17,0,Primeira_Liga,2021_2022
Lincoln,BRA,MF,Santa Clara,22,1998,30.5,30,20,11,18,1,14,36,38.9,22,29,3,26,14,44,26,2,Primeira_Liga,2021_2022
Samuel Lino,BRA,"FW,MF",Gil Vicente FC,21,1999,32.9,74,44,37,22,15,35,97,36.1,62,56,3,53,26,100,25,0,Primeira_Liga,2021_2022
Danny Loader,ENG,FW,Porto,20,2000,0.1,0,0,0,0,0,0,0,,0,0,0,0,0,0,0,0,Primeira_Liga,2021_2022
André Lopes,POR,DF,B-SAD,19,2001,1.0,0,0,0,0,0,0,0,,0,0,0,0,0,0,2,0,Primeira_Liga,2021_2022
Bruno Lourenço,POR,"FW,MF",Estoril,23,1998,12.7,8,3,2,4,2,5,22,22.7,17,3,0,3,3,11,10,1,Primeira_Liga,2021_2022
André Luis,BRA,"FW,MF",Moreirense,27,1994,14.8,8,5,0,4,4,2,13,15.4,11,15,1,14,2,10,17,0,Primeira_Liga,2021_2022
Andrija Luković,SRB,MF,B-SAD,26,1994,9.9,14,7,5,7,2,6,17,35.3,11,8,4,4,14,28,10,0,Primeira_Liga,2021_2022
Luquinha,BRA,"MF,FW",Portimonense,20,2000,6.1,9,6,4,3,2,5,17,29.4,12,8,0,8,3,12,0,0,Primeira_Liga,2021_2022
Rúben Macedo,POR,"FW,DF",Marítimo,25,1996,0.7,2,2,2,0,0,0,1,0.0,1,0,0,0,0,2,1,0,Primeira_Liga,2021_2022
Miguel Maga,POR,DF,Vitória,18,2002,12.0,28,18,15,10,3,17,32,53.1,15,16,2,14,19,47,18,0,Primeira_Liga,2021_2022
Gaius Makouta,CGO,MF,Boavista,24,1997,28.0,45,27,20,22,3,21,46,45.7,25,18,4,14,35,80,31,1,Primeira_Liga,2021_2022
Pedro Malheiro,POR,"MF,DF",Boavista,20,2001,9.9,27,14,20,4,3,19,29,65.5,10,13,0,13,30,57,16,0,Primeira_Liga,2021_2022
Wilson Manafá,POR,DF,Porto,27,1994,2.9,6,3,3,2,1,4,6,66.7,2,3,1,2,2,8,7,0,Primeira_Liga,2021_2022
Sori Mané,GNB,MF,Moreirense,25,1996,5.5,9,5,3,5,1,7,17,41.2,10,4,1,3,4,13,11,0,Primeira_Liga,2021_2022
Mansur,BRA,DF,Santa Clara,28,1993,22.1,34,18,27,5,2,20,36,55.6,16,27,8,19,37,71,62,1,Primeira_Liga,2021_2022
Juan Manuel Boselli,URU,"FW,MF",Tondela,21,1999,9.5,10,7,5,3,2,3,9,33.3,6,10,1,9,3,13,6,0,Primeira_Liga,2021_2022
José Manuel Velázquez,VEN,DF,Arouca,30,1990,4.0,7,2,5,2,0,5,9,55.6,4,4,0,4,11,18,17,0,Primeira_Liga,2021_2022
Maracás,BRA,DF,Paços,27,1994,23.0,34,21,28,6,0,17,36,47.2,19,34,19,15,53,87,108,0,Primeira_Liga,2021_2022
Iván Marcano,ESP,DF,Porto,34,1987,7.3,9,7,6,2,1,4,6,66.7,2,3,3,0,10,19,22,0,Primeira_Liga,2021_2022
Marcelo,BRA,"FW,MF",Gil Vicente FC,24,1997,0.1,0,0,0,0,0,0,0,,0,0,0,0,0,0,0,0,Primeira_Liga,2021_2022
Agustín Marchesín,ARG,GK,Porto,33,1988,0.0,0,0,0,0,0,0,0,,0,0,0,0,0,0,0,0,Primeira_Liga,2021_2022
Abraham Marcus,NGA,FW,Portimonense,21,2000,0.9,0,0,0,0,0,0,1,0.0,1,2,0,2,1,1,2,0,Primeira_Liga,2021_2022
Adrián Marín,ESP,"DF,MF",Famalicão,24,1997,25.5,39,22,18,14,7,19,25,76.0,6,17,8,9,42,81,60,3,Primeira_Liga,2021_2022
João Mário,POR,MF,Benfica,28,1993,19.3,38,22,12,18,8,17,33,51.5,16,12,3,9,15,53,2,1,Primeira_Liga,2021_2022
João Mário Lopes,POR,DF,Porto,21,2000,22.9,41,28,16,21,4,26,60,43.3,34,25,1,24,28,69,23,0,Primeira_Liga,2021_2022
Pedro David Rosendo Marques,POR,"FW,MF",Famalicão,23,1998,3.5,1,1,1,0,0,1,3,33.3,2,3,0,3,0,1,1,0,Primeira_Liga,2021_2022
José Marsà,ESP,DF,Sporting CP,19,2002,0.1,0,0,0,0,0,0,0,,0,0,0,0,0,0,0,0,Primeira_Liga,2021_2022
Toni Martínez,ESP,FW,Porto,24,1997,5.3,3,1,0,2,1,1,3,33.3,2,5,0,5,0,3,5,0,Primeira_Liga,2021_2022
Fábio Martins,POR,"MF,FW",Braga,28,1993,4.6,6,3,2,4,0,1,7,14.3,6,4,0,4,2,8,5,0,Primeira_Liga,2021_2022
Rafael Martins,BRA,FW,Moreirense,32,1989,26.6,14,9,4,8,2,7,17,41.2,10,14,2,12,2,16,21,0,Primeira_Liga,2021_2022
Matheus,BRA,GK,Braga,29,1992,32.0,1,0,1,0,0,1,3,33.3,2,0,0,0,1,2,15,1,Primeira_Liga,2021_2022
Yan Matheus,BRA,"FW,MF",Moreirense,22,1998,19.8,48,30,16,26,6,18,52,34.6,34,24,2,22,13,61,8,0,Primeira_Liga,2021_2022
Ricardo Matos,POR,"FW,MF",Portimonense,21,2000,2.5,1,0,1,0,0,0,0,,0,0,0,0,1,2,3,0,Primeira_Liga,2021_2022
Nor Maviram,NGA,DF,Vizela,20,2001,0.3,1,1,1,0,0,0,0,,0,0,0,0,1,2,1,0,Primeira_Liga,2021_2022
Chancel Mbemba,COD,DF,Porto,26,1994,30.9,25,15,16,8,1,13,17,76.5,4,16,11,5,25,50,83,1,Primeira_Liga,2021_2022
Jordi Mboula,ESP,"FW,MF",Estoril,22,1999,10.7,11,4,5,5,1,3,13,23.1,10,11,3,8,8,19,2,1,Primeira_Liga,2021_2022
Iuri Medeiros,POR,"MF,FW",Braga,27,1994,15.8,17,13,1,10,6,3,15,20.0,12,20,3,17,8,25,0,0,Primeira_Liga,2021_2022
Soualiho Meïté,FRA,MF,Benfica,27,1994,9.8,14,5,1,10,3,6,13,46.2,7,10,5,5,13,27,8,0,Primeira_Liga,2021_2022
Francisco Meixedo,POR,GK,Porto,20,2001,0.0,0,0,0,0,0,0,0,,0,0,0,0,0,0,0,0,Primeira_Liga,2021_2022
Tiago Melo Almeida,POR,"DF,MF",Tondela,19,2001,20.6,43,28,22,19,2,24,37,64.9,13,16,6,10,26,69,45,0,Primeira_Liga,2021_2022
Diogo Mendes,CPV,MF,Marítimo,23,1998,20.4,41,22,12,23,6,14,40,35.0,26,27,7,20,27,68,17,1,Primeira_Liga,2021_2022
Edmilson Mendes,GNB,"FW,MF",Paços,18,2003,0.2,0,0,0,0,0,0,0,,0,0,0,0,0,0,0,0,Primeira_Liga,2021_2022
Nuno Mendes,POR,DF,Sporting CP,19,2002,1.3,3,2,0,2,1,2,4,50.0,2,1,0,1,1,4,1,0,Primeira_Liga,2021_2022
Alex Mendez,USA,"MF,FW",Vizela,20,2000,16.2,27,12,12,12,3,10,26,38.5,16,5,1,4,13,40,9,0,Primeira_Liga,2021_2022
Ryotaro Meshino,JPN,"FW,MF",Estoril,23,1998,1.3,3,1,2,1,0,1,4,25.0,3,1,0,1,0,3,0,0,Primeira_Liga,2021_2022
Fabrício dos Santos Messias,BRA,"FW,MF",Portimonense,31,1990,14.8,10,7,3,5,2,3,10,30.0,7,9,2,7,2,12,12,0,Primeira_Liga,2021_2022
João Miguel,POR,DF,Porto,21,2000,0.1,0,0,0,0,0,0,1,0.0,1,0,0,0,0,0,0,0,Primeira_Liga,2021_2022
Milson,ANG,MF,Marítimo,21,1999,0.2,2,1,0,1,1,0,0,,0,0,0,0,0,2,0,0,Primeira_Liga,2021_2022
Lucas Mineiro,BRA,MF,Braga,25,1996,6.2,10,5,0,9,1,3,10,30.0,7,8,1,7,2,12,9,0,Primeira_Liga,2021_2022
Kevin Mirallas,BEL,"FW,MF",Moreirense,33,1987,3.3,3,1,1,2,0,0,2,0.0,2,1,0,1,1,4,0,0,Primeira_Liga,2021_2022
Mohammad Mohebbi,IRN,"FW,MF",Santa Clara,22,1998,5.0,9,8,4,3,2,3,7,42.9,4,3,2,1,3,12,4,0,Primeira_Liga,2021_2022
João Monteiro,POR,MF,B-SAD,20,2001,1.0,1,1,1,0,0,1,1,100.0,0,0,0,0,0,1,1,0,Primeira_Liga,2021_2022
António Montez,POR,MF,B-SAD,19,2001,1.0,1,1,1,0,0,1,1,100.0,0,1,1,0,0,1,7,0,Primeira_Liga,2021_2022
Morato,BRA,DF,Benfica,20,2001,11.2,14,10,5,6,3,8,15,53.3,7,18,13,5,8,22,34,0,Primeira_Liga,2021_2022
Diego Moreira,POR,FW,Benfica,16,2004,0.3,0,0,0,0,0,0,0,,0,0,0,0,1,1,0,0,Primeira_Liga,2021_2022
Pedro Filipe Barbosa Moreira,POR,MF,Gil Vicente FC,28,1992,32.0,68,38,22,37,9,25,63,39.7,38,23,5,18,28,96,22,2,Primeira_Liga,2021_2022
Hidemasa Morita,JPN,MF,Santa Clara,26,1995,25.3,38,18,14,23,1,16,37,43.2,21,27,5,22,45,83,34,0,Primeira_Liga,2021_2022
Mosquito,BRA,GK,Estoril,25,1996,10.0,0,0,0,0,0,0,0,,0,0,0,0,0,0,2,2,Primeira_Liga,2021_2022
Luís Mota,POR,"FW,MF",B-SAD,17,2003,1.2,2,1,0,1,1,0,2,0.0,2,2,0,2,2,4,0,0,Primeira_Liga,2021_2022
Fahd Moufi,MAR,DF,Portimonense,25,1996,30.6,35,24,20,8,7,16,32,50.0,16,50,22,28,51,86,66,1,Primeira_Liga,2021_2022
Moura,POR,"DF,MF",Braga,21,1999,16.5,26,19,11,11,4,13,28,46.4,15,25,1,24,18,44,32,0,Primeira_Liga,2021_2022
Abdul Mumin,GHA,DF,Vitória,23,1998,24.7,34,25,20,13,1,17,24,70.8,7,23,17,6,34,68,100,1,Primeira_Liga,2021_2022
Simone Muratore,ITA,MF,Tondela,23,1998,0.3,2,2,0,2,0,2,3,66.7,1,1,1,0,0,2,2,0,Primeira_Liga,2021_2022
Jhon Murillo,VEN,FW,Tondela,25,1995,11.9,12,8,8,1,3,4,14,28.6,10,6,0,6,2,14,6,1,Primeira_Liga,2021_2022
Petar Musa,CRO,FW,Boavista,23,1998,25.7,14,10,2,7,5,8,18,44.4,10,16,3,13,4,18,35,0,Primeira_Liga,2021_2022
Almoatasem Al Musrati,LBY,MF,Braga,25,1996,28.5,63,34,22,33,8,23,50,46.0,27,26,9,17,43,106,28,1,Primeira_Liga,2021_2022
Herculano Nabian,POR,FW,Vitória,17,2004,0.7,0,0,0,0,0,0,0,,0,0,0,0,0,0,0,0,Primeira_Liga,2021_2022
Shoya Nakajima,JPN,"MF,FW",Portimonense,26,1994,19.6,20,11,5,11,4,7,19,36.8,12,7,2,5,4,24,2,0,Primeira_Liga,2021_2022
Kosuke Nakamura,JPN,GK,Portimonense,26,1995,2.0,0,0,0,0,0,0,0,,0,0,0,0,0,0,1,0,Primeira_Liga,2021_2022
Manuel Namora,POR,"MF,DF",Boavista,23,1998,0.2,0,0,0,0,0,0,2,0.0,2,0,0,0,2,2,0,0,Primeira_Liga,2021_2022
Bruno Nascimento,BRA,"FW,MF",Famalicão,24,1997,21.7,35,21,15,11,9,18,40,45.0,22,30,0,30,16,51,14,0,Primeira_Liga,2021_2022
Nathan,BRA,"DF,MF",Boavista,19,2001,25.8,59,38,30,22,7,30,68,44.1,38,19,4,15,25,84,50,0,Primeira_Liga,2021_2022
Fran Navarro,ESP,FW,Gil Vicente FC,23,1998,28.9,19,8,6,9,4,4,28,14.3,24,21,1,20,4,23,15,0,Primeira_Liga,2021_2022
Flávio Nazinho,POR,"DF,MF",Sporting CP,18,2003,1.1,0,0,0,0,0,0,1,0.0,1,1,0,1,0,0,0,0,Primeira_Liga,2021_2022
Alioune Ndour,SEN,FW,B-SAD,20,2001,9.2,6,3,0,3,3,3,5,60.0,2,5,1,4,2,8,4,0,Primeira_Liga,2021_2022
Christian Neiva Afonso,POR,DF,Vizela,26,1994,19.9,49,36,31,15,3,31,49,63.3,18,23,7,16,32,81,58,1,Primeira_Liga,2021_2022
Nelson,ANG,"FW,MF",Vitória,23,1998,3.8,6,4,4,2,0,0,0,,0,6,0,6,2,8,2,0,Primeira_Liga,2021_2022
Wellington Nem,BRA,DF,Arouca,29,1992,0.0,0,0,0,0,0,0,0,,0,0,0,0,0,0,0,0,Primeira_Liga,2021_2022
João Neto,BRA,"MF,FW",Famalicão,18,2003,0.7,1,1,1,0,0,1,1,100.0,0,0,0,0,0,1,0,0,Primeira_Liga,2021_2022
Luís Neto,POR,DF,Sporting CP,33,1988,15.5,27,18,20,7,0,14,27,51.9,13,11,6,5,23,50,40,0,Primeira_Liga,2021_2022
Martim Neto,POR,MF,Benfica,18,2003,0.2,0,0,0,0,0,0,0,,0,0,0,0,0,0,0,0,Primeira_Liga,2021_2022
Babacar Niasse,MTN,GK,Tondela,24,1996,5.1,0,0,0,0,0,0,0,,0,0,0,0,0,0,6,0,Primeira_Liga,2021_2022
Payam Niazmand,IRN,GK,Portimonense,26,1995,2.0,0,0,0,0,0,0,0,,0,0,0,0,0,0,1,1,Primeira_Liga,2021_2022
Yusupha Njie,GAM,"FW,MF",Boavista,27,1994,17.4,17,8,4,12,1,6,31,19.4,25,23,1,22,4,21,15,0,Primeira_Liga,2021_2022
Paul-Georges Ntep,CMR,"FW,MF",Boavista,29,1992,5.6,5,4,1,2,2,2,8,25.0,6,9,2,7,1,6,4,0,Primeira_Liga,2021_2022
Arsénio Martins Lafuente Nunes,POR,"FW,MF",Arouca,31,1989,24.3,26,17,5,16,5,10,32,31.3,22,17,2,15,14,40,12,0,Primeira_Liga,2021_2022
Matheus Nunes,POR,MF,Sporting CP,22,1998,28.4,42,23,17,21,4,15,38,39.5,23,23,2,21,29,71,22,1,Primeira_Liga,2021_2022
Darwin Núñez,URU,"FW,MF",Benfica,22,1999,22.0,14,7,5,5,4,3,10,30.0,7,13,5,8,5,19,15,0,Primeira_Liga,2021_2022
Pedro Nuno,POR,"MF,FW",B-SAD,26,1995,15.8,13,8,3,5,5,2,16,12.5,14,16,4,12,8,21,8,0,Primeira_Liga,2021_2022
Lawrence Ofori,GHA,MF,Famalicão,23,1998,1.7,4,2,1,1,2,3,7,42.9,4,0,0,0,4,8,0,0,Primeira_Liga,2021_2022
Richard Ofori,GHA,DF,Vizela,28,1993,19.0,40,27,32,6,2,22,47,46.8,25,15,2,13,44,84,38,1,Primeira_Liga,2021_2022
Thales Oleques,BRA,DF,Arouca,27,1994,30.2,68,43,29,34,5,44,81,54.3,37,40,11,29,50,118,71,1,Primeira_Liga,2021_2022
Hugo Oliveira,POR,DF,Vizela,19,2002,0.1,0,0,0,0,0,0,0,,0,0,0,0,0,0,0,0,Primeira_Liga,2021_2022
Paulo Oliveira,POR,DF,Braga,29,1992,26.1,35,24,25,10,0,15,30,50.0,15,23,11,12,53,88,104,1,Primeira_Liga,2021_2022
Rúben Alexandre Gomes Oliveira,POR,"MF,FW",Santa Clara,26,1994,2.1,6,3,1,4,1,3,5,60.0,2,4,1,3,0,6,3,0,Primeira_Liga,2021_2022
Sérgio Oliveira,POR,MF,Porto,29,1992,4.4,19,14,4,10,5,7,21,33.3,14,5,1,4,4,23,3,0,Primeira_Liga,2021_2022
Nicolás Otamendi,ARG,DF,Benfica,33,1988,27.4,54,31,42,10,2,35,55,63.6,20,24,11,13,59,113,70,1,Primeira_Liga,2021_2022
Otávio,POR,"MF,FW",Porto,26,1995,29.5,100,60,22,46,32,42,85,49.4,43,32,3,29,21,121,16,0,Primeira_Liga,2021_2022
João Othavio Basso,BRA,DF,Arouca,24,1997,32.5,61,45,43,14,4,35,49,71.4,14,26,12,14,44,105,147,0,Primeira_Liga,2021_2022
Pablo,BRA,FW,Famalicão,17,2004,2.0,5,2,1,1,3,3,4,75.0,1,2,0,2,0,5,2,0,Primeira_Liga,2021_2022
Fábio Pacheco,POR,MF,Moreirense,33,1988,20.6,61,30,26,30,5,26,66,39.4,40,33,9,24,34,95,42,1,Primeira_Liga,2021_2022
João Palhinha,POR,MF,Sporting CP,26,1995,20.8,81,46,22,52,7,33,57,57.9,24,33,3,30,28,109,25,0,Primeira_Liga,2021_2022
Mateus Pasinato,BRA,GK,Moreirense,29,1992,19.0,1,1,1,0,0,0,1,0.0,1,0,0,0,0,1,10,3,Primeira_Liga,2021_2022
Jean Patric,BRA,"FW,MF",Santa Clara,24,1997,6.3,3,2,1,1,1,2,8,25.0,6,8,0,8,4,7,3,0,Primeira_Liga,2021_2022
Patrick,BRA,DF,Estoril,24,1997,11.5,21,12,14,5,2,14,19,73.7,5,21,18,3,13,34,46,1,Primeira_Liga,2021_2022
Patrick,BRA,MF,Santa Clara,22,1998,0.0,0,0,0,0,0,0,1,0.0,1,0,0,0,0,0,0,0,Primeira_Liga,2021_2022
Paulinho,POR,"FW,MF",Sporting CP,28,1992,26.4,21,11,1,12,8,5,15,33.3,10,24,2,22,3,24,25,0,Primeira_Liga,2021_2022
André Paulo,POR,GK,Sporting CP,24,1996,0.1,0,0,0,0,0,0,0,,0,0,0,0,0,0,0,0,Primeira_Liga,2021_2022
Marcos Paulo,BRA,"FW,MF",Famalicão,20,2001,7.6,7,5,2,5,0,0,9,0.0,9,6,0,6,5,12,3,0,Primeira_Liga,2021_2022
Marcos Paulo,BRA,MF,Vizela,33,1988,18.8,32,17,12,17,3,15,39,38.5,24,10,6,4,14,46,34,0,Primeira_Liga,2021_2022
Pedrão,BRA,DF,Portimonense,24,1997,27.8,38,19,22,15,1,18,29,62.1,11,36,27,9,53,91,101,0,Primeira_Liga,2021_2022
João Pedro,POR,MF,Tondela,28,1993,21.3,39,25,20,16,3,21,51,41.2,30,14,4,10,23,62,19,0,Primeira_Liga,2021_2022
Pedro Pelágio,POR,MF,Marítimo,21,2000,11.1,33,21,16,16,1,12,35,34.3,23,10,3,7,13,46,18,0,Primeira_Liga,2021_2022
Alexandre Penetra,POR,DF,Famalicão,19,2001,28.9,42,29,25,15,2,28,43,65.1,15,15,9,6,68,110,105,0,Primeira_Liga,2021_2022
Pepe,POR,DF,Porto,38,1983,19.9,15,14,9,5,1,7,15,46.7,8,11,4,7,26,41,41,0,Primeira_Liga,2021_2022
Pepê,BRA,"MF,DF",Porto,24,1997,15.1,25,11,12,8,5,12,33,36.4,21,10,0,10,14,39,9,0,Primeira_Liga,2021_2022
Francisco Pereira,POR,MF,Boavista,19,2002,0.0,0,0,0,0,0,0,0,,0,0,0,0,0,0,0,0,Primeira_Liga,2021_2022
Marco André Rocha Pereira,POR,GK,Santa Clara,34,1987,28.0,0,0,0,0,0,0,0,,0,0,0,0,0,0,5,2,Primeira_Liga,2021_2022
Sebastián Pérez Cardona,COL,MF,Boavista,28,1993,25.1,61,31,36,21,4,27,56,48.2,29,35,7,28,35,96,22,0,Primeira_Liga,2021_2022
Luiz Phellype,BRA,FW,Santa Clara,27,1993,3.1,3,2,0,2,1,0,1,0.0,1,3,1,2,0,3,6,0,Primeira_Liga,2021_2022
Thibang Phete,RSA,"MF,DF",B-SAD,27,1994,20.5,34,14,15,15,4,12,30,40.0,18,21,9,12,23,57,61,0,Primeira_Liga,2021_2022
Lucas Piazon,BRA,"MF,FW",Braga,27,1994,4.0,6,4,0,5,1,2,12,16.7,10,8,2,6,1,7,0,0,Primeira_Liga,2021_2022
Charles Pickel,COD,MF,Famalicão,24,1997,26.3,50,29,25,20,5,29,76,38.2,47,39,3,36,37,87,37,0,Primeira_Liga,2021_2022
Rodrigo Pinho,BRA,FW,Benfica,30,1991,0.9,0,0,0,0,0,0,0,,0,0,0,0,0,0,0,0,Primeira_Liga,2021_2022
Dinis Pinto,POR,MF,Braga,20,2000,0.3,0,0,0,0,0,0,0,,0,0,0,0,0,0,0,0,Primeira_Liga,2021_2022
Felipe Pires,BRA,"FW,MF",Moreirense,26,1995,12.9,10,6,3,6,1,5,20,25.0,15,7,0,7,2,12,3,1,Primeira_Liga,2021_2022
Rui Pires,POR,MF,Paços,23,1998,13.4,32,18,9,17,6,16,39,41.0,23,19,4,15,14,46,17,0,Primeira_Liga,2021_2022
Pité,POR,MF,Arouca,26,1994,10.8,31,18,13,15,3,17,33,51.5,16,19,0,19,5,36,5,1,Primeira_Liga,2021_2022
Pizzi,POR,"MF,FW",Benfica,31,1989,3.6,1,0,0,0,1,1,8,12.5,7,2,0,2,1,2,1,0,Primeira_Liga,2021_2022
Jackson Porozo,ECU,DF,Boavista,20,2000,23.8,38,28,28,10,0,16,22,72.7,6,26,16,10,37,75,97,0,Primeira_Liga,2021_2022
Pedro Porro,ESP,"DF,MF",Sporting CP,21,1999,18.2,41,25,18,17,6,18,51,35.3,33,22,2,20,25,66,24,0,Primeira_Liga,2021_2022
Samuel Portugal,BRA,GK,Portimonense,27,1994,30.0,0,0,0,0,0,0,2,0.0,2,0,0,0,0,0,16,2,Primeira_Liga,2021_2022
Lucas Possignolo,POR,DF,Portimonense,27,1994,22.9,28,16,17,9,2,14,29,48.3,15,22,16,6,53,81,89,1,Primeira_Liga,2021_2022
Quaresma,BRA,DF,Arouca,24,1996,27.0,48,33,26,19,3,32,57,56.1,25,24,9,15,42,90,36,1,Primeira_Liga,2021_2022
Eduardo Quaresma,POR,DF,Tondela,19,2002,17.1,41,28,27,12,2,23,33,69.7,10,16,6,10,20,61,64,0,Primeira_Liga,2021_2022
Ricardo Quaresma,POR,"FW,MF",Vitória,37,1983,10.9,8,4,1,3,4,4,9,44.4,5,4,0,4,0,8,5,0,Primeira_Liga,2021_2022
Diogo Queirós,POR,DF,Famalicão,22,1999,0.0,0,0,0,0,0,0,0,,0,0,0,0,0,0,2,0,Primeira_Liga,2021_2022
Nemanja Radonjić,SRB,"DF,MF",Benfica,25,1996,1.5,3,1,2,1,0,1,2,50.0,1,0,0,0,0,3,2,0,Primeira_Liga,2021_2022
Álvaro Ramalho,POR,GK,B-SAD,22,1999,2.0,0,0,0,0,0,0,0,,0,0,0,0,0,0,3,0,Primeira_Liga,2021_2022
Cláudio Ramos,POR,GK,Porto,29,1991,1.0,0,0,0,0,0,0,0,,0,0,0,0,0,0,0,0,Primeira_Liga,2021_2022
Flávio Ramos,BRA,DF,Paços,27,1994,8.7,5,3,3,1,1,3,8,37.5,5,12,10,2,11,16,34,1,Primeira_Liga,2021_2022
Gonçalo Ramos,POR,"FW,MF",Benfica,20,2001,17.9,16,10,6,9,1,4,16,25.0,12,14,1,13,5,21,13,0,Primeira_Liga,2021_2022
Rafael Ramos,POR,DF,Santa Clara,26,1995,20.7,44,27,32,10,2,20,33,60.6,13,15,1,14,28,72,54,0,Primeira_Liga,2021_2022
Osama Rashid,IRQ,MF,Vizela,29,1992,6.5,11,6,3,6,2,4,14,28.6,10,2,0,2,7,18,5,0,Primeira_Liga,2021_2022
Bruno Reis,POR,MF,Portimonense,22,1999,0.7,2,2,1,1,0,1,3,33.3,2,0,0,0,0,2,0,0,Primeira_Liga,2021_2022
Matheus Reis,BRA,DF,Sporting CP,26,1995,23.0,28,19,14,12,2,18,27,66.7,9,26,7,19,23,51,41,0,Primeira_Liga,2021_2022
Miguel Reisinho,POR,"FW,MF",Boavista,22,1999,0.5,2,2,1,1,0,2,4,50.0,2,0,0,0,1,3,3,0,Primeira_Liga,2021_2022
Filipe Relvas,POR,DF,Portimonense,21,1999,17.9,18,14,11,7,0,13,18,72.2,5,26,16,10,34,52,65,0,Primeira_Liga,2021_2022
Tomás Reymão,POR,MF,Boavista,23,1998,3.8,10,5,4,5,1,5,12,41.7,7,2,0,2,8,18,6,0,Primeira_Liga,2021_2022
Eduardo Ribeiro,POR,MF,Braga,20,2001,0.0,0,0,0,0,0,0,0,,0,0,0,0,0,0,0,0,Primeira_Liga,2021_2022
Henrique Ribeiro,POR,DF,B-SAD,19,2002,1.0,0,0,0,0,0,0,1,0.0,1,0,0,0,2,2,5,0,Primeira_Liga,2021_2022
Rodrigo Ribeiro,POR,FW,Sporting CP,16,2005,0.5,0,0,0,0,0,0,1,0.0,1,0,0,0,1,1,0,0,Primeira_Liga,2021_2022
Tomás Ribeiro,POR,DF,B-SAD,22,1999,17.0,19,8,13,5,1,11,19,57.9,8,25,15,10,27,46,88,1,Primeira_Liga,2021_2022
Ricardinho,BRA,FW,Marítimo,20,2001,5.1,7,4,2,4,1,1,8,12.5,7,7,2,5,1,8,6,0,Primeira_Liga,2021_2022
Ricardinho,POR,"FW,MF",Santa Clara,22,1998,24.0,31,18,15,13,3,22,56,39.3,34,24,3,21,13,44,16,0,Primeira_Liga,2021_2022
André Ricardo,POR,"FW,MF",Famalicão,20,2000,0.8,1,1,0,1,0,1,2,50.0,1,1,0,1,1,2,0,0,Primeira_Liga,2021_2022
Riccieli,BRA,DF,Famalicão,22,1998,24.2,32,19,23,9,0,21,33,63.6,12,29,22,7,36,68,133,2,Primeira_Liga,2021_2022
Rochinha,POR,"FW,MF",Vitória,26,1995,21.7,21,16,6,6,9,5,28,17.9,23,8,0,8,11,32,12,1,Primeira_Liga,2021_2022
Bruno Rodrigues,POR,DF,Braga,20,2001,6.4,6,5,3,3,0,3,4,75.0,1,2,1,1,7,13,25,0,Primeira_Liga,2021_2022
Ivo Rodrigues,POR,"FW,MF",Famalicão,26,1995,20.7,42,24,12,25,5,21,44,47.7,23,21,3,18,17,59,14,0,Primeira_Liga,2021_2022
Pedro Rodrigues,POR,MF,Famalicão,24,1997,30.6,57,32,28,24,5,28,71,39.4,43,33,7,26,26,83,23,0,Primeira_Liga,2021_2022
Julio Romão,BRA,"MF,DF",Santa Clara,23,1998,4.0,28,16,11,14,3,10,13,76.9,3,7,3,4,2,30,4,0,Primeira_Liga,2021_2022
Lazar Rosić,SRB,DF,Moreirense,28,1993,28.0,26,10,18,8,0,15,27,55.6,12,28,24,4,36,62,112,1,Primeira_Liga,2021_2022
Loreintz Rosier,FRA,MF,Estoril,22,1998,25.5,65,33,37,21,7,32,55,58.2,23,26,8,18,30,95,60,2,Primeira_Liga,2021_2022
Iván Rossi,ARG,MF,Marítimo,27,1993,19.1,62,30,21,33,8,19,45,42.2,26,29,12,17,32,94,35,0,Primeira_Liga,2021_2022
Abel Ruiz,ESP,"FW,MF",Braga,21,2000,15.4,2,0,0,1,1,2,12,16.7,10,7,2,5,3,5,5,0,Primeira_Liga,2021_2022
Alan Ruiz,ARG,MF,Arouca,27,1993,5.2,4,3,1,3,0,1,5,20.0,4,3,1,2,1,5,5,0,Primeira_Liga,2021_2022
Leonardo Ruíz,COL,FW,Estoril,25,1996,9.7,7,3,4,3,0,1,9,11.1,8,8,2,6,3,10,8,1,Primeira_Liga,2021_2022
Helder Sá,POR,DF,Vitória,18,2002,5.6,10,6,5,4,1,5,9,55.6,4,9,3,6,9,19,14,1,Primeira_Liga,2021_2022
Pedro Sá,POR,MF,Portimonense,27,1993,12.0,28,18,16,12,0,17,37,45.9,20,21,7,14,12,40,37,0,Primeira_Liga,2021_2022
Tiago Sá,POR,GK,Braga,26,1995,1.0,1,0,1,0,0,1,1,100.0,0,0,0,0,0,1,0,0,Primeira_Liga,2021_2022
Falaye Sacko,MLI,DF,Vitória,26,1995,10.3,10,7,3,5,2,9,17,52.9,8,8,3,5,13,23,23,0,Primeira_Liga,2021_2022
Jorge Sáenz,ESP,DF,Marítimo,24,1996,4.4,5,4,1,4,0,1,4,25.0,3,6,2,4,10,15,10,0,Primeira_Liga,2021_2022
Safira,BRA,FW,B-SAD,26,1995,16.1,13,6,2,8,3,4,20,20.0,16,17,3,14,4,17,19,0,Primeira_Liga,2021_2022
Pierre Sagna,SEN,DF,Santa Clara,30,1990,11.5,16,10,10,4,2,9,11,81.8,2,12,3,9,25,41,26,1,Primeira_Liga,2021_2022
Modibo Sagnan,MLI,DF,Tondela,22,1999,25.0,58,39,44,11,3,34,47,72.3,13,29,18,11,24,82,116,1,Primeira_Liga,2021_2022
Braima Sambú,POR,MF,B-SAD,20,2001,7.9,16,6,9,4,3,13,24,54.2,11,12,2,10,11,27,13,0,Primeira_Liga,2021_2022
Samu,POR,MF,Vizela,25,1996,27.4,66,36,25,25,16,32,73,43.8,41,48,12,36,38,104,42,0,Primeira_Liga,2021_2022
Sandro,BRA,"MF,FW",B-SAD,32,1989,0.8,6,4,4,2,0,4,6,66.7,2,1,0,1,4,10,4,0,Primeira_Liga,2021_2022
Elder Santana,BRA,"FW,MF",Gil Vicente FC,28,1993,3.7,2,2,0,1,1,0,3,0.0,3,5,2,3,1,3,8,0,Primeira_Liga,2021_2022
Adílio Santos,BRA,FW,Arouca,28,1993,1.7,4,2,2,1,1,1,5,20.0,4,3,0,3,0,4,2,0,Primeira_Liga,2021_2022
Jeferson Santos,BRA,MF,Portimonense,29,1992,0.2,0,0,0,0,0,0,1,0.0,1,0,0,0,1,1,1,0,Primeira_Liga,2021_2022
Luís Santos,POR,"MF,DF",Boavista,21,2000,6.2,18,12,9,5,4,10,18,55.6,8,3,0,3,2,20,14,1,Primeira_Liga,2021_2022
Nuno Santos,POR,"DF,MF",Sporting CP,26,1995,23.4,34,22,17,13,4,15,36,41.7,21,9,2,7,28,62,21,1,Primeira_Liga,2021_2022
Nuno Santos,POR,"MF,FW",Paços,22,1999,25.9,19,9,4,11,4,7,47,14.9,40,19,1,18,25,44,23,0,Primeira_Liga,2021_2022
Pablo Santos,BRA,DF,Moreirense,29,1992,13.6,24,15,18,4,2,14,28,50.0,14,9,4,5,27,51,73,1,Primeira_Liga,2021_2022
Rafael Santos,POR,MF,B-SAD,24,1997,1.1,1,1,0,1,0,0,1,0.0,1,1,0,1,0,1,0,0,Primeira_Liga,2021_2022
Zaidu Sanusi,NGA,DF,Porto,24,1997,19.0,31,17,16,7,8,19,41,46.3,22,17,4,13,29,60,21,0,Primeira_Liga,2021_2022
Adewele Sapara,NGA,"MF,DF",Portimonense,26,1995,0.6,1,1,0,1,0,0,0,,0,0,0,0,0,1,1,0,Primeira_Liga,2021_2022
Pablo Sarabia,ESP,"MF,FW",Sporting CP,29,1992,23.0,12,2,5,4,3,4,24,16.7,20,23,1,22,4,16,4,0,Primeira_Liga,2021_2022
Andrés Sarmiento,COL,FW,Vizela,23,1998,1.6,2,1,2,0,0,1,4,25.0,3,0,0,0,0,2,0,0,Primeira_Liga,2021_2022
Gustavo Sauer,BRA,"FW,MF",Boavista,28,1993,25.5,36,23,17,16,3,18,65,27.7,47,28,4,24,9,45,9,0,Primeira_Liga,2021_2022
Guilherme Schettine,BRA,FW,Vizela,25,1995,16.9,10,9,2,4,4,4,10,40.0,6,17,2,15,6,16,7,0,Primeira_Liga,2021_2022
Schürrle,POR,FW,Braga,19,2001,0.1,0,0,0,0,0,0,0,,0,0,0,0,0,0,0,0,Primeira_Liga,2021_2022
Haris Seferović,SUI,FW,Benfica,29,1992,4.4,1,0,0,0,1,0,2,0.0,2,2,0,2,0,1,3,1,Primeira_Liga,2021_2022
Alfa Semedo,GNB,MF,Vitória,23,1997,16.4,42,27,16,20,6,18,42,42.9,24,14,4,10,27,69,28,1,Primeira_Liga,2021_2022
Rúben Semedo,POR,DF,Porto,27,1994,0.1,0,0,0,0,0,0,0,,0,0,0,0,0,0,0,0,Primeira_Liga,2021_2022
Nuno Sequeira,POR,DF,Braga,30,1990,4.9,6,4,3,2,1,4,11,36.4,7,4,3,1,8,14,9,0,Primeira_Liga,2021_2022
Paulo Sérgio Mota,POR,"DF,MF",Moreirense,30,1991,25.7,23,16,14,8,1,12,26,46.2,14,23,6,17,16,39,52,0,Primeira_Liga,2021_2022
André Silva,BRA,FW,Arouca,24,1997,28.1,16,7,1,8,7,6,20,30.0,14,10,0,10,10,26,17,0,Primeira_Liga,2021_2022
Benny Silva,POR,DF,Famalicão,20,2001,0.0,0,0,0,0,0,0,0,,0,0,0,0,0,0,1,0,Primeira_Liga,2021_2022
Diogo Silva,BRA,DF,Gil Vicente FC,26,1995,2.5,1,1,1,0,0,0,2,0.0,2,2,2,0,1,2,8,0,Primeira_Liga,2021_2022
João Miguel Macedo Silva,POR,GK,Marítimo,26,1995,4.0,0,0,0,0,0,0,0,,0,0,0,0,0,0,6,0,Primeira_Liga,2021_2022
João Pedro Sousa Silva,GNB,"FW,MF",Paços,24,1996,5.6,1,1,0,1,0,0,3,0.0,3,3,2,1,0,1,5,0,Primeira_Liga,2021_2022
Jorge Fernando Santos Silva,POR,DF,Paços,25,1996,4.5,9,4,7,1,1,6,9,66.7,3,7,3,4,3,12,15,0,Primeira_Liga,2021_2022
Leandro Miguel Pereira Silva,POR,MF,Arouca,27,1994,24.4,34,21,14,12,8,21,48,43.8,27,29,1,28,27,61,42,1,Primeira_Liga,2021_2022
Lucas Silva,BRA,"FW,MF",Paços,23,1998,21.1,16,8,10,4,2,6,28,21.4,22,21,0,21,15,31,17,0,Primeira_Liga,2021_2022
Matheus Silva,BRA,"DF,MF",Moreirense,23,1997,5.3,6,2,4,1,1,2,4,50.0,2,4,2,2,5,11,22,0,Primeira_Liga,2021_2022
Pedro Manuel da Silva Moreira,POR,MF,Arouca,32,1989,19.1,27,19,7,18,2,10,28,35.7,18,16,5,11,23,50,21,0,Primeira_Liga,2021_2022
Pedro José Moreira Silva,POR,GK,Vizela,24,1997,18.0,1,1,1,0,0,1,1,100.0,0,1,0,1,0,1,12,3,Primeira_Liga,2021_2022
Rafa Silva,POR,"MF,FW",Benfica,28,1993,22.6,25,18,8,12,5,9,25,36.0,16,20,1,19,13,38,4,0,Primeira_Liga,2021_2022
Raul Silva,BRA,DF,Estoril,31,1989,5.6,9,6,8,1,0,6,13,46.2,7,11,6,5,5,14,19,0,Primeira_Liga,2021_2022
Raul Silva,BRA,DF,Braga,31,1989,5.7,3,2,1,2,0,3,5,60.0,2,1,0,1,8,11,16,0,Primeira_Liga,2021_2022
Tiago Silva,POR,MF,Vitória,28,1993,21.9,33,23,9,16,8,16,44,36.4,28,21,0,21,22,55,7,0,Primeira_Liga,2021_2022
Sílvio,POR,DF,Vitória,33,1987,0.3,0,0,0,0,0,0,0,,0,0,0,0,0,0,0,0,Primeira_Liga,2021_2022
David Simão,POR,MF,Arouca,31,1990,12.5,24,16,12,11,1,14,28,50.0,14,11,4,7,9,33,5,0,Primeira_Liga,2021_2022
Sphephelo Sithole,RSA,MF,B-SAD,22,1999,16.6,21,16,6,15,0,11,35,31.4,24,23,8,15,18,39,21,0,Primeira_Liga,2021_2022
Islam Slimani,ALG,FW,Sporting CP,33,1988,4.8,2,1,0,1,1,0,3,0.0,3,3,1,2,2,4,3,0,Primeira_Liga,2021_2022
Everton Soares,BRA,"MF,FW",Benfica,25,1996,17.8,42,27,16,19,7,15,32,46.9,17,25,2,23,9,51,2,1,Primeira_Liga,2021_2022
Filipe Soares,POR,MF,Moreirense,22,1999,11.2,16,8,4,8,4,5,27,18.5,22,11,2,9,13,29,6,0,Primeira_Liga,2021_2022
Marco Soares,CPV,"FW,MF",Arouca,37,1984,0.4,0,0,0,0,0,0,0,,0,0,0,0,0,0,1,0,Primeira_Liga,2021_2022
Rafa Soares,POR,DF,Vitória,26,1995,28.2,40,24,27,11,2,26,41,63.4,15,22,6,16,33,73,52,1,Primeira_Liga,2021_2022
Tim Söderström,SWE,DF,Marítimo,27,1994,0.8,2,1,0,1,1,1,1,100.0,0,0,0,0,2,4,2,0,Primeira_Liga,2021_2022
Carles Soria,ESP,DF,Estoril,24,1996,20.2,25,14,11,10,4,19,31,61.3,12,19,6,13,23,48,40,0,Primeira_Liga,2021_2022
Afonso Sousa,POR,"MF,FW",B-SAD,21,2000,25.1,38,24,18,13,7,22,56,39.3,34,13,1,12,24,62,8,0,Primeira_Liga,2021_2022
César Sousa,ANG,MF,B-SAD,21,2000,5.4,24,15,14,8,2,13,34,38.2,21,10,1,9,11,35,5,0,Primeira_Liga,2021_2022
Miguel Sousa,POR,MF,Marítimo,22,1998,3.1,3,2,0,2,1,0,1,0.0,1,4,0,4,0,3,2,0,Primeira_Liga,2021_2022
Claudemir de Souza,BRA,MF,Vizela,33,1988,22.3,27,15,10,13,4,14,39,35.9,25,21,8,13,27,54,52,1,Primeira_Liga,2021_2022
Adel Taarabt,MAR,MF,Benfica,32,1989,9.6,16,10,9,5,2,13,25,52.0,12,12,3,9,7,23,4,0,Primeira_Liga,2021_2022
Bruno Tabata,BRA,"FW,MF",Sporting CP,24,1997,4.5,16,11,8,6,2,6,11,54.5,5,4,0,4,3,19,2,0,Primeira_Liga,2021_2022
Kyosuke Tagawa,JPN,"FW,MF",Santa Clara,22,1999,5.4,1,0,0,1,0,0,1,0.0,1,0,0,0,0,1,0,0,Primeira_Liga,2021_2022
Afonso Taira,POR,MF,B-SAD,29,1992,0.2,0,0,0,0,0,0,0,,0,0,0,0,1,1,0,0,Primeira_Liga,2021_2022
Talocha,POR,DF,Gil Vicente FC,31,1989,30.9,28,18,11,15,2,11,20,55.0,9,17,10,7,29,57,95,0,Primeira_Liga,2021_2022
Douglas Tanque,BRA,FW,Paços,27,1993,1.6,1,0,0,0,1,0,1,0.0,1,3,0,3,0,1,2,0,Primeira_Liga,2021_2022
Mehdi Taremi,IRN,FW,Porto,29,1992,26.9,11,2,3,4,4,5,27,18.5,22,29,0,29,14,25,17,1,Primeira_Liga,2021_2022
David Tavares,CPV,MF,Famalicão,22,1999,5.0,13,5,7,5,1,7,15,46.7,8,3,2,1,3,16,4,0,Primeira_Liga,2021_2022
Heriberto Tavares,POR,"FW,MF",Famalicão,24,1997,8.4,15,11,6,5,4,7,22,31.8,15,13,2,11,6,21,11,0,Primeira_Liga,2021_2022
Yohan Tavares,POR,DF,B-SAD,33,1988,28.0,44,26,36,6,2,23,37,62.2,14,38,23,15,31,75,97,1,Primeira_Liga,2021_2022
André Teles,POR,MF,Marítimo,24,1997,1.2,1,1,0,0,1,0,0,,0,0,0,0,0,1,1,0,Primeira_Liga,2021_2022
Guo Tianyu,CHN,FW,Vizela,22,1999,0.4,0,0,0,0,0,0,0,,0,0,0,0,1,1,0,0,Primeira_Liga,2021_2022
Tiago Tomás,POR,"MF,FW",Sporting CP,19,2002,1.9,3,2,0,3,0,1,5,20.0,4,7,0,7,2,5,0,0,Primeira_Liga,2021_2022
Vítor Tormena,BRA,DF,Braga,25,1996,20.7,13,9,6,7,0,9,20,45.0,11,16,9,7,28,41,65,2,Primeira_Liga,2021_2022
Pedro Trigueira,POR,GK,Tondela,33,1988,28.9,1,0,1,0,0,1,3,33.3,2,2,0,2,1,2,17,2,Primeira_Liga,2021_2022
Matouš Trmal,CZE,GK,Vitória,22,1998,9.0,0,0,0,0,0,0,0,,0,0,0,0,1,1,5,1,Primeira_Liga,2021_2022
Manuel Ugarte Ribeiro,URU,MF,Sporting CP,20,2001,12.3,45,24,10,28,7,24,56,42.9,32,27,0,27,29,74,8,0,Primeira_Liga,2021_2022
Zé Uilton,BRA,"FW,DF",Paços,29,1992,21.0,23,12,10,9,4,11,27,40.7,16,10,1,9,22,45,26,0,Primeira_Liga,2021_2022
Iker Undabarrena,ESP,MF,Tondela,26,1995,22.3,40,28,22,14,4,26,54,48.1,28,26,6,20,35,75,27,1,Primeira_Liga,2021_2022
Mateus Uribe,COL,MF,Porto,30,1991,22.1,64,41,25,36,3,26,61,42.6,35,16,4,12,35,99,28,0,Primeira_Liga,2021_2022
Eugeni Valderrama,ESP,MF,Arouca,27,1994,5.9,12,5,3,9,0,6,13,46.2,7,5,1,4,6,18,0,0,Primeira_Liga,2021_2022
Rodrigo Valente,POR,"MF,FW",Estoril,20,2001,0.5,1,1,0,1,0,0,0,,0,0,0,0,1,2,1,0,Primeira_Liga,2021_2022
Bruno Varela,CPV,GK,Vitória,26,1994,25.0,1,0,1,0,0,1,2,50.0,1,0,0,0,1,2,16,0,Primeira_Liga,2021_2022
Nilton Varela,POR,"DF,MF",B-SAD,20,2001,8.7,18,12,12,6,0,8,18,44.4,10,19,2,17,15,33,9,0,Primeira_Liga,2021_2022
Luciano Vega,ARG,MF,Estoril,22,1999,1.2,3,3,1,2,0,1,3,33.3,2,1,0,1,1,4,2,0,Primeira_Liga,2021_2022
Igor Vekič,SVN,GK,Paços,23,1998,0.0,0,0,0,0,0,0,0,,0,0,0,0,0,0,0,0,Primeira_Liga,2021_2022
Calvin Verdonk,IDN,FW,Famalicão,24,1997,0.2,0,0,0,0,0,0,0,,0,0,0,0,0,0,0,0,Primeira_Liga,2021_2022
Lucas Veríssimo,BRA,DF,Benfica,26,1995,9.3,16,9,6,8,2,12,20,60.0,8,7,5,2,17,33,29,0,Primeira_Liga,2021_2022
Jan Vertonghen,BEL,DF,Benfica,34,1987,27.6,33,21,14,14,5,16,30,53.3,14,21,16,5,33,66,76,0,Primeira_Liga,2021_2022
Paulo Victor Vidotti,BRA,GK,Marítimo,34,1987,30.0,0,0,0,0,0,0,1,0.0,1,0,0,0,1,1,17,2,Primeira_Liga,2021_2022
André Vidigal,POR,"FW,MF",Marítimo,22,1998,23.9,28,16,10,14,4,8,20,40.0,12,17,0,17,9,37,15,1,Primeira_Liga,2021_2022
Fabio Vieira,POR,"MF,FW",Porto,21,2000,14.8,19,14,1,13,5,10,20,50.0,10,10,0,10,10,29,7,0,Primeira_Liga,2021_2022
Mikel Villanueva,VEN,DF,Santa Clara,28,1993,19.8,22,17,16,6,0,16,26,61.5,10,18,14,4,35,57,80,2,Primeira_Liga,2021_2022
Rúben Vinagre,POR,"DF,MF",Sporting CP,22,1999,6.0,13,9,5,5,3,4,10,40.0,6,4,0,4,6,19,7,0,Primeira_Liga,2021_2022
Carlos Vinícius,BRA,FW,Benfica,26,1995,0.1,0,0,0,0,0,0,0,,0,0,0,0,0,0,0,0,Primeira_Liga,2021_2022
João Virgínia,POR,GK,Sporting CP,21,1999,0.9,0,0,0,0,0,0,0,,0,0,0,0,0,0,0,0,Primeira_Liga,2021_2022
Bernardo Vital,POR,DF,Estoril,20,2000,15.4,6,4,3,3,0,4,9,44.4,5,26,23,3,10,16,58,0,Primeira_Liga,2021_2022
Vitinha,POR,FW,Braga,21,2000,16.4,19,12,1,9,9,4,16,25.0,12,13,4,9,7,26,19,0,Primeira_Liga,2021_2022
Vitinha,POR,MF,Porto,21,2000,25.0,49,30,11,28,10,23,41,56.1,18,25,4,21,36,85,14,1,Primeira_Liga,2021_2022
Steven Vitória,CAN,DF,Moreirense,34,1987,15.8,12,7,7,4,1,5,10,50.0,5,16,9,7,11,23,74,0,Primeira_Liga,2021_2022
Odisseas Vlachodimos,GRE,GK,Benfica,27,1994,32.0,1,1,1,0,0,1,3,33.3,2,0,0,0,0,1,10,1,Primeira_Liga,2021_2022
Ilija Vukotić,MNE,MF,Boavista,22,1999,9.0,14,5,6,8,0,5,15,33.3,10,10,7,3,6,20,11,0,Primeira_Liga,2021_2022
Luca Waldschmidt,GER,"FW,MF",Benfica,25,1996,1.6,3,2,0,3,0,0,0,,0,2,0,2,0,3,1,0,Primeira_Liga,2021_2022
Walterson,BRA,"FW,MF",Moreirense,26,1994,15.8,36,23,12,16,8,12,41,29.3,29,15,1,14,16,52,9,0,Primeira_Liga,2021_2022
Julian Weigl,GER,MF,Benfica,25,1995,26.8,57,36,16,36,5,31,48,64.6,17,34,7,27,40,97,47,1,Primeira_Liga,2021_2022
Wendell,BRA,DF,Porto,28,1993,10.6,31,18,11,13,7,17,27,63.0,10,14,2,12,13,44,19,0,Primeira_Liga,2021_2022
Willyan,BRA,"DF,MF",Portimonense,26,1995,23.7,53,30,33,17,3,25,40,62.5,15,27,15,12,47,100,105,0,Primeira_Liga,2021_2022
Bruno Wilson,POR,DF,Vizela,24,1996,15.8,16,11,10,6,0,8,13,61.5,5,19,14,5,23,39,56,0,Primeira_Liga,2021_2022
Cláudio Winck,BRA,DF,Marítimo,27,1994,28.6,59,40,28,26,5,38,73,52.1,35,36,10,26,27,86,63,0,Primeira_Liga,2021_2022
Xadas,POR,"MF,FW",Marítimo,23,1997,14.6,21,14,7,13,1,12,25,48.0,13,15,2,13,4,25,2,0,Primeira_Liga,2021_2022
António Xavier,POR,"FW,MF",Estoril,29,1992,7.2,6,6,1,4,1,3,13,23.1,10,6,0,6,7,13,3,0,Primeira_Liga,2021_2022
Roman Yaremchuk,UKR,FW,Benfica,25,1995,11.9,5,3,0,4,1,2,5,40.0,3,3,0,3,0,5,5,0,Primeira_Liga,2021_2022
Hugues Zagbayou,CIV,MF,Vizela,31,1990,4.3,9,5,1,8,0,3,6,50.0,3,5,1,4,6,15,2,0,Primeira_Liga,2021_2022
Ivan Zlobin,RUS,GK,Famalicão,24,1997,1.0,0,0,0,0,0,0,0,,0,0,0,0,0,0,1,0,Primeira_Liga,2021_2022
Kévin Zohi,MLI,FW,Vizela,24,1996,9.2,10,6,5,5,0,2,9,22.2,7,10,0,10,5,15,11,0,Primeira_Liga,2021_2022
Emilijus Zubas,LTU,GK,Arouca,31,1990,1.0,0,0,0,0,0,0,0,,0,0,0,0,0,0,0,0,Primeira_Liga,2021_2022
Max Aarons,ENG,DF,Norwich City,21,2000,32.0,64,44,49,15,0,37,55,67.3,18,39,19,20,28,92,96,1,Premier_League,2021_2022
Che Adams,SCO,FW,Southampton,25,1996,22.7,13,6,5,5,3,2,16,12.5,14,18,2,16,8,21,18,0,Premier_League,2021_2022
Rayan Aït-Nouri,ALG,"DF,MF",Wolves,20,2001,20.3,64,36,46,15,3,22,44,50.0,22,24,2,22,22,86,39,1,Premier_League,2021_2022
Kristoffer Ajer,NOR,DF,Brentford,23,1998,22.2,29,18,21,6,2,13,21,61.9,8,19,11,8,26,55,74,0,Premier_League,2021_2022
Nathan Aké,NED,DF,Manchester City,26,1995,10.3,16,9,7,8,1,6,8,75.0,2,7,5,2,8,24,23,0,Premier_League,2021_2022
Marc Albrighton,ENG,"FW,DF",Leicester City,31,1989,12.6,31,19,16,9,6,10,47,21.3,37,15,3,12,14,45,20,0,Premier_League,2021_2022
Thiago Alcántara,ESP,MF,Liverpool,30,1991,17.0,48,29,14,24,10,10,42,23.8,32,22,2,20,26,74,13,2,Premier_League,2021_2022
Trent Alexander-Arnold,ENG,DF,Liverpool,22,1998,31.7,40,23,19,13,8,27,60,45.0,33,22,4,18,43,83,40,0,Premier_League,2021_2022
Alisson,BRA,GK,Liverpool,28,1992,36.0,3,1,3,0,0,3,5,60.0,2,1,0,1,0,3,28,1,Premier_League,2021_2022
Allan,BRA,MF,Everton,30,1991,24.3,74,44,28,39,7,34,105,32.4,71,40,9,31,23,97,39,1,Premier_League,2021_2022
Dele Alli,ENG,MF,Tottenham,25,1996,7.3,14,8,10,3,1,5,17,29.4,12,22,5,17,6,20,16,0,Premier_League,2021_2022
Dele Alli,ENG,"MF,FW",Everton,25,1996,3.8,7,2,3,4,0,0,4,0.0,4,7,2,5,6,13,10,0,Premier_League,2021_2022
Miguel Almirón,PAR,"MF,FW",Newcastle Utd,27,1994,19.1,47,29,23,17,7,11,44,25.0,33,14,1,13,20,67,13,0,Premier_League,2021_2022
Marcos Alonso,ESP,DF,Chelsea,30,1990,24.1,41,29,20,12,9,17,36,47.2,19,29,5,24,43,84,53,0,Premier_League,2021_2022
Steven Alzate,COL,MF,Brighton,22,1998,4.5,10,4,4,5,1,4,7,57.1,3,2,1,1,10,20,10,0,Premier_League,2021_2022
Daniel Amartey,GHA,DF,Leicester City,26,1994,23.6,26,13,19,7,0,19,29,65.5,10,30,22,8,21,47,93,4,Premier_League,2021_2022
Joachim Andersen,DEN,DF,Crystal Palace,25,1996,32.4,30,23,21,9,0,16,27,59.3,11,29,19,10,37,67,125,3,Premier_League,2021_2022
Michail Antonio,JAM,FW,West Ham,31,1990,33.0,23,17,5,9,9,7,18,38.9,11,19,1,18,3,26,13,0,Premier_League,2021_2022
Cameron Archer,ENG,"FW,MF",Aston Villa,20,2001,0.3,0,0,0,0,0,0,0,,0,0,0,0,0,0,0,0,Premier_League,2021_2022
Alphonse Areola,FRA,GK,West Ham,28,1993,1.0,0,0,0,0,0,0,0,,0,0,0,0,0,0,1,0,Premier_League,2021_2022
Adam Armstrong,ENG,FW,Southampton,24,1997,15.7,10,4,2,2,6,0,6,0.0,6,13,1,12,3,13,6,0,Premier_League,2021_2022
Stuart Armstrong,SCO,MF,Southampton,29,1992,16.4,27,19,15,6,6,9,23,39.1,14,10,1,9,8,35,15,0,Premier_League,2021_2022
Kepa Arrizabalaga,ESP,GK,Chelsea,26,1994,4.0,0,0,0,0,0,0,0,,0,0,0,0,0,0,4,0,Premier_League,2021_2022
Harrison Ashby,SCO,DF,West Ham,19,2001,0.1,0,0,0,0,0,0,0,,0,1,0,1,1,1,1,0,Premier_League,2021_2022
Pierre-Emerick Aubameyang,GAB,FW,Arsenal,32,1989,11.5,11,5,6,4,1,3,10,30.0,7,12,1,11,0,11,4,0,Premier_League,2021_2022
Jordan Ayew,GHA,FW,Crystal Palace,29,1991,22.4,47,30,20,20,7,17,31,54.8,14,33,3,30,15,62,15,0,Premier_League,2021_2022
Luke Ayling,ENG,DF,Leeds United,29,1991,25.2,74,42,46,23,5,51,97,52.6,46,46,25,21,28,102,52,1,Premier_League,2021_2022
César Azpilicueta,ESP,DF,Chelsea,31,1989,23.0,51,28,18,27,6,16,35,45.7,19,32,9,23,23,74,65,1,Premier_League,2021_2022
Daniel Bachmann,AUT,GK,Watford,27,1994,12.0,0,0,0,0,0,0,0,,0,0,0,0,1,1,5,0,Premier_League,2021_2022
Leon Bailey,JAM,"FW,MF",Aston Villa,23,1997,8.5,17,11,6,8,3,6,13,46.2,7,10,1,9,1,18,2,0,Premier_League,2021_2022
Eric Bailly,CIV,DF,Manchester Utd,27,1994,2.4,5,4,4,0,1,3,4,75.0,1,4,2,2,3,8,11,0,Premier_League,2021_2022
Folarin Balogun,USA,FW,Arsenal,20,2001,0.8,1,1,0,0,1,0,0,,0,1,0,1,0,1,1,0,Premier_League,2021_2022
Patrick Bamford,ENG,FW,Leeds United,27,1993,6.2,1,0,0,1,0,0,3,0.0,3,8,2,6,2,3,8,0,Premier_League,2021_2022
Shandon Baptiste,GRN,MF,Brentford,23,1998,10.1,14,4,9,4,1,6,15,40.0,9,10,0,10,11,25,12,0,Premier_League,2021_2022
Ross Barkley,ENG,"MF,FW",Chelsea,27,1993,2.0,0,0,0,0,0,0,1,0.0,1,1,0,1,1,1,0,0,Premier_League,2021_2022
Ashley Barnes,ENG,FW,Burnley,31,1989,9.0,11,2,2,7,2,2,9,22.2,7,8,1,7,2,13,5,0,Premier_League,2021_2022
Harvey Barnes,ENG,"FW,MF",Leicester City,23,1997,23.3,31,16,9,11,11,7,23,30.4,16,24,1,23,5,36,7,0,Premier_League,2021_2022
Lewis Bate,ENG,MF,Leeds United,18,2002,1.6,1,0,0,0,1,0,8,0.0,8,1,0,1,1,2,1,0,Premier_League,2021_2022
Mads Bech Sørensen,DEN,DF,Brentford,22,1999,9.3,8,7,6,2,0,6,7,85.7,1,9,6,3,6,14,25,0,Premier_League,2021_2022
Jan Bednarek,POL,DF,Southampton,25,1996,29.2,32,15,18,13,1,19,33,57.6,14,48,27,21,72,104,141,0,Premier_League,2021_2022
Donny van de Beek,NED,MF,Manchester Utd,24,1997,0.8,6,4,4,1,1,1,2,50.0,1,5,1,4,2,8,1,0,Premier_League,2021_2022
Donny van de Beek,NED,MF,Everton,24,1997,5.4,15,7,8,6,1,6,13,46.2,7,6,2,4,6,21,4,0,Premier_League,2021_2022
Asmir Begović,BIH,GK,Everton,34,1987,3.0,0,0,0,0,0,0,0,,0,0,0,0,0,0,3,0,Premier_League,2021_2022
Saïd Benrahma,ALG,"FW,MF",West Ham,25,1995,24.1,28,17,16,9,3,15,38,39.5,23,17,1,16,9,37,8,0,Premier_League,2021_2022
Rodrigo Bentancur,URU,MF,Tottenham,24,1997,15.1,36,18,14,14,8,16,32,50.0,16,24,9,15,20,56,35,0,Premier_League,2021_2022
Christian Benteke,BEL,FW,Crystal Palace,30,1990,12.7,3,2,1,2,0,2,6,33.3,4,7,3,4,2,5,33,0,Premier_League,2021_2022
Jóhann Berg Guðmundsson,ISL,MF,Burnley,30,1990,12.2,16,6,7,7,2,5,20,25.0,15,11,2,9,12,28,22,0,Premier_League,2021_2022
Steven Bergwijn,NED,"FW,MF",Tottenham,23,1997,6.3,3,2,2,1,0,1,10,10.0,9,3,0,3,1,4,8,0,Premier_League,2021_2022
Ryan Bertrand,ENG,DF,Leicester City,31,1989,3.7,8,5,3,4,1,2,5,40.0,3,8,3,5,1,9,7,0,Premier_League,2021_2022
Mads Bidstrup,DEN,MF,Brentford,20,2001,0.5,1,0,0,1,0,0,3,0.0,3,0,0,0,1,2,2,0,Premier_League,2021_2022
Yves Bissouma,MLI,MF,Brighton,24,1996,23.5,76,49,35,37,4,21,37,56.8,16,33,3,30,50,126,49,0,Premier_League,2021_2022
Willy Boly,CIV,DF,Wolves,30,1991,10.0,25,19,18,7,0,8,15,53.3,7,14,6,8,14,39,35,0,Premier_League,2021_2022
Jarrod Bowen,ENG,FW,West Ham,24,1996,33.1,36,20,20,11,5,17,44,38.6,27,29,2,27,21,57,14,0,Premier_League,2021_2022
Jarrad Branthwaite,ENG,DF,Everton,19,2002,4.3,4,1,3,1,0,3,8,37.5,5,3,2,1,1,5,20,0,Premier_League,2021_2022
Armando Broja,ALB,FW,Southampton,19,2001,21.9,12,5,2,7,3,2,9,22.2,7,17,1,16,3,15,11,0,Premier_League,2021_2022
Josh Brownhill,ENG,MF,Burnley,25,1995,32.8,73,37,25,42,6,21,53,39.6,32,37,12,25,68,141,42,1,Premier_League,2021_2022
Lewis Brunt,ENG,MF,Leicester City,20,2000,0.3,0,0,0,0,0,0,0,,0,1,0,1,0,0,0,0,Premier_League,2021_2022
Emi Buendía,ARG,"MF,FW",Aston Villa,24,1996,21.1,38,18,16,13,9,21,51,41.2,30,21,3,18,9,47,11,0,Premier_League,2021_2022
Dan Burn,ENG,DF,Newcastle Utd,29,1992,16.0,16,11,11,4,1,7,11,63.6,4,22,14,8,20,36,101,0,Premier_League,2021_2022
Dan Burn,ENG,DF,Brighton,29,1992,11.4,22,12,13,8,1,6,15,40.0,9,14,10,4,24,46,51,0,Premier_League,2021_2022
Jack Butland,ENG,GK,Crystal Palace,28,1993,8.5,0,0,0,0,0,0,0,,0,0,0,0,0,0,1,0,Premier_League,2021_2022
Sam Byram,ENG,DF,Norwich City,27,1993,11.4,24,15,17,6,1,19,27,70.4,8,21,11,10,22,46,48,0,Premier_League,2021_2022
Willy Caballero,ARG,GK,Southampton,39,1981,2.0,0,0,0,0,0,0,0,,0,0,0,0,0,0,2,1,Premier_League,2021_2022
Moisés Caicedo,ECU,MF,Brighton,19,2001,7.3,16,10,7,7,2,5,12,41.7,7,18,4,14,10,26,7,0,Premier_League,2021_2022
Dominic Calvert-Lewin,ENG,FW,Everton,24,1997,14.3,11,8,1,6,4,3,8,37.5,5,5,2,3,3,14,12,0,Premier_League,2021_2022
Chem Campbell,WAL,MF,Wolves,18,2002,0.1,1,1,0,1,0,0,0,,0,0,0,0,0,1,0,0,Premier_League,2021_2022
João Cancelo,POR,DF,Manchester City,27,1994,35.9,83,54,33,35,15,46,91,50.5,45,25,3,22,59,142,45,1,Premier_League,2021_2022
Sergi Canós,ESP,"DF,FW",Brentford,24,1997,23.1,56,25,32,15,9,33,60,55.0,27,32,3,29,22,78,38,0,Premier_League,2021_2022
Todd Cantwell,ENG,"FW,MF",Norwich City,23,1998,4.9,15,13,8,6,1,6,17,35.3,11,2,0,2,3,18,2,0,Premier_League,2021_2022
Matty Cash,POL,DF,Aston Villa,23,1997,37.5,89,50,52,34,3,47,78,60.3,31,54,16,38,49,138,100,2,Premier_League,2021_2022
Timothy Castagne,BEL,DF,Leicester City,25,1995,23.6,67,31,38,22,7,27,43,62.8,16,28,9,19,29,96,54,1,Premier_League,2021_2022
Jonny Castro,ESP,DF,Wolves,27,1994,11.4,25,15,13,11,1,11,20,55.0,9,14,3,11,13,38,11,0,Premier_League,2021_2022
Craig Cathcart,NIR,DF,Watford,32,1989,26.6,32,15,25,6,1,16,30,53.3,14,39,29,10,28,60,132,3,Premier_League,2021_2022
Edinson Cavani,URU,FW,Manchester Utd,34,1987,8.5,4,1,0,3,1,2,8,25.0,6,6,0,6,2,6,8,0,Premier_League,2021_2022
Kayky Chagas,BRA,FW,Manchester City,18,2003,0.1,0,0,0,0,0,0,0,,0,0,0,0,0,0,0,0,Premier_League,2021_2022
Trevoh Chalobah,ENG,DF,Chelsea,22,1999,16.1,40,27,22,18,0,24,31,77.4,7,16,6,10,19,59,43,2,Premier_League,2021_2022
Calum Chambers,ENG,DF,Arsenal,26,1995,1.9,5,3,3,1,1,3,4,75.0,1,6,3,3,0,5,10,0,Premier_League,2021_2022
Calum Chambers,ENG,DF,Aston Villa,26,1995,9.2,16,8,10,6,0,4,6,66.7,2,14,8,6,5,21,42,0,Premier_League,2021_2022
Daniel Chesters,ENG,MF,West Ham,19,2002,0.0,0,0,0,0,0,0,0,,0,0,0,0,0,0,0,0,Premier_League,2021_2022
Ben Chilwell,ENG,DF,Chelsea,24,1996,6.0,8,3,2,6,0,2,5,40.0,3,7,0,7,4,12,14,1,Premier_League,2021_2022
Chiquinho,POR,"DF,FW",Wolves,21,2000,2.3,9,6,4,5,0,4,5,80.0,1,5,0,5,2,11,1,0,Premier_League,2021_2022
Hamza Choudhury,ENG,"DF,MF",Leicester City,23,1997,3.2,9,3,4,4,1,3,5,60.0,2,0,0,0,12,21,10,0,Premier_League,2021_2022
Andreas Christensen,DEN,DF,Chelsea,25,1996,16.6,14,8,9,4,1,4,7,57.1,3,14,6,8,29,43,57,1,Premier_League,2021_2022
Carney Chukwuemeka,ENG,"MF,FW",Aston Villa,17,2003,3.3,7,1,2,5,0,3,5,60.0,2,3,0,3,1,8,2,1,Premier_League,2021_2022
Ciaran Clark,IRL,DF,Newcastle Utd,31,1989,11.3,13,10,4,7,2,9,14,64.3,5,14,11,3,13,26,43,1,Premier_League,2021_2022
Tom Cleverley,ENG,MF,Watford,31,1989,18.0,37,20,19,17,1,18,33,54.5,15,23,6,17,18,55,19,3,Premier_League,2021_2022
Nathaniel Clyne,ENG,DF,Crystal Palace,30,1991,15.0,21,10,11,9,1,10,20,50.0,10,7,2,5,15,36,32,0,Premier_League,2021_2022
Conor Coady,ENG,DF,Wolves,28,1993,37.3,31,14,23,7,1,16,28,57.1,12,46,40,6,28,59,140,0,Premier_League,2021_2022
Séamus Coleman,IRL,DF,Everton,32,1988,29.5,61,36,35,16,10,33,51,64.7,18,30,11,19,32,93,80,2,Premier_League,2021_2022
Nathan Collins,IRL,DF,Burnley,20,2001,18.6,37,15,27,8,2,17,27,63.0,10,38,25,13,24,61,83,2,Premier_League,2021_2022
Aaron Connolly,IRL,"FW,MF",Brighton,21,2000,1.7,0,0,0,0,0,0,1,0.0,1,2,0,2,0,0,0,0,Premier_League,2021_2022
Liam Cooper,SCO,DF,Leeds United,29,1991,20.2,41,23,27,13,1,23,33,69.7,10,29,18,11,43,84,72,2,Premier_League,2021_2022
Jack Cork,ENG,MF,Burnley,32,1989,18.6,20,6,6,11,3,7,20,35.0,13,17,4,13,17,37,29,1,Premier_League,2021_2022
Maxwel Cornet,CIV,"FW,MF",Burnley,24,1996,19.6,16,9,7,5,4,7,15,46.7,8,13,4,9,10,26,14,0,Premier_League,2021_2022
Hélder Costa,ANG,MF,Leeds United,27,1994,0.2,0,0,0,0,0,0,0,,0,1,0,1,0,0,0,0,Premier_League,2021_2022
Vladimír Coufal,CZE,DF,West Ham,28,1992,24.5,45,25,24,14,7,18,36,50.0,18,31,9,22,22,67,64,1,Premier_League,2021_2022
Philippe Coutinho,BRA,"MF,FW",Aston Villa,29,1992,14.8,17,12,4,11,2,6,21,28.6,15,11,1,10,7,24,4,0,Premier_League,2021_2022
Aaron Cresswell,ENG,DF,West Ham,31,1989,30.3,28,18,18,6,4,13,25,52.0,12,31,18,13,35,63,66,0,Premier_League,2021_2022
Charlie Cresswell,ENG,DF,Leeds United,18,2002,1.6,5,2,1,4,0,3,3,100.0,0,1,1,0,2,7,6,0,Premier_League,2021_2022
Cucho,COL,"FW,MF",Watford,22,1999,12.7,13,5,5,5,3,5,27,18.5,22,13,1,12,5,18,9,0,Premier_League,2021_2022
Marc Cucurella,ESP,DF,Brighton,23,1998,34.3,93,62,43,32,18,44,71,62.0,27,42,14,28,30,123,74,0,Premier_League,2021_2022
Luke Cundle,ENG,MF,Wolves,19,2002,2.0,4,3,0,4,0,1,1,100.0,0,0,0,0,1,5,1,0,Premier_League,2021_2022
Patson Daka,ZAM,FW,Leicester City,22,1998,12.9,15,10,2,8,5,2,19,10.5,17,7,0,7,2,17,8,0,Premier_League,2021_2022
Stuart Dallas,NIR,"DF,MF",Leeds United,30,1991,32.4,93,55,58,31,4,56,105,53.3,49,45,14,31,57,150,63,2,Premier_League,2021_2022
Diogo Dalot,POR,DF,Manchester Utd,22,1999,20.0,55,41,35,12,8,31,57,54.4,26,24,13,11,29,84,59,0,Premier_League,2021_2022
Karl Darlow,WAL,GK,Newcastle Utd,30,1990,8.0,0,0,0,0,0,0,0,,0,0,0,0,0,0,5,1,Premier_League,2021_2022
Josh Dasilva,ENG,"MF,FW",Brentford,22,1998,2.9,2,1,0,1,1,1,2,50.0,1,3,0,3,1,3,7,0,Premier_League,2021_2022
Ben Davies,WAL,DF,Tottenham,28,1993,28.2,36,21,20,12,4,13,26,50.0,13,32,19,13,30,66,75,1,Premier_League,2021_2022
Tom Davies,ENG,MF,Everton,23,1998,2.6,3,1,1,1,1,2,5,40.0,3,2,1,1,2,5,9,0,Premier_League,2021_2022
Keinan Davis,ENG,FW,Aston Villa,23,1998,0.1,0,0,0,0,0,0,0,,0,0,0,0,0,0,0,0,Premier_League,2021_2022
Craig Dawson,ENG,DF,West Ham,31,1990,30.6,29,17,20,8,1,14,25,56.0,11,59,52,7,29,58,139,0,Premier_League,2021_2022
Kevin De Bruyne,BEL,MF,Manchester City,30,1991,24.5,32,16,4,15,13,12,37,32.4,25,32,2,30,6,38,16,0,Premier_League,2021_2022
Troy Deeney,ENG,FW,Watford,33,1988,0.3,0,0,0,0,0,0,1,0.0,1,0,0,0,0,0,2,0,Premier_League,2021_2022
Liam Delap,ENG,FW,Manchester City,18,2003,0.1,0,0,0,0,0,0,0,,0,0,0,0,0,0,0,0,Premier_League,2021_2022
Fabian Delph,ENG,MF,Everton,31,1989,7.4,18,15,10,7,1,8,21,38.1,13,12,5,7,14,32,10,0,Premier_League,2021_2022
Leander Dendoncker,BEL,MF,Wolves,26,1995,21.7,42,17,25,14,3,22,50,44.0,28,37,10,27,9,51,38,1,Premier_League,2021_2022
Emmanuel Dennis,NGA,"FW,MF",Watford,23,1997,28.7,51,35,20,22,9,17,52,32.7,35,36,2,34,15,66,13,0,Premier_League,2021_2022
Kiernan Dewsbury-Hall,ENG,MF,Leicester City,22,1998,23.4,39,24,20,14,5,19,40,47.5,21,37,8,29,21,60,26,1,Premier_League,2021_2022
Ibrahima Diallo,FRA,MF,Southampton,22,1999,11.4,22,11,10,9,3,10,24,41.7,14,7,0,7,9,31,10,0,Premier_League,2021_2022
Rúben Dias,POR,DF,Manchester City,24,1997,26.7,26,19,11,12,3,8,15,53.3,7,19,13,6,23,49,66,0,Premier_League,2021_2022
Luis Díaz,COL,FW,Liverpool,24,1997,10.6,9,7,3,5,1,2,8,25.0,6,7,0,7,4,13,2,0,Premier_League,2021_2022
Eric Dier,ENG,DF,Tottenham,27,1994,34.1,15,9,6,8,1,7,14,50.0,7,37,32,5,27,42,142,1,Premier_League,2021_2022
Lucas Digne,FRA,DF,Aston Villa,28,1993,14.1,13,10,8,3,2,9,19,47.4,10,15,8,7,23,36,40,0,Premier_League,2021_2022
Lucas Digne,FRA,DF,Everton,28,1993,13.0,33,19,26,4,3,21,28,75.0,7,16,5,11,14,47,30,0,Premier_League,2021_2022
Issa Diop,FRA,DF,West Ham,24,1997,10.7,10,8,5,5,0,4,11,36.4,7,14,13,1,7,17,44,0,Premier_League,2021_2022
Moussa Djenepo,MLI,MF,Southampton,23,1998,5.1,9,3,3,5,1,3,11,27.3,8,6,1,5,2,11,6,1,Premier_League,2021_2022
Lewis Dobbin,ENG,"FW,MF",Everton,18,2003,0.4,2,1,0,1,1,1,2,50.0,1,0,0,0,0,2,0,0,Premier_League,2021_2022
Matt Doherty,IRL,DF,Tottenham,29,1992,9.7,18,12,5,11,2,8,14,57.1,6,11,2,9,13,31,20,0,Premier_League,2021_2022
Abdoulaye Doucouré,MLI,MF,Everton,28,1993,28.2,75,43,30,37,8,32,71,45.1,39,33,8,25,28,103,32,0,Premier_League,2021_2022
Kieran Dowell,ENG,"FW,MF",Norwich City,23,1997,10.1,18,7,8,7,3,9,32,28.1,23,10,1,9,7,25,4,0,Premier_League,2021_2022
Cody Drameh,ENG,"DF,MF",Leeds United,19,2001,1.4,4,2,3,1,0,1,3,33.3,2,0,0,0,1,5,4,0,Premier_League,2021_2022
Martin Dúbravka,SVK,GK,Newcastle Utd,32,1989,26.0,1,1,1,0,0,0,1,0.0,1,0,0,0,0,1,8,2,Premier_League,2021_2022
Shane Duffy,IRL,DF,Brighton,29,1992,16.0,15,12,12,3,0,8,14,57.1,6,24,18,6,16,31,76,1,Premier_League,2021_2022
Paul Dummett,WAL,DF,Newcastle Utd,29,1991,2.2,7,3,3,4,0,5,8,62.5,3,5,0,5,3,10,5,0,Premier_League,2021_2022
Lewis Dunk,ENG,DF,Brighton,29,1991,28.6,10,8,5,5,0,5,11,45.5,6,32,28,4,27,37,113,3,Premier_League,2021_2022
Ederson,BRA,GK,Manchester City,27,1993,37.0,2,1,2,0,0,0,2,0.0,2,0,0,0,0,2,12,0,Premier_League,2021_2022
Odsonne Édouard,FRA,FW,Crystal Palace,23,1998,17.4,16,10,2,7,7,7,21,33.3,14,20,5,15,0,16,18,0,Premier_League,2021_2022
CJ Egan-Riley,ENG,DF,Manchester City,18,2003,0.0,1,1,1,0,0,1,1,100.0,0,0,0,0,0,1,0,0,Premier_League,2021_2022
Anthony Elanga,SWE,FW,Manchester Utd,19,2002,13.5,26,20,12,12,2,15,29,51.7,14,17,1,16,9,35,7,0,Premier_League,2021_2022
Harvey Elliott,ENG,MF,Liverpool,18,2003,3.8,3,0,1,1,1,0,6,0.0,6,8,1,7,4,7,2,0,Premier_League,2021_2022
Mohamed Elneny,EGY,MF,Arsenal,29,1992,9.0,16,8,10,5,1,7,12,58.3,5,7,1,6,14,30,13,0,Premier_League,2021_2022
Mohamed Elyounoussi,NOR,"MF,FW",Southampton,26,1994,22.7,36,17,14,15,7,11,39,28.2,28,23,2,21,12,48,28,0,Premier_League,2021_2022
Emerson,BRA,"DF,MF",Tottenham,22,1999,25.4,72,47,50,16,6,36,67,53.7,31,25,2,23,22,94,92,1,Premier_League,2021_2022
Christian Eriksen,DEN,MF,Brentford,29,1992,10.4,13,6,4,5,4,8,17,47.1,9,9,1,8,9,22,14,0,Premier_League,2021_2022
Oghenekaro Etebo,NGA,MF,Watford,25,1995,4.5,11,8,7,4,0,3,8,37.5,5,3,1,2,5,16,5,0,Premier_League,2021_2022
Jonny Evans,NIR,DF,Leicester City,33,1988,15.0,24,14,14,8,2,14,22,63.6,8,17,13,4,20,44,59,0,Premier_League,2021_2022
Eberechi Eze,ENG,"MF,FW",Crystal Palace,23,1998,6.7,10,6,5,2,3,6,11,54.5,5,4,1,3,5,15,1,0,Premier_League,2021_2022
Łukasz Fabiański,POL,GK,West Ham,36,1985,37.0,0,0,0,0,0,0,0,,0,0,0,0,0,0,11,0,Premier_League,2021_2022
Fabinho,BRA,MF,Liverpool,27,1993,25.7,46,25,17,23,6,24,70,34.3,46,33,10,23,39,85,25,1,Premier_League,2021_2022
Kiko Femenía,ESP,DF,Watford,30,1991,23.8,35,22,23,10,2,21,37,56.8,16,24,8,16,37,72,51,0,Premier_League,2021_2022
Evan Ferguson,IRL,MF,Brighton,16,2004,0.3,0,0,0,0,0,0,0,,0,0,0,0,0,0,0,0,Premier_League,2021_2022
Nathan Ferguson,ENG,DF,Crystal Palace,20,2000,0.1,0,0,0,0,0,0,0,,0,0,0,0,0,0,0,0,Premier_League,2021_2022
Bruno Fernandes,POR,MF,Manchester Utd,26,1994,34.6,54,28,26,22,6,26,91,28.6,65,36,0,36,17,71,42,2,Premier_League,2021_2022
Álvaro Fernández,ESP,GK,Brentford,23,1998,12.0,0,0,0,0,0,0,0,,0,0,0,0,0,0,5,2,Premier_League,2021_2022
Federico Fernández,ARG,DF,Newcastle Utd,32,1989,5.8,3,0,3,0,0,2,5,40.0,3,10,10,0,4,7,28,0,Premier_League,2021_2022
Fernandinho,BRA,"MF,DF",Manchester City,36,1985,10.7,21,10,7,10,4,9,27,33.3,18,8,2,6,8,29,13,1,Premier_League,2021_2022
Roberto Firmino,BRA,FW,Liverpool,29,1991,11.0,23,14,5,8,10,3,16,18.8,13,20,0,20,4,27,3,0,Premier_League,2021_2022
Junior Firpo,DOM,"DF,MF",Leeds United,24,1996,19.0,61,29,30,26,5,31,59,52.5,28,22,6,16,24,85,37,0,Premier_League,2021_2022
Ashley Fletcher,ENG,FW,Watford,25,1995,0.3,2,1,1,1,0,1,1,100.0,0,1,1,0,0,2,0,0,Premier_League,2021_2022
Phil Foden,ENG,FW,Manchester City,21,2000,23.6,16,8,10,4,2,7,17,41.2,10,9,0,9,11,27,5,0,Premier_League,2021_2022
Wesley Fofana,FRA,DF,Leicester City,20,2000,7.0,12,8,11,1,0,7,11,63.6,4,5,2,3,12,24,26,1,Premier_League,2021_2022
Pablo Fornals,ESP,"FW,MF",West Ham,25,1996,31.1,54,28,21,21,12,22,84,26.2,62,49,2,47,27,81,16,1,Premier_League,2021_2022
Adam Forshaw,ENG,MF,Leeds United,29,1991,17.0,53,23,21,27,5,21,54,38.9,33,17,1,16,19,72,12,2,Premier_League,2021_2022
Marcus Forss,FIN,"FW,MF",Brentford,22,1999,2.3,3,3,0,2,1,2,4,50.0,2,5,0,5,1,4,0,0,Premier_League,2021_2022
Fraser Forster,ENG,GK,Southampton,33,1988,19.0,1,0,1,0,0,0,1,0.0,1,0,0,0,0,1,23,2,Premier_League,2021_2022
Ben Foster,ENG,GK,Watford,38,1983,26.0,0,0,0,0,0,0,3,0.0,3,0,0,0,0,0,9,4,Premier_League,2021_2022
Tariqe Fosu,GHA,DF,Brentford,25,1995,0.2,0,0,0,0,0,0,0,,0,1,0,1,0,0,0,0,Premier_League,2021_2022
Ryan Fraser,SCO,"FW,MF",Newcastle Utd,27,1994,16.3,10,3,5,3,2,5,13,38.5,8,11,1,10,11,21,11,0,Premier_League,2021_2022
Fred,BRA,MF,Manchester Utd,28,1993,22.5,63,27,32,24,7,22,79,27.8,57,38,11,27,32,95,24,0,Premier_League,2021_2022
Ryan Fredericks,ENG,DF,West Ham,28,1992,3.4,2,2,2,0,0,0,1,0.0,1,2,1,1,4,6,6,0,Premier_League,2021_2022
Leo Fuhr Hjelde,NOR,"MF,DF",Leeds United,17,2003,1.7,5,4,3,2,0,3,3,100.0,0,3,3,0,4,9,7,0,Premier_League,2021_2022
Conor Gallagher,ENG,MF,Crystal Palace,21,2000,31.6,69,38,35,20,14,21,69,30.4,48,58,9,49,29,98,26,0,Premier_League,2021_2022
Alejandro Garnacho,ARG,"FW,MF",Manchester Utd,17,2004,0.1,0,0,0,0,0,0,1,0.0,1,0,0,0,0,0,0,0,Premier_League,2021_2022
Dwight Gayle,ENG,"FW,DF",Newcastle Utd,30,1990,0.4,1,0,0,1,0,0,1,0.0,1,0,0,0,1,2,0,0,Premier_League,2021_2022
Jean-Philippe Gbamin,CIV,MF,Everton,25,1995,0.7,1,1,1,0,0,0,2,0.0,2,0,0,0,1,2,1,0,Premier_League,2021_2022
David de Gea,ESP,GK,Manchester Utd,30,1990,38.0,0,0,0,0,0,0,0,,0,0,0,0,0,0,11,2,Premier_League,2021_2022
Joe Gelhardt,ENG,"FW,MF",Leeds United,19,2002,8.3,4,3,1,0,3,2,10,20.0,8,9,0,9,0,4,3,0,Premier_League,2021_2022
Anwar El Ghazi,NED,"FW,MF",Aston Villa,26,1995,4.3,4,4,2,2,0,2,7,28.6,5,6,0,6,1,5,2,0,Premier_League,2021_2022
Anwar El Ghazi,NED,"FW,MF",Everton,26,1995,0.1,1,1,1,0,0,1,1,100.0,0,3,0,3,0,1,0,0,Premier_League,2021_2022
Saman Ghoddos,IRN,"MF,DF",Brentford,27,1993,6.0,17,10,8,6,3,9,15,60.0,6,2,0,2,3,20,16,0,Premier_League,2021_2022
Dimitris Giannoulis,GRE,DF,Norwich City,25,1995,13.0,36,21,17,17,2,24,36,66.7,12,22,6,16,19,55,41,1,Premier_League,2021_2022
Morgan Gibbs-White,ENG,"DF,FW",Wolves,21,2000,0.1,0,0,0,0,0,0,0,,0,1,0,1,0,0,0,0,Premier_League,2021_2022
Ben Gibson,ENG,DF,Norwich City,28,1993,27.7,23,16,17,6,0,7,12,58.3,5,36,30,6,27,50,139,2,Premier_League,2021_2022
Bryan Gil,ESP,"FW,MF",Tottenham,20,2001,1.0,3,0,1,0,2,1,2,50.0,1,2,0,2,0,3,0,0,Premier_League,2021_2022
Billy Gilmour,SCO,MF,Norwich City,20,2001,20.6,41,21,16,21,4,14,52,26.9,38,21,4,17,17,58,29,0,Premier_League,2021_2022
Ben Godfrey,ENG,DF,Everton,23,1998,22.5,47,32,29,14,4,24,39,61.5,15,41,19,22,15,62,100,2,Premier_League,2021_2022
André Gomes,POR,MF,Everton,28,1993,6.9,16,4,6,6,4,8,32,25.0,24,8,2,6,1,17,7,1,Premier_League,2021_2022
Toti Gomes,POR,DF,Wolves,22,1999,4.0,11,7,10,1,0,7,9,77.8,2,6,3,3,8,19,15,0,Premier_League,2021_2022
Joe Gomez,ENG,DF,Liverpool,24,1997,3.7,10,6,5,2,3,5,9,55.6,4,4,1,3,5,15,6,0,Premier_League,2021_2022
Charlie Goode,ENG,DF,Brentford,25,1995,5.0,7,5,5,2,0,4,4,100.0,0,4,2,2,2,9,8,0,Premier_League,2021_2022
Anthony Gordon,ENG,"MF,FW",Everton,20,2001,25.4,54,32,20,30,4,21,59,35.6,38,49,3,46,22,76,17,0,Premier_League,2021_2022
Kaide Gordon,ENG,FW,Liverpool,16,2004,0.1,1,0,0,0,1,0,0,,0,0,0,0,0,1,0,0,Premier_League,2021_2022
Dan Gosling,ENG,MF,Watford,31,1990,1.8,2,1,1,1,0,2,6,33.3,4,2,0,2,0,2,3,0,Premier_League,2021_2022
Demarai Gray,JAM,"MF,FW",Everton,25,1996,26.0,30,19,13,10,7,10,22,45.5,12,30,2,28,15,45,21,1,Premier_League,2021_2022
Jack Grealish,ENG,FW,Manchester City,25,1995,21.3,18,17,4,10,4,5,13,38.5,8,11,1,10,8,26,7,0,Premier_League,2021_2022
Mason Greenwood,ENG,"FW,MF",Manchester Utd,19,2001,14.1,15,9,9,1,5,3,9,33.3,6,5,0,5,1,16,6,0,Premier_League,2021_2022
Sam Greenwood,ENG,"MF,FW",Leeds United,19,2002,2.6,8,5,0,5,3,4,7,57.1,3,3,0,3,2,10,1,0,Premier_League,2021_2022
Pascal Groß,GER,"MF,DF",Brighton,30,1991,22.6,28,15,15,11,2,12,33,36.4,21,34,8,26,18,46,23,0,Premier_League,2021_2022
Vicente Guaita,ESP,GK,Crystal Palace,34,1987,29.5,1,0,1,0,0,1,1,100.0,0,0,0,0,1,2,8,1,Premier_League,2021_2022
Marc Guéhi,ENG,DF,Crystal Palace,21,2000,35.8,35,17,24,10,1,15,16,93.8,1,34,26,8,30,65,127,0,Premier_League,2021_2022
Bruno Guimarães,BRA,MF,Newcastle Utd,23,1997,11.5,44,23,18,22,4,21,38,55.3,17,25,6,19,9,53,13,0,Premier_League,2021_2022
İlkay Gündoğan,GER,MF,Manchester City,30,1990,20.6,23,9,10,12,1,12,31,38.7,19,11,1,10,15,38,10,0,Premier_League,2021_2022
Angus Gunn,SCO,GK,Norwich City,25,1996,9.0,0,0,0,0,0,0,0,,0,0,0,0,0,0,11,0,Premier_League,2021_2022
Grant Hanley,SCO,DF,Norwich City,29,1991,32.2,44,25,28,14,2,18,35,51.4,17,56,45,11,56,100,176,2,Premier_League,2021_2022
Jack Harrison,ENG,"FW,MF",Leeds United,24,1996,29.3,57,37,22,22,13,31,76,40.8,45,35,1,34,21,78,19,0,Premier_League,2021_2022
Kortney Hause,ENG,DF,Aston Villa,26,1995,4.4,3,3,2,0,1,3,4,75.0,1,8,5,3,6,9,13,0,Premier_League,2021_2022
Kai Havertz,GER,"FW,MF",Chelsea,22,1999,20.1,17,8,5,7,5,4,14,28.6,10,28,1,27,4,21,32,1,Premier_League,2021_2022
Isaac Hayden,ENG,"MF,DF",Newcastle Utd,26,1995,11.1,28,14,11,14,3,12,29,41.4,17,17,8,9,14,42,24,0,Premier_League,2021_2022
Hwang Hee-chan,KOR,"FW,MF",Wolves,25,1996,20.2,27,13,9,16,2,14,44,31.8,30,10,0,10,13,40,7,1,Premier_League,2021_2022
Jordan Henderson,ENG,MF,Liverpool,31,1990,28.9,36,20,9,25,2,17,44,38.6,27,25,1,24,23,59,14,0,Premier_League,2021_2022
Jeff Hendrick,IRL,MF,Newcastle Utd,29,1992,0.8,1,1,0,1,0,1,1,100.0,0,0,0,0,0,1,1,0,Premier_League,2021_2022
Wayne Hennessey,WAL,GK,Burnley,34,1987,2.0,0,0,0,0,0,0,0,,0,0,0,0,1,1,0,1,Premier_League,2021_2022
Rico Henry,ENG,DF,Brentford,24,1997,30.8,28,20,18,8,2,12,34,35.3,22,31,10,21,26,54,76,1,Premier_League,2021_2022
Son Heung-min,KOR,"MF,FW",Tottenham,29,1992,33.4,15,6,5,7,3,5,23,21.7,18,27,6,21,13,28,8,0,Premier_League,2021_2022
Ki-Jana Hoever,NED,"DF,MF",Wolves,19,2002,3.4,10,6,5,5,0,7,12,58.3,5,6,0,6,6,16,8,0,Premier_League,2021_2022
Rob Holding,ENG,DF,Arsenal,25,1995,9.4,13,9,11,1,1,5,6,83.3,1,23,18,5,10,23,42,1,Premier_League,2021_2022
Mason Holgate,ENG,DF,Everton,24,1996,23.7,35,18,26,9,0,11,26,42.3,15,25,17,8,26,61,95,1,Premier_League,2021_2022
Callum Hudson-Odoi,ENG,"MF,FW",Chelsea,20,2000,10.7,14,10,5,6,3,8,23,34.8,15,8,0,8,2,16,6,1,Premier_League,2021_2022
Will Hughes,ENG,MF,Crystal Palace,26,1995,11.7,29,14,10,16,3,7,16,43.8,9,13,7,6,8,37,10,0,Premier_League,2021_2022
Pierre Højbjerg,DEN,MF,Tottenham,25,1995,35.5,78,45,31,38,9,38,85,44.7,47,61,13,48,48,126,54,0,Premier_League,2021_2022
Adam Idah,IRL,"FW,MF",Norwich City,20,2001,6.9,9,6,2,5,2,2,3,66.7,1,4,2,2,3,12,7,0,Premier_League,2021_2022
Kelechi Iheanacho,NGA,FW,Leicester City,24,1996,14.0,10,7,2,5,3,3,14,21.4,11,19,0,19,4,14,10,0,Premier_League,2021_2022
Danny Ings,ENG,FW,Aston Villa,29,1992,21.1,23,16,2,16,5,13,37,35.1,24,31,2,29,6,29,22,0,Premier_League,2021_2022
Tim Iroegbunam,ENG,MF,Aston Villa,18,2003,1.0,5,4,2,3,0,1,1,100.0,0,0,0,0,2,7,1,0,Premier_League,2021_2022
Alex Iwobi,NGA,"MF,DF",Everton,25,1996,22.6,40,19,23,12,5,21,52,40.4,31,39,3,36,20,60,25,2,Premier_League,2021_2022
Daniel James,WAL,FW,Manchester Utd,23,1997,1.4,2,1,0,2,0,0,0,,0,2,0,2,0,2,1,0,Premier_League,2021_2022
Daniel James,WAL,"FW,MF",Leeds United,23,1997,26.3,24,14,8,8,8,10,23,43.5,13,18,1,17,8,32,12,0,Premier_League,2021_2022
Reece James,ENG,DF,Chelsea,21,1999,20.7,33,25,14,18,1,9,22,40.9,13,20,2,18,17,50,22,0,Premier_League,2021_2022
Vitaly Janelt,GER,MF,Brentford,23,1998,25.5,61,32,26,27,8,27,53,50.9,26,23,7,16,28,89,35,0,Premier_League,2021_2022
Pontus Jansson,SWE,DF,Brentford,30,1991,36.9,40,21,32,8,0,22,34,64.7,12,37,27,10,52,92,187,0,Premier_League,2021_2022
Mathias Jensen,DEN,MF,Brentford,25,1996,17.8,33,18,12,16,5,22,63,34.9,41,32,3,29,22,55,13,0,Premier_League,2021_2022
Gabriel Jesus,BRA,FW,Manchester City,24,1997,20.9,18,12,2,4,12,6,26,23.1,20,18,0,18,15,33,8,0,Premier_League,2021_2022
Raúl Jiménez,MEX,FW,Wolves,30,1991,29.2,29,14,6,16,7,6,30,20.0,24,31,5,26,13,42,26,0,Premier_League,2021_2022
João Pedro,BRA,"FW,MF",Watford,19,2001,18.3,20,14,7,8,5,6,23,26.1,17,23,3,20,15,35,17,0,Premier_League,2021_2022
Joelinton,BRA,"MF,FW",Newcastle Utd,24,1996,28.4,72,38,30,33,9,26,61,42.6,35,46,11,35,34,106,50,2,Premier_League,2021_2022
Ben Johnson,ENG,DF,West Ham,21,2000,15.5,33,16,15,15,3,21,28,75.0,7,16,8,8,22,55,55,0,Premier_League,2021_2022
Curtis Jones,ENG,MF,Liverpool,20,2001,9.5,11,9,3,6,2,1,10,10.0,9,4,0,4,6,17,4,0,Premier_League,2021_2022
Phil Jones,ENG,DF,Manchester Utd,29,1992,1.8,5,5,3,1,1,2,3,66.7,1,4,4,0,3,8,8,0,Premier_League,2021_2022
Jorginho,ITA,MF,Chelsea,29,1991,25.3,64,33,27,31,6,29,83,34.9,54,27,4,23,36,100,21,1,Premier_League,2021_2022
Diogo Jota,POR,FW,Liverpool,24,1996,26.3,39,18,12,18,9,13,55,23.6,42,19,2,17,6,45,6,0,Premier_League,2021_2022
James Justin,ENG,DF,Leicester City,23,1998,11.1,22,13,11,8,3,7,15,46.7,8,16,4,12,17,39,34,0,Premier_League,2021_2022
Mathias Jørgensen,DEN,DF,Brentford,31,1990,5.8,10,4,3,5,2,7,10,70.0,3,6,1,5,10,20,13,0,Premier_League,2021_2022
Ozan Kabak,TUR,DF,Norwich City,21,2000,10.2,10,5,4,6,0,5,9,55.6,4,19,11,8,16,26,26,0,Premier_League,2021_2022
Christian Kabasele,BEL,DF,Watford,30,1991,13.3,11,5,10,1,0,7,10,70.0,3,20,16,4,14,25,67,1,Premier_League,2021_2022
Samuel Kalu,NGA,FW,Watford,23,1997,2.5,2,2,0,2,0,1,1,100.0,0,2,0,2,3,5,3,0,Premier_League,2021_2022
Hassane Kamara,CIV,DF,Watford,27,1994,18.0,53,34,31,16,6,27,43,62.8,16,20,4,16,69,122,67,0,Premier_League,2021_2022
Harry Kane,ENG,FW,Tottenham,28,1993,35.9,15,5,2,10,3,7,18,38.9,11,26,8,18,3,18,39,0,Premier_League,2021_2022
N'Golo Kanté,FRA,MF,Chelsea,30,1991,19.7,59,31,20,27,12,25,40,62.5,15,37,2,35,31,90,8,0,Premier_League,2021_2022
Edo Kayembe,COD,MF,Watford,23,1998,8.9,21,13,11,9,1,8,16,50.0,8,6,1,5,9,30,13,0,Premier_League,2021_2022
Moise Kean,ITA,FW,Everton,21,2000,0.0,0,0,0,0,0,0,0,,0,0,0,0,0,0,0,0,Premier_League,2021_2022
Michael Keane,ENG,DF,Everton,28,1993,31.0,46,25,32,13,1,28,45,62.2,17,33,28,5,62,108,128,2,Premier_League,2021_2022
Naby Keïta,GUI,MF,Liverpool,26,1995,13.0,46,23,17,19,10,26,42,61.9,16,33,2,31,14,60,8,0,Premier_League,2021_2022
Caoimhín Kelleher,IRL,GK,Liverpool,22,1998,2.0,1,1,1,0,0,1,1,100.0,0,0,0,0,0,1,1,0,Premier_League,2021_2022
Kenedy,BRA,DF,Chelsea,25,1996,0.6,5,2,1,2,2,2,3,66.7,1,0,0,0,0,5,0,0,Premier_League,2021_2022
Jonjoe Kenny,ENG,DF,Everton,24,1997,11.3,17,7,11,6,0,13,21,61.9,8,8,1,7,20,37,31,0,Premier_League,2021_2022
Max Kilman,ENG,DF,Wolves,24,1997,29.9,50,26,38,10,2,24,37,64.9,13,36,21,15,45,95,113,3,Premier_League,2021_2022
Joshua King,NOR,FW,Watford,29,1992,25.0,19,15,7,6,6,4,17,23.5,13,15,4,11,8,27,31,0,Premier_League,2021_2022
Kristoffer Klaesson,NOR,GK,Leeds United,20,2000,0.4,0,0,0,0,0,0,0,,0,0,0,0,0,0,0,0,Premier_League,2021_2022
Mateusz Klich,POL,MF,Leeds United,31,1990,23.0,47,25,18,23,6,25,66,37.9,41,22,4,18,11,58,20,0,Premier_League,2021_2022
Robin Koch,GER,"MF,DF",Leeds United,25,1996,17.5,21,13,9,10,2,9,34,26.5,25,26,10,16,20,41,44,0,Premier_League,2021_2022
Sead Kolašinac,BIH,DF,Arsenal,28,1993,1.0,0,0,0,0,0,0,0,,0,0,0,0,4,4,1,0,Premier_League,2021_2022
Ibrahima Konaté,FRA,DF,Liverpool,22,1999,11.0,16,10,9,6,1,7,10,70.0,3,13,9,4,16,32,37,1,Premier_League,2021_2022
Ezri Konsa,ENG,DF,Aston Villa,23,1997,27.5,25,15,13,11,1,10,13,76.9,3,31,22,9,15,40,86,2,Premier_League,2021_2022
Cheikhou Kouyaté,SEN,MF,Crystal Palace,31,1989,21.9,52,38,28,22,2,18,39,46.2,21,40,14,26,38,90,39,0,Premier_League,2021_2022
Mateo Kovačić,CRO,MF,Chelsea,27,1994,17.3,51,31,14,26,11,17,35,48.6,18,19,4,15,7,58,9,1,Premier_League,2021_2022
Emil Krafth,SWE,DF,Newcastle Utd,26,1994,18.2,37,16,25,11,1,27,36,75.0,9,16,10,6,25,62,56,0,Premier_League,2021_2022
Alex Král,CZE,MF,West Ham,23,1998,0.0,0,0,0,0,0,0,0,,0,0,0,0,0,0,0,0,Premier_League,2021_2022
Tim Krul,NED,GK,Norwich City,33,1988,29.0,1,1,1,0,0,1,4,25.0,3,0,0,0,0,1,10,4,Premier_League,2021_2022
Juraj Kucka,SVK,MF,Watford,34,1987,21.3,59,39,32,25,2,27,73,37.0,46,30,9,21,27,86,46,2,Premier_League,2021_2022
Dejan Kulusevski,SWE,"MF,FW",Tottenham,21,2000,14.0,19,13,7,10,2,5,23,21.7,18,14,0,14,13,32,3,0,Premier_League,2021_2022
Alexandre Lacazette,FRA,FW,Arsenal,30,1991,19.8,27,10,8,13,6,7,21,33.3,14,12,1,11,5,32,6,0,Premier_League,2021_2022
Adam Lallana,ENG,MF,Brighton,33,1988,17.3,34,17,14,14,6,12,41,29.3,29,16,6,10,16,50,13,1,Premier_League,2021_2022
Tariq Lamptey,GHA,"DF,FW",Brighton,20,2000,17.3,36,25,14,17,5,15,25,60.0,10,13,3,10,21,57,23,0,Premier_League,2021_2022
Manuel Lanzini,ARG,"MF,FW",West Ham,28,1993,19.8,28,15,10,11,7,10,35,28.6,25,16,0,16,19,47,10,0,Premier_League,2021_2022
Aymeric Laporte,ESP,DF,Manchester City,27,1994,31.4,33,15,22,10,1,14,20,70.0,6,15,10,5,20,53,64,2,Premier_League,2021_2022
Jamaal Lascelles,ENG,DF,Newcastle Utd,27,1993,22.9,15,7,9,5,1,4,12,33.3,8,38,28,10,22,37,121,1,Premier_League,2021_2022
Pierre Lees-Melou,FRA,MF,Norwich City,28,1993,25.2,58,36,23,29,6,25,92,27.2,67,37,11,26,25,83,23,0,Premier_League,2021_2022
Aaron Lennon,ENG,"MF,FW",Burnley,34,1987,17.2,33,17,10,13,10,10,34,29.4,24,26,4,22,9,42,14,0,Premier_League,2021_2022
Bernd Leno,GER,GK,Arsenal,29,1992,4.0,1,1,1,0,0,1,1,100.0,0,0,0,0,0,1,1,0,Premier_League,2021_2022
Jamal Lewis,NIR,DF,Newcastle Utd,23,1998,2.9,8,6,6,1,1,3,4,75.0,1,3,2,1,3,11,8,0,Premier_League,2021_2022
Victor Lindelöf,SWE,DF,Manchester Utd,27,1994,26.2,16,11,9,7,0,9,14,64.3,5,26,17,9,25,41,96,0,Premier_League,2021_2022
Jesse Lingard,ENG,"FW,MF",Manchester Utd,28,1992,4.1,9,7,4,3,2,2,6,33.3,4,4,0,4,0,9,1,0,Premier_League,2021_2022
Valentino Livramento,ENG,DF,Southampton,18,2002,24.5,54,28,30,18,6,27,45,60.0,18,23,9,14,47,101,50,1,Premier_League,2021_2022
Diego Llorente,ESP,DF,Leeds United,27,1993,26.0,53,31,32,19,2,33,47,70.2,14,35,17,18,40,93,77,2,Premier_League,2021_2022
Hugo Lloris,FRA,GK,Tottenham,34,1986,38.0,1,1,1,0,0,1,2,50.0,1,0,0,0,1,2,24,3,Premier_League,2021_2022
Giovani Lo Celso,ARG,"MF,FW",Tottenham,25,1996,2.6,8,4,4,2,2,4,10,40.0,6,6,1,5,1,9,0,1,Premier_League,2021_2022
Jürgen Locadia,CUW,"MF,FW",Brighton,27,1993,0.3,0,0,0,0,0,0,0,,0,0,0,0,0,0,0,0,Premier_League,2021_2022
Ruben Loftus-Cheek,ENG,"MF,DF",Chelsea,25,1996,15.5,29,10,16,11,2,10,19,52.6,9,15,6,9,11,40,17,0,Premier_League,2021_2022
Kevin Long,IRL,DF,Burnley,30,1990,4.6,3,2,1,2,0,1,2,50.0,1,4,1,3,1,4,20,0,Premier_League,2021_2022
Shane Long,IRL,FW,Southampton,34,1987,3.4,9,5,2,4,3,1,1,100.0,0,4,0,4,0,9,2,0,Premier_League,2021_2022
Sean Longstaff,ENG,MF,Newcastle Utd,23,1997,16.3,54,34,18,31,5,24,65,36.9,41,18,6,12,9,63,18,0,Premier_League,2021_2022
Ademola Lookman,NGA,"FW,MF",Leicester City,23,1997,16.1,32,14,10,13,9,10,28,35.7,18,19,1,18,10,42,4,0,Premier_League,2021_2022
Jonas Lössl,DEN,GK,Brentford,32,1989,2.0,0,0,0,0,0,0,0,,0,0,0,0,0,0,1,0,Premier_League,2021_2022
Imran Louza,MAR,MF,Watford,22,1999,15.7,41,21,18,20,3,16,38,42.1,22,28,6,22,42,83,20,1,Premier_League,2021_2022
Matthew Lowton,ENG,DF,Burnley,32,1989,19.7,38,24,20,10,8,20,37,54.1,17,25,11,14,26,64,68,0,Premier_League,2021_2022
Douglas Luiz,BRA,MF,Aston Villa,23,1998,30.2,59,39,30,24,5,21,72,29.2,51,30,7,23,34,93,28,1,Premier_League,2021_2022
Romelu Lukaku,BEL,FW,Chelsea,28,1993,17.7,2,1,0,1,1,1,5,20.0,4,11,1,10,0,2,20,0,Premier_League,2021_2022
Lyanco,BRA,DF,Southampton,24,1997,10.1,18,15,11,7,0,10,18,55.6,8,18,13,5,13,31,50,1,Premier_League,2021_2022
Alexis Mac Allister,ARG,"MF,FW",Brighton,22,1998,23.6,65,40,23,30,12,29,68,42.6,39,37,7,30,13,78,22,0,Premier_League,2021_2022
James Maddison,ENG,"MF,FW",Leicester City,24,1996,27.3,40,20,8,24,8,14,46,30.4,32,18,3,15,11,51,12,0,Premier_League,2021_2022
Gabriel Magalhães,BRA,DF,Arsenal,23,1997,34.0,50,30,36,12,2,30,41,73.2,11,34,26,8,13,63,112,4,Premier_League,2021_2022
Harry Maguire,ENG,DF,Manchester Utd,28,1993,27.9,34,21,22,8,4,19,31,61.3,12,36,29,7,32,66,101,3,Premier_League,2021_2022
Riyad Mahrez,ALG,FW,Manchester City,30,1991,16.6,11,3,5,4,2,5,19,26.3,14,15,1,14,6,17,6,0,Premier_League,2021_2022
Ainsley Maitland-Niles,ENG,MF,Arsenal,23,1997,3.0,8,4,5,3,0,2,4,50.0,2,2,0,2,4,12,4,0,Premier_League,2021_2022
Sadio Mané,SEN,FW,Liverpool,29,1992,31.3,33,20,7,14,12,8,26,30.8,18,30,1,29,8,41,15,0,Premier_League,2021_2022
Javier Manquillo,ESP,DF,Newcastle Utd,27,1994,14.0,39,29,28,10,1,21,36,58.3,15,15,6,9,10,49,32,0,Premier_League,2021_2022
Fernando Marçal,BRA,"MF,DF",Wolves,32,1989,16.1,42,22,27,14,1,21,37,56.8,16,25,4,21,28,70,52,0,Premier_League,2021_2022
Solly March,ENG,"DF,FW",Brighton,27,1994,19.4,30,17,11,9,10,7,22,31.8,15,22,3,19,17,47,25,0,Premier_League,2021_2022
Pablo Marí,ESP,DF,Arsenal,27,1993,2.0,5,3,1,3,1,3,6,50.0,3,5,4,1,3,8,10,0,Premier_League,2021_2022
Anthony Martial,FRA,FW,Manchester Utd,25,1995,2.4,0,0,0,0,0,0,1,0.0,1,1,0,1,0,0,1,0,Premier_League,2021_2022
Gabriel Martinelli,BRA,"FW,MF",Arsenal,20,2001,20.7,27,19,7,14,6,10,29,34.5,19,26,1,25,20,47,15,0,Premier_League,2021_2022
Emiliano Martínez,ARG,GK,Aston Villa,28,1992,36.0,1,1,1,0,0,1,3,33.3,2,0,0,0,0,1,6,1,Premier_League,2021_2022
Adam Masina,MAR,DF,Watford,27,1994,12.0,24,13,11,10,3,12,29,41.4,17,18,6,12,18,42,45,0,Premier_League,2021_2022
Arthur Masuaku,COD,"DF,FW",West Ham,27,1993,7.2,31,23,19,11,1,14,23,60.9,9,9,1,8,9,40,17,0,Premier_League,2021_2022
Juan Mata,ESP,MF,Manchester Utd,33,1988,2.6,6,4,2,3,1,3,5,60.0,2,1,0,1,1,7,1,0,Premier_League,2021_2022
Jean-Philippe Mateta,FRA,FW,Crystal Palace,24,1997,12.7,8,4,2,5,1,3,18,16.7,15,11,3,8,4,12,13,0,Premier_League,2021_2022
Nemanja Matić,SRB,MF,Manchester Utd,32,1988,15.4,31,18,19,11,1,15,31,48.4,16,21,6,15,31,62,21,3,Premier_League,2021_2022
Joël Matip,CMR,DF,Liverpool,29,1991,31.0,47,34,23,19,5,20,31,64.5,11,26,14,12,44,91,93,1,Premier_League,2021_2022
Neal Maupay,FRA,FW,Brighton,24,1996,25.3,17,10,2,6,9,4,18,22.2,14,21,2,19,2,19,2,0,Premier_League,2021_2022
Bryan Mbeumo,CMR,FW,Brentford,21,1999,32.3,28,16,1,12,15,6,20,30.0,14,21,6,15,11,39,20,0,Premier_League,2021_2022
James McArthur,SCO,MF,Crystal Palace,33,1987,16.0,33,23,13,19,1,16,44,36.4,28,23,9,14,30,63,27,0,Premier_League,2021_2022
James Mcatee,ENG,"MF,FW",Manchester City,18,2002,0.2,0,0,0,0,0,0,2,0.0,2,0,0,0,0,0,0,0,Premier_League,2021_2022
Kasey McAteer,IRL,FW,Leicester City,19,2001,0.0,0,0,0,0,0,0,0,,0,0,0,0,0,0,0,0,Premier_League,2021_2022
Liam McCarron,SCO,FW,Leeds United,20,2001,0.1,0,0,0,0,0,0,0,,0,1,0,1,0,0,0,0,Premier_League,2021_2022
Alex McCarthy,ENG,GK,Southampton,31,1989,17.0,0,0,0,0,0,0,0,,0,0,0,0,0,0,4,0,Premier_League,2021_2022
John McGinn,SCO,MF,Aston Villa,26,1994,34.3,106,64,35,55,16,54,104,51.9,50,53,6,47,35,141,34,0,Premier_League,2021_2022
Stuart McKinstry,SCO,MF,Leeds United,18,2002,0.0,0,0,0,0,0,0,0,,0,0,0,0,0,0,0,0,Premier_League,2021_2022
Kenny McLean,SCO,MF,Norwich City,29,1992,30.1,42,22,18,20,4,17,59,28.8,42,29,7,22,34,76,54,0,Premier_League,2021_2022
Dwight McNeil,ENG,MF,Burnley,21,1999,34.5,78,49,27,38,13,33,73,45.2,40,64,11,53,35,113,31,1,Premier_League,2021_2022
Scott McTominay,SCO,MF,Manchester Utd,24,1996,26.5,65,33,32,24,9,30,61,49.2,31,45,10,35,31,96,60,1,Premier_League,2021_2022
Ben Mee,ENG,DF,Burnley,31,1989,20.4,26,12,16,7,3,12,19,63.2,7,28,22,6,24,50,94,1,Premier_League,2021_2022
Hannibal Mejbri,TUN,FW,Manchester Utd,18,2003,0.8,2,1,1,1,0,1,1,100.0,0,0,0,0,0,2,0,0,Premier_League,2021_2022
Benjamin Mendy,FRA,DF,Manchester City,27,1994,0.9,2,2,1,1,0,2,6,33.3,4,0,0,0,0,2,0,0,Premier_League,2021_2022
Edouard Mendy,SEN,GK,Chelsea,29,1992,34.0,1,0,1,0,0,1,3,33.3,2,0,0,0,0,1,13,4,Premier_League,2021_2022
Nampalys Mendy,SEN,MF,Leicester City,29,1992,11.5,12,6,8,4,0,6,17,35.3,11,7,4,3,11,23,11,1,Premier_League,2021_2022
Illan Meslier,FRA,GK,Leeds United,21,2000,37.6,1,1,1,0,0,1,1,100.0,0,0,0,0,0,1,27,1,Premier_League,2021_2022
Luka Milivojević,SRB,MF,Crystal Palace,30,1991,8.6,18,9,9,6,3,10,16,62.5,6,6,1,5,11,29,15,0,Premier_League,2021_2022
James Milner,ENG,"MF,DF",Liverpool,35,1986,9.5,28,16,12,11,5,12,29,41.4,17,19,5,14,17,45,20,0,Premier_League,2021_2022
Yerry Mina,COL,DF,Everton,26,1994,9.4,12,10,12,0,0,10,13,76.9,3,13,9,4,11,23,38,1,Premier_League,2021_2022
Takumi Minamino,JPN,"FW,MF",Liverpool,26,1995,2.1,3,2,1,1,1,2,8,25.0,6,2,0,2,1,4,2,0,Premier_League,2021_2022
Tyrone Mings,ENG,DF,Aston Villa,28,1993,35.4,23,12,17,3,3,14,22,63.6,8,47,30,17,46,69,153,2,Premier_League,2021_2022
Tyrick Mitchell,ENG,DF,Crystal Palace,21,1999,34.5,104,57,67,26,11,46,67,68.7,21,47,5,42,41,145,101,0,Premier_League,2021_2022
Jakub Moder,POL,MF,Brighton,22,1999,18.9,42,25,18,17,7,23,42,54.8,19,25,2,23,10,52,22,1,Premier_League,2021_2022
Wesley Moraes,BRA,FW,Aston Villa,24,1996,0.0,0,0,0,0,0,0,0,,0,0,0,0,0,0,0,0,Premier_League,2021_2022
Tyler Morton,ENG,MF,Liverpool,18,2002,0.7,0,0,0,0,0,0,2,0.0,2,0,0,0,3,3,0,0,Premier_League,2021_2022
Mason Mount,ENG,MF,Chelsea,22,1999,26.3,41,16,10,17,14,10,34,29.4,24,18,1,17,13,54,12,0,Premier_League,2021_2022
Lucas Moura,BRA,"FW,MF",Tottenham,28,1992,19.7,25,10,7,14,4,8,35,22.9,27,19,0,19,18,43,19,0,Premier_League,2021_2022
João Moutinho,POR,MF,Wolves,34,1986,33.0,74,39,34,27,13,30,106,28.3,76,48,8,40,34,108,36,2,Premier_League,2021_2022
Bali Mumba,ENG,DF,Norwich City,19,2001,0.5,1,1,1,0,0,0,0,,0,0,0,0,0,1,5,0,Premier_League,2021_2022
Jacob Murphy,ENG,"FW,DF",Newcastle Utd,26,1995,16.4,49,26,34,11,4,26,41,63.4,15,20,2,18,23,72,17,0,Premier_League,2021_2022
Enock Mwepu,ZAM,MF,Brighton,23,1998,11.1,22,12,10,10,2,5,27,18.5,22,20,2,18,12,34,19,0,Premier_League,2021_2022
Vitaliy Mykolenko,UKR,DF,Everton,22,1999,11.7,25,15,15,7,3,12,21,57.1,9,15,2,13,16,41,37,0,Premier_League,2021_2022
Marvelous Nakamba,ZIM,MF,Aston Villa,27,1994,10.0,32,19,18,14,0,12,34,35.3,22,14,4,10,12,44,17,1,Premier_League,2021_2022
Wilfred Ndidi,NGA,"MF,DF",Leicester City,24,1996,18.0,60,32,32,27,1,22,55,40.0,33,36,8,28,42,102,54,1,Premier_League,2021_2022
Tanguy Ndombele,FRA,MF,Tottenham,24,1996,5.4,10,7,3,5,2,1,8,12.5,7,5,0,5,1,11,1,0,Premier_League,2021_2022
Reiss Nelson,ENG,FW,Arsenal,21,1999,0.2,1,0,0,0,1,0,1,0.0,1,1,0,1,0,1,0,0,Premier_League,2021_2022
Pedro Neto,POR,"FW,MF",Wolves,21,2000,5.2,4,4,2,0,2,0,9,0.0,9,0,0,0,6,10,1,0,Premier_League,2021_2022
Rúben Neves,POR,MF,Wolves,24,1997,29.6,68,37,23,41,4,24,87,27.6,63,39,5,34,41,109,49,3,Premier_League,2021_2022
Jeremy Ngakia,ENG,DF,Watford,20,2000,10.0,31,18,23,5,3,11,26,42.3,15,11,4,7,12,43,32,0,Premier_League,2021_2022
Saúl Ñíguez,ESP,"DF,MF",Chelsea,26,1994,5.3,20,9,11,9,0,9,16,56.3,7,14,3,11,7,27,10,1,Premier_League,2021_2022
Eddie Nketiah,ENG,FW,Arsenal,22,1999,9.3,9,4,1,4,4,1,4,25.0,3,9,2,7,4,13,5,0,Premier_League,2021_2022
Nicolas Nkoulou,CMR,DF,Watford,31,1990,1.9,1,0,0,1,0,0,0,,0,2,1,1,2,3,8,0,Premier_League,2021_2022
Mark Noble,ENG,MF,West Ham,34,1987,3.7,8,2,7,1,0,5,11,45.5,6,4,1,3,4,12,2,1,Premier_League,2021_2022
Mathias Normann,NOR,MF,Norwich City,25,1996,18.3,34,21,19,14,1,17,46,37.0,29,17,8,9,19,53,43,1,Premier_League,2021_2022
Christian Nørgaard,DEN,MF,Brentford,27,1994,33.9,109,60,42,58,9,52,101,51.5,49,48,9,39,64,173,58,1,Premier_League,2021_2022
Angelo Ogbonna,ITA,DF,West Ham,33,1988,10.2,7,4,5,2,0,3,7,42.9,4,5,4,1,11,18,29,0,Premier_League,2021_2022
Michael Olise,FRA,"FW,MF",Crystal Palace,19,2001,12.7,22,18,8,11,3,7,24,29.2,17,17,0,17,6,28,6,0,Premier_League,2021_2022
Robin Olsen,SWE,GK,Aston Villa,31,1990,1.0,0,0,0,0,0,0,0,,0,0,0,0,0,0,0,0,Premier_League,2021_2022
Andrew Omobamidele,IRL,DF,Norwich City,19,2002,4.2,8,6,5,3,0,5,11,45.5,6,8,8,0,5,13,13,0,Premier_League,2021_2022
Tyler Onyango,ENG,MF,Everton,18,2003,0.3,0,0,0,0,0,0,0,,0,0,0,0,0,0,1,0,Premier_League,2021_2022
Frank Onyeka,NGA,MF,Brentford,23,1998,11.6,25,17,13,9,3,8,27,29.6,19,16,2,14,14,39,13,0,Premier_League,2021_2022
Divock Origi,BEL,FW,Liverpool,26,1995,1.5,0,0,0,0,0,0,2,0.0,2,1,0,1,1,1,2,0,Premier_League,2021_2022
Alex Oxlade-Chamberlain,ENG,"MF,FW",Liverpool,27,1993,8.7,15,11,2,8,5,3,14,21.4,11,12,2,10,6,21,5,0,Premier_League,2021_2022
Cole Palmer,ENG,"FW,MF",Manchester City,19,2002,1.4,2,1,1,1,0,0,2,0.0,2,3,0,3,1,3,0,0,Premier_League,2021_2022
Emerson Palmieri,ITA,DF,Chelsea,26,1994,0.1,0,0,0,0,0,0,0,,0,0,0,0,0,0,0,0,Premier_League,2021_2022
Thomas Partey,GHA,MF,Arsenal,28,1993,22.5,43,29,22,17,4,18,44,40.9,26,22,4,18,23,66,35,2,Premier_League,2021_2022
Nicolas Pépé,CIV,"FW,MF",Arsenal,26,1995,7.7,8,5,3,5,0,3,9,33.3,6,9,1,8,8,16,2,0,Premier_League,2021_2022
Ricardo Pereira,POR,DF,Leicester City,27,1993,11.0,37,20,19,13,5,21,40,52.5,19,13,1,12,17,54,39,0,Premier_League,2021_2022
Ayoze Pérez,ESP,"MF,FW",Leicester City,28,1993,4.9,4,2,0,3,1,0,13,0.0,13,11,1,10,2,6,5,0,Premier_League,2021_2022
Sonny Perkins,ENG,MF,West Ham,17,2004,0.0,0,0,0,0,0,0,0,,0,0,0,0,0,0,0,0,Premier_League,2021_2022
Romain Perraud,FRA,DF,Southampton,23,1997,18.0,34,22,18,14,2,16,29,55.2,13,24,6,18,17,51,42,0,Premier_League,2021_2022
Kalvin Phillips,ENG,MF,Leeds United,25,1995,17.7,54,25,24,25,5,24,57,42.1,33,37,9,28,24,78,18,0,Premier_League,2021_2022
Jaden Philogene Bidace,ENG,FW,Aston Villa,19,2002,0.1,0,0,0,0,0,0,0,,0,0,0,0,0,0,0,0,Premier_League,2021_2022
Jordan Pickford,ENG,GK,Everton,27,1994,35.0,1,1,1,0,0,0,1,0.0,1,1,0,1,1,2,14,1,Premier_League,2021_2022
Erik Pieters,NED,DF,Burnley,32,1988,8.1,28,15,15,11,2,17,28,60.7,11,18,7,11,10,38,38,0,Premier_League,2021_2022
Ethan Pinnock,JAM,DF,Brentford,28,1993,29.9,51,35,37,12,2,25,38,65.8,13,30,11,19,44,95,154,1,Premier_League,2021_2022
Daniel Podence,POR,"FW,MF",Wolves,25,1995,16.5,18,11,10,5,3,4,17,23.5,13,8,1,7,10,28,1,0,Premier_League,2021_2022
Paul Pogba,FRA,"MF,FW",Manchester Utd,28,1993,15.0,13,9,5,7,1,6,28,21.4,22,11,0,11,13,26,16,0,Premier_League,2021_2022
Nick Pope,ENG,GK,Burnley,29,1992,36.0,0,0,0,0,0,0,2,0.0,2,0,0,0,2,2,30,3,Premier_League,2021_2022
Isaac Price,NIR,MF,Everton,17,2003,0.2,0,0,0,0,0,0,0,,0,1,0,1,0,0,0,0,Premier_League,2021_2022
Teemu Pukki,FIN,FW,Norwich City,31,1990,36.1,23,11,2,14,7,6,29,20.7,23,21,1,20,4,27,3,0,Premier_League,2021_2022
Christian Pulisic,USA,"MF,FW",Chelsea,22,1998,14.3,10,7,6,3,1,3,17,17.6,14,12,0,12,5,15,10,0,Premier_League,2021_2022
Przemysław Płacheta,POL,"FW,MF",Norwich City,23,1998,5.6,4,3,3,1,0,2,7,28.6,5,3,1,2,2,6,5,1,Premier_League,2021_2022
Jesurun Rak Sakyi,ENG,"FW,MF",Crystal Palace,18,2002,0.9,0,0,0,0,0,0,1,0.0,1,3,0,3,1,1,0,0,Premier_League,2021_2022
Aaron Ramsdale,ENG,GK,Arsenal,23,1998,34.0,2,1,2,0,0,1,2,50.0,1,0,0,0,0,2,26,3,Premier_League,2021_2022
Jacob Ramsey,ENG,MF,Aston Villa,20,2001,27.4,67,44,31,28,8,30,69,43.5,39,36,7,29,24,91,28,0,Premier_League,2021_2022
Raphinha,BRA,"FW,MF",Leeds United,24,1996,32.4,51,29,25,14,12,22,71,31.0,49,43,0,43,29,80,28,1,Premier_League,2021_2022
Marcus Rashford,ENG,"FW,MF",Manchester Utd,23,1997,13.7,6,5,1,4,1,2,13,15.4,11,10,1,9,5,11,5,1,Premier_League,2021_2022
Milot Rashica,KVX,"FW,MF",Norwich City,25,1996,24.8,31,19,12,12,7,11,30,36.7,19,22,3,19,15,46,23,0,Premier_League,2021_2022
David Raya,ESP,GK,Brentford,25,1995,24.0,0,0,0,0,0,0,0,,0,1,0,1,0,0,10,1,Premier_League,2021_2022
Nathan Redmond,ENG,"MF,FW",Southampton,27,1994,20.4,22,14,9,9,4,7,30,23.3,23,21,2,19,8,30,16,0,Premier_League,2021_2022
Sergio Reguilón,ESP,"DF,MF",Tottenham,24,1996,21.3,40,24,15,18,7,22,43,51.2,21,20,8,12,31,71,45,1,Premier_League,2021_2022
Declan Rice,ENG,MF,West Ham,22,1999,35.3,80,42,45,32,3,38,71,53.5,33,45,21,24,63,143,52,1,Premier_League,2021_2022
Taylor Richards,ENG,MF,Brighton,20,2000,0.3,1,0,0,1,0,1,2,50.0,1,0,0,0,0,1,0,0,Premier_League,2021_2022
Richarlison,BRA,FW,Everton,24,1997,28.0,40,23,18,15,7,15,31,48.4,16,42,4,38,12,52,34,0,Premier_League,2021_2022
Jaïro Riedewald,NED,MF,Crystal Palace,24,1996,1.3,1,1,0,1,0,1,2,50.0,1,1,0,1,1,2,2,0,Premier_League,2021_2022
Matt Ritchie,SCO,DF,Newcastle Utd,31,1989,14.9,22,15,10,10,2,10,27,37.0,17,10,2,8,13,35,26,0,Premier_League,2021_2022
Connor Roberts,WAL,DF,Burnley,25,1995,18.8,20,13,10,7,3,10,15,66.7,5,25,5,20,22,42,62,1,Premier_League,2021_2022
Tyler Roberts,WAL,"MF,FW",Leeds United,22,1999,11.0,16,7,6,7,3,9,16,56.3,7,11,1,10,5,21,11,0,Premier_League,2021_2022
Andrew Robertson,SCO,DF,Liverpool,27,1994,28.2,36,21,16,15,5,20,35,57.1,15,24,3,21,23,59,61,0,Premier_League,2021_2022
Joe Rodon,WAL,DF,Tottenham,23,1997,1.0,0,0,0,0,0,0,0,,0,2,1,1,0,0,7,0,Premier_League,2021_2022
Rodri,ESP,MF,Manchester City,25,1996,32.0,72,43,24,38,10,32,59,54.2,27,28,5,23,28,100,45,0,Premier_League,2021_2022
Rodrigo,ESP,"MF,FW",Leeds United,30,1991,25.2,20,9,7,6,7,4,32,12.5,28,12,0,12,11,31,27,1,Premier_League,2021_2022
Jay Rodriguez,ENG,FW,Burnley,32,1989,15.4,20,12,8,8,4,4,14,28.6,10,19,1,18,4,24,12,0,Premier_League,2021_2022
Mads Roerslev,DEN,DF,Brentford,22,1999,13.8,23,12,19,2,2,14,32,43.8,18,14,5,9,16,39,29,0,Premier_League,2021_2022
Cristian Romero,ARG,DF,Tottenham,23,1998,20.5,62,39,39,21,2,22,34,64.7,12,46,21,25,33,95,74,1,Premier_League,2021_2022
Oriol Romeu,ESP,MF,Southampton,29,1991,32.1,77,39,25,45,7,28,73,38.4,45,39,8,31,51,128,43,0,Premier_League,2021_2022
Cristiano Ronaldo,POR,FW,Manchester Utd,36,1985,27.3,8,6,1,5,2,2,6,33.3,4,8,0,8,2,10,29,0,Premier_League,2021_2022
Salomón Rondón,VEN,FW,Everton,31,1989,8.8,6,1,1,2,3,4,14,28.6,10,5,0,5,0,6,10,0,Premier_League,2021_2022
Danny Rose,ENG,DF,Watford,31,1990,7.7,16,10,11,4,1,10,24,41.7,14,8,5,3,14,30,11,1,Premier_League,2021_2022
Jon Rowe,ENG,"FW,MF",Norwich City,18,2003,2.5,3,2,2,1,0,2,3,66.7,1,7,0,7,3,6,1,0,Premier_League,2021_2022
John Ruddy,ENG,GK,Wolves,34,1986,1.5,0,0,0,0,0,0,0,,0,0,0,0,0,0,3,0,Premier_League,2021_2022
Antonio Rüdiger,GER,DF,Chelsea,28,1993,33.7,48,28,29,15,4,36,48,75.0,12,20,11,9,28,76,91,1,Premier_League,2021_2022
Lukas Rupp,GER,MF,Norwich City,30,1991,8.5,9,4,5,3,1,4,15,26.7,11,11,1,10,9,18,7,0,Premier_League,2021_2022
José Sá,POR,GK,Wolves,28,1993,36.5,2,1,2,0,0,2,4,50.0,2,0,0,0,2,4,19,5,Premier_League,2021_2022
Allan Saint-Maximin,FRA,"FW,MF",Newcastle Utd,24,1997,31.2,13,8,6,4,3,3,17,17.6,14,13,2,11,11,24,3,0,Premier_League,2021_2022
Romain Saïss,MAR,DF,Wolves,31,1990,30.1,40,27,28,11,1,19,33,57.6,14,41,21,20,58,98,158,2,Premier_League,2021_2022
Bukayo Saka,ENG,"FW,MF",Arsenal,19,2001,33.1,40,21,12,17,11,13,39,33.3,26,28,2,26,22,62,23,0,Premier_League,2021_2022
Mohamed Salah,EGY,FW,Liverpool,29,1992,30.7,17,8,5,9,3,6,19,31.6,13,7,1,6,6,23,5,0,Premier_League,2021_2022
Mohammed Salisu,GHA,DF,Southampton,22,1999,33.0,80,47,54,22,4,40,65,61.5,25,49,26,23,78,158,158,4,Premier_League,2021_2022
Albert Sambi Lokonga,BEL,MF,Arsenal,21,1999,12.6,22,18,11,9,2,12,14,85.7,2,12,7,5,13,35,12,4,Premier_League,2021_2022
Davinson Sánchez,COL,DF,Tottenham,25,1996,18.1,41,22,25,14,2,19,28,67.9,9,24,16,8,30,71,54,3,Premier_League,2021_2022
Robert Sánchez,ESP,GK,Brighton,23,1997,37.0,2,1,2,0,0,1,1,100.0,0,1,0,1,0,2,11,4,Premier_League,2021_2022
Jadon Sancho,ENG,"FW,MF",Manchester Utd,21,2000,21.1,14,8,9,4,1,8,22,36.4,14,19,0,19,15,29,5,3,Premier_League,2021_2022
Morgan Sanson,FRA,MF,Aston Villa,26,1994,4.0,12,8,7,2,3,3,7,42.9,4,13,0,13,10,22,2,1,Premier_League,2021_2022
Samir Santos,BRA,DF,Watford,26,1994,18.6,24,11,18,6,0,8,19,42.1,11,21,11,10,43,67,85,3,Premier_League,2021_2022
Josh Sargent,USA,"FW,MF",Norwich City,21,2000,17.5,26,14,15,7,4,14,39,35.9,25,29,2,27,11,37,18,2,Premier_League,2021_2022
Jeremy Sarmiento,ECU,"FW,MF",Brighton,19,2002,0.5,1,1,0,0,1,0,2,0.0,2,2,0,2,0,1,0,0,Premier_League,2021_2022
Ismaila Sarr,SEN,"FW,MF",Watford,23,1998,20.7,12,7,4,3,5,5,19,26.3,14,10,1,9,9,21,10,0,Premier_League,2021_2022
Malang Sarr,FRA,DF,Chelsea,22,1999,6.1,14,7,10,2,2,7,12,58.3,5,6,3,3,11,25,20,0,Premier_League,2021_2022
Dane Scarlett,ENG,MF,Tottenham,17,2004,0.0,0,0,0,0,0,0,0,,0,0,0,0,0,0,0,0,Premier_League,2021_2022
Fabian Schär,SUI,DF,Newcastle Utd,29,1991,24.0,16,11,11,3,2,8,16,50.0,8,27,18,9,32,48,95,2,Premier_League,2021_2022
Jeffrey Schlupp,GHA,"MF,FW",Crystal Palace,28,1992,20.6,46,25,16,23,7,24,50,48.0,26,39,9,30,18,64,32,0,Premier_League,2021_2022
Kasper Schmeichel,DEN,GK,Leicester City,34,1986,37.0,0,0,0,0,0,0,2,0.0,2,0,0,0,1,1,15,2,Premier_League,2021_2022
Ken Sema,SWE,"MF,FW",Watford,27,1993,9.5,16,6,11,4,1,9,20,45.0,11,10,0,10,5,21,11,0,Premier_League,2021_2022
Nélson Semedo,POR,"MF,DF",Wolves,27,1993,23.7,58,39,39,17,2,25,49,51.0,24,23,4,19,21,79,64,1,Premier_League,2021_2022
Ryan Sessegnon,ENG,"DF,MF",Tottenham,21,2000,11.6,25,19,14,7,4,11,22,50.0,11,18,3,15,7,32,26,0,Premier_League,2021_2022
Jamie Shackleton,ENG,"DF,MF",Leeds United,21,1999,7.9,27,16,19,7,1,13,25,52.0,12,11,7,4,8,35,12,1,Premier_League,2021_2022
Luke Shaw,ENG,DF,Manchester Utd,26,1995,17.8,21,13,9,9,3,12,21,57.1,9,22,11,11,9,30,22,2,Premier_League,2021_2022
Jonjo Shelvey,ENG,MF,Newcastle Utd,29,1992,22.0,30,17,12,18,0,14,34,41.2,20,22,7,15,22,52,20,2,Premier_League,2021_2022
Shola Shoretire,ENG,MF,Manchester Utd,17,2004,0.2,0,0,0,0,0,0,0,,0,0,0,0,0,0,0,0,Premier_League,2021_2022
Francisco Sierralta,CHI,DF,Watford,24,1997,4.7,7,3,7,0,0,5,8,62.5,3,7,2,5,6,13,35,0,Premier_League,2021_2022
Bernardo Silva,POR,"MF,FW",Manchester City,26,1994,31.7,57,29,19,19,19,31,67,46.3,36,24,2,22,20,77,19,0,Premier_League,2021_2022
Fábio Silva,POR,FW,Wolves,19,2002,6.4,3,2,0,2,1,0,8,0.0,8,2,0,2,1,4,1,0,Premier_League,2021_2022
Thiago Silva,BRA,DF,Chelsea,36,1984,29.4,32,21,19,12,1,11,22,50.0,11,54,31,23,44,76,100,0,Premier_League,2021_2022
Ellis Simms,ENG,FW,Everton,20,2001,0.7,0,0,0,0,0,0,0,,0,1,1,0,0,0,1,0,Premier_League,2021_2022
Moussa Sissoko,FRA,MF,Watford,31,1989,35.8,53,27,27,20,6,28,42,66.7,14,42,13,29,30,83,64,0,Premier_League,2021_2022
Oliver Skipp,ENG,MF,Tottenham,20,2000,15.0,33,19,14,18,1,15,31,48.4,16,19,7,12,12,45,10,1,Premier_League,2021_2022
William Smallbone,IRL,"MF,FW",Southampton,21,2000,1.5,4,4,2,2,0,1,3,33.3,2,4,0,4,2,6,0,0,Premier_League,2021_2022
Emile Smith Rowe,ENG,"MF,FW",Arsenal,21,2000,21.3,14,7,7,7,0,4,20,20.0,16,18,1,17,15,29,10,1,Premier_League,2021_2022
Cédric Soares,POR,DF,Arsenal,29,1991,16.5,38,26,23,9,6,16,25,64.0,9,18,7,11,16,54,31,1,Premier_League,2021_2022
Tomáš Souček,CZE,MF,West Ham,26,1995,34.0,66,32,27,33,6,28,65,43.1,37,34,13,21,52,118,98,1,Premier_League,2021_2022
Boubakary Soumaré,FRA,MF,Leicester City,22,1999,12.2,19,13,10,8,1,8,17,47.1,9,13,1,12,14,33,18,0,Premier_League,2021_2022
Çağlar Söyüncü,TUR,DF,Leicester City,25,1996,27.7,47,30,32,12,3,26,42,61.9,16,44,27,17,32,79,115,1,Premier_League,2021_2022
Tony Springett,IRL,"MF,FW",Norwich City,18,2002,1.6,2,1,1,1,0,1,4,25.0,3,0,0,0,0,2,2,0,Premier_League,2021_2022
Jason Steele,ENG,GK,Brighton,30,1990,1.0,0,0,0,0,0,0,0,,0,0,0,0,0,0,0,0,Premier_League,2021_2022
Jed Steer,ENG,GK,Aston Villa,28,1992,1.0,0,0,0,0,0,0,0,,0,0,0,0,0,0,0,0,Premier_League,2021_2022
Zack Steffen,USA,GK,Manchester City,26,1995,1.0,0,0,0,0,0,0,0,,0,0,0,0,0,0,2,0,Premier_League,2021_2022
Dale Stephens,ENG,MF,Burnley,32,1989,1.4,4,1,0,3,1,3,8,37.5,5,4,1,3,1,5,1,0,Premier_League,2021_2022
Jack Stephens,ENG,DF,Southampton,27,1994,9.0,19,12,13,5,1,6,16,37.5,10,12,7,5,19,38,42,0,Premier_League,2021_2022
Raheem Sterling,ENG,FW,Manchester City,26,1994,23.6,23,10,3,11,9,10,23,43.5,13,12,0,12,12,35,3,0,Premier_League,2021_2022
Finley Stevens,WAL,DF,Brentford,18,2003,0.2,3,1,0,3,0,1,1,100.0,0,0,0,0,0,3,0,0,Premier_League,2021_2022
John Stones,ENG,DF,Manchester City,27,1994,12.4,5,3,3,2,0,2,3,66.7,1,3,3,0,11,16,27,1,Premier_League,2021_2022
Pascal Struijk,NED,"DF,MF",Leeds United,21,1999,22.8,61,39,34,23,4,30,50,60.0,20,35,23,12,33,94,60,2,Premier_League,2021_2022
Crysencio Summerville,NED,"MF,FW",Leeds United,19,2001,1.4,5,3,1,1,3,2,3,66.7,1,2,0,2,2,7,0,0,Premier_League,2021_2022
Jakob Sørensen,DEN,"MF,DF",Norwich City,23,1998,6.7,22,11,6,14,2,10,20,50.0,10,7,3,4,10,32,19,0,Premier_League,2021_2022
Japhet Tanganga,ENG,DF,Tottenham,22,1999,8.2,14,8,7,6,1,9,19,47.4,10,13,5,8,9,23,31,0,Premier_League,2021_2022
Matt Targett,ENG,DF,Aston Villa,25,1995,15.9,34,18,28,5,1,24,45,53.3,21,16,9,7,23,57,35,0,Premier_League,2021_2022
Matt Targett,ENG,DF,Newcastle Utd,25,1995,16.0,41,26,26,14,1,24,37,64.9,13,15,4,11,25,66,39,1,Premier_League,2021_2022
James Tarkowski,ENG,DF,Burnley,28,1992,34.5,65,45,47,17,1,33,47,70.2,14,75,61,14,48,113,186,4,Premier_League,2021_2022
Nuno Tavares,POR,DF,Arsenal,21,2000,13.1,21,14,10,7,4,8,18,44.4,10,15,5,10,9,30,33,1,Premier_League,2021_2022
Charlie Taylor,ENG,DF,Burnley,27,1993,30.3,45,26,31,11,3,26,44,59.1,18,42,20,22,58,103,95,2,Premier_League,2021_2022
Nathan Tella,NGA,"MF,FW",Southampton,22,1999,8.9,13,9,5,7,1,6,17,35.3,11,13,0,13,6,19,9,0,Premier_League,2021_2022
Alex Telles,BRA,DF,Manchester Utd,28,1992,18.4,48,27,35,9,4,27,43,62.8,16,17,4,13,26,74,45,0,Premier_League,2021_2022
Luke Thomas,ENG,DF,Leicester City,20,2001,21.2,50,31,33,13,4,28,65,43.1,37,35,14,21,40,90,55,0,Premier_League,2021_2022
Dominic Thompson,ENG,DF,Brentford,21,2000,1.6,1,0,1,0,0,0,1,0.0,1,2,2,0,2,3,3,0,Premier_League,2021_2022
Youri Tielemans,BEL,MF,Leicester City,24,1997,29.2,74,38,23,45,6,42,100,42.0,58,47,13,34,21,95,41,3,Premier_League,2021_2022
Kieran Tierney,SCO,DF,Arsenal,24,1997,21.3,18,14,11,7,0,10,11,90.9,1,23,5,18,15,33,54,0,Premier_League,2021_2022
Takehiro Tomiyasu,JPN,DF,Arsenal,22,1998,18.7,35,17,19,13,3,21,32,65.6,11,22,3,19,24,59,64,2,Premier_League,2021_2022
James Tomkins,ENG,DF,Crystal Palace,32,1989,6.1,8,3,6,2,0,6,8,75.0,2,8,8,0,4,12,18,0,Premier_League,2021_2022
Ivan Toney,ENG,FW,Brentford,25,1996,32.3,33,21,5,20,8,12,38,31.6,26,16,2,14,14,47,44,1,Premier_League,2021_2022
Ferrán Torres,ESP,FW,Manchester City,21,2000,3.4,2,2,0,1,1,0,3,0.0,3,2,0,2,0,2,1,0,Premier_League,2021_2022
Cenk Tosun,TUR,MF,Everton,30,1991,0.1,0,0,0,0,0,0,0,,0,0,0,0,0,0,0,0,Premier_League,2021_2022
Andros Townsend,ENG,"MF,FW",Everton,30,1991,16.2,31,17,15,6,10,15,40,37.5,25,28,2,26,14,45,6,1,Premier_League,2021_2022
Adama Traoré,ESP,"FW,MF",Wolves,25,1996,11.9,8,3,6,0,2,3,7,42.9,4,4,1,3,2,10,1,0,Premier_League,2021_2022
Bertrand Traoré,BFA,"MF,FW",Aston Villa,25,1995,2.4,3,3,0,1,2,1,2,50.0,1,0,0,0,0,3,1,0,Premier_League,2021_2022
Trézéguet,EGY,FW,Aston Villa,26,1994,0.1,0,0,0,0,0,0,0,,0,0,0,0,0,0,0,0,Premier_League,2021_2022
Francisco Trincão,POR,"FW,MF",Wolves,21,1999,14.8,28,15,9,13,6,3,19,15.8,16,17,1,16,12,40,1,1,Premier_League,2021_2022
Kieran Trippier,ENG,DF,Newcastle Utd,30,1990,4.8,17,10,8,8,1,10,16,62.5,6,10,3,7,10,27,10,0,Premier_League,2021_2022
William Troost-Ekong,NGA,DF,Watford,27,1993,15.4,18,9,11,6,1,10,15,66.7,5,24,14,10,7,25,82,1,Premier_League,2021_2022
Leandro Trossard,BEL,"FW,MF",Brighton,26,1994,31.2,34,20,12,9,13,4,31,12.9,27,33,4,29,15,49,10,0,Premier_League,2021_2022
Kostas Tsimikas,GRE,DF,Liverpool,25,1996,9.7,27,12,12,8,7,12,16,75.0,4,6,2,4,10,37,22,2,Premier_League,2021_2022
Axel Tuanzebe,COD,DF,Aston Villa,23,1997,5.6,5,3,3,2,0,2,5,40.0,3,5,4,1,5,10,12,1,Premier_League,2021_2022
Ozan Tufan,TUR,MF,Watford,26,1995,3.7,3,2,1,1,1,1,5,20.0,4,2,0,2,2,5,4,0,Premier_League,2021_2022
Christos Tzolis,GRE,"FW,MF",Norwich City,19,2002,3.7,5,3,3,1,1,2,9,22.2,7,3,0,3,1,6,1,0,Premier_League,2021_2022
Yan Valery,TUN,DF,Southampton,22,1999,4.1,8,6,4,3,1,4,9,44.4,5,6,3,3,6,14,19,1,Premier_League,2021_2022
Virgil van Dijk,NED,DF,Liverpool,30,1991,34.0,16,10,11,5,0,11,16,68.8,5,21,14,7,31,47,109,0,Premier_League,2021_2022
Raphaël Varane,FRA,DF,Manchester Utd,28,1993,20.3,28,19,21,6,1,10,22,45.5,12,18,9,9,18,46,82,1,Premier_League,2021_2022
Jamie Vardy,ENG,FW,Leicester City,34,1987,20.1,6,5,0,4,2,1,7,14.3,6,9,0,9,1,7,17,0,Premier_League,2021_2022
Joël Veltman,NED,DF,Brighton,29,1992,31.9,74,48,47,21,6,21,53,39.6,32,46,16,30,45,119,89,0,Premier_League,2021_2022
Jannik Vestergaard,DEN,DF,Leicester City,28,1992,6.3,15,10,12,3,0,8,15,53.3,7,10,8,2,7,22,36,0,Premier_League,2021_2022
Nikola Vlašić,CRO,"FW,MF",West Ham,23,1997,6.2,11,7,4,6,1,5,20,25.0,15,4,0,4,2,13,1,0,Premier_League,2021_2022
Matěj Vydra,CZE,FW,Burnley,29,1992,7.5,12,7,3,4,5,3,7,42.9,4,5,1,4,0,12,9,0,Premier_League,2021_2022
Theo Walcott,ENG,"MF,FW",Southampton,32,1989,4.2,4,2,2,0,2,1,5,20.0,4,3,0,3,5,9,2,0,Premier_League,2021_2022
Kyle Walker,ENG,DF,Manchester City,31,1990,19.5,15,6,7,7,1,8,17,47.1,9,14,4,10,14,29,16,1,Premier_League,2021_2022
Kyle Walker-Peters,ENG,DF,Southampton,24,1997,29.3,57,33,28,21,8,26,38,68.4,12,29,8,21,37,94,53,1,Premier_League,2021_2022
Aaron Wan-Bissaka,ENG,DF,Manchester Utd,23,1997,19.9,49,36,25,18,6,14,20,70.0,6,24,14,10,34,83,41,2,Premier_League,2021_2022
Danny Ward,WAL,GK,Leicester City,28,1993,1.0,0,0,0,0,0,0,0,,0,0,0,0,0,0,1,0,Premier_League,2021_2022
Joel Ward,ENG,DF,Crystal Palace,31,1989,27.6,44,26,30,11,3,30,57,52.6,27,24,11,13,32,76,107,1,Premier_League,2021_2022
James Ward-Prowse,ENG,MF,Southampton,26,1994,35.7,41,24,12,24,5,19,70,27.1,51,43,15,28,40,81,45,1,Premier_League,2021_2022
Ollie Watkins,ENG,FW,Aston Villa,25,1995,32.8,17,13,2,7,8,2,15,13.3,13,25,3,22,12,29,27,0,Premier_League,2021_2022
Adam Webster,ENG,DF,Brighton,26,1995,15.9,26,8,17,7,2,13,20,65.0,7,25,17,8,17,43,66,2,Premier_League,2021_2022
Wout Weghorst,NED,FW,Burnley,28,1992,16.1,17,9,3,9,5,6,19,31.6,13,16,5,11,6,23,13,0,Premier_League,2021_2022
Danny Welbeck,ENG,"FW,MF",Brighton,30,1990,16.4,14,7,2,8,4,3,10,30.0,7,18,2,16,5,19,18,0,Premier_League,2021_2022
Timo Werner,GER,"FW,MF",Chelsea,25,1996,14.3,8,4,3,3,2,2,20,10.0,18,9,0,9,2,10,4,0,Premier_League,2021_2022
Ashley Westwood,ENG,MF,Burnley,31,1990,25.4,21,12,8,12,1,10,31,32.3,21,21,9,12,30,51,16,1,Premier_League,2021_2022
Ben White,ENG,DF,Arsenal,23,1997,32.0,44,23,30,8,6,28,45,62.2,17,42,24,18,42,86,102,0,Premier_League,2021_2022
Brandon Williams,ENG,DF,Norwich City,20,2000,23.6,55,37,35,18,2,36,64,56.3,28,26,6,20,44,99,50,0,Premier_League,2021_2022
Neco Williams,WAL,DF,Liverpool,20,2001,0.1,0,0,0,0,0,0,0,,0,0,0,0,0,0,0,0,Premier_League,2021_2022
Joe Willock,ENG,MF,Newcastle Utd,21,1999,22.6,64,37,30,28,6,29,68,42.6,39,37,6,31,21,85,10,1,Premier_League,2021_2022
Callum Wilson,ENG,FW,Newcastle Utd,29,1992,15.4,9,8,1,5,3,1,4,25.0,3,7,2,5,3,12,10,0,Premier_League,2021_2022
Harry Winks,ENG,MF,Tottenham,25,1996,10.1,15,10,4,9,2,8,21,38.1,13,14,3,11,16,31,10,2,Premier_League,2021_2022
Yoane Wissa,COD,FW,Brentford,24,1996,14.3,12,6,5,4,3,1,16,6.3,15,12,5,7,8,20,6,0,Premier_League,2021_2022
Chris Wood,NZL,FW,Burnley,29,1991,15.2,7,5,0,3,4,3,10,30.0,7,13,4,9,0,7,3,0,Premier_League,2021_2022
Chris Wood,NZL,FW,Newcastle Utd,29,1991,14.7,2,0,1,1,0,1,2,50.0,1,5,2,3,2,4,9,0,Premier_League,2021_2022
Freddie Woodman,ENG,GK,Newcastle Utd,24,1997,4.0,0,0,0,0,0,0,0,,0,0,0,0,0,0,0,1,Premier_League,2021_2022
Granit Xhaka,SUI,"MF,DF",Arsenal,28,1992,25.9,32,18,16,12,4,16,41,39.0,25,21,6,15,21,53,31,0,Premier_League,2021_2022
Andriy Yarmolenko,UKR,"FW,MF",West Ham,31,1989,3.5,4,2,2,2,0,2,8,25.0,6,4,2,2,0,4,2,0,Premier_League,2021_2022
Ashley Young,ENG,"DF,FW",Aston Villa,36,1985,13.9,18,6,9,6,3,11,16,68.8,5,10,4,6,13,31,25,1,Premier_League,2021_2022
Nathan Young-Coombes,ENG,MF,Brentford,18,2003,0.0,0,0,0,0,0,0,0,,0,0,0,0,0,0,0,0,Premier_League,2021_2022
Wilfried Zaha,CIV,FW,Crystal Palace,28,1992,30.7,40,20,14,15,11,10,31,32.3,21,28,0,28,5,45,5,0,Premier_League,2021_2022
Christoph Zimmermann,GER,DF,Norwich City,28,1993,1.7,6,3,5,1,0,3,4,75.0,1,0,0,0,1,7,4,0,Premier_League,2021_2022
Oleksandr Zinchenko,UKR,DF,Manchester City,24,1996,11.6,20,14,7,10,3,11,20,55.0,9,11,3,8,14,34,15,1,Premier_League,2021_2022
Hakim Ziyech,MAR,"MF,FW",Chelsea,28,1993,14.7,19,10,5,12,2,10,36,27.8,26,11,1,10,10,29,10,0,Premier_League,2021_2022
Kurt Zouma,FRA,DF,West Ham,26,1994,23.1,11,6,8,3,0,4,7,57.1,3,31,26,5,34,45,132,0,Premier_League,2021_2022
Martin Ødegaard,NOR,"MF,FW",Arsenal,22,1998,30.9,49,21,6,24,19,22,61,36.1,39,18,1,17,11,60,11,1,Premier_League,2021_2022
Yunis Abdelhamid,MAR,DF,Reims,33,1987,33.1,48,27,34,14,0,16,32,50.0,16,50,25,25,68,116,104,0,Ligue_1,2021_2022
Salis Abdul Samed,GHA,MF,Clermont Foot,21,2000,27.4,43,23,25,16,2,20,57,35.1,37,18,1,17,42,85,15,0,Ligue_1,2021_2022
Laurent Abergel,FRA,MF,Lorient,28,1993,32.8,110,60,44,53,13,71,166,42.8,95,58,1,57,55,165,13,0,Ligue_1,2021_2022
Charles Abi,FRA,FW,Saint-Étienne,21,2000,0.5,0,0,0,0,0,0,1,0.0,1,2,0,2,0,0,0,0,Ligue_1,2021_2022
Matthis Abline,FRA,FW,Rennes,18,2003,1.1,0,0,0,0,0,0,0,,0,2,0,2,0,0,1,0,Ligue_1,2021_2022
Mohamed Achi,FRA,MF,Nantes,19,2002,0.1,0,0,0,0,0,0,0,,0,0,0,0,0,0,0,0,Ligue_1,2021_2022
Martin Adeline,FRA,"MF,FW",Reims,17,2003,3.9,15,11,5,8,2,8,16,50.0,8,0,0,0,11,26,6,0,Ligue_1,2021_2022
Yacine Adli,FRA,"MF,FW",Bordeaux,21,2000,25.1,43,27,22,14,7,19,68,27.9,49,33,3,30,37,80,11,2,Ligue_1,2021_2022
Lucien Agoume,FRA,MF,Brest,19,2002,20.8,51,31,24,20,7,23,45,51.1,22,30,9,21,52,103,27,1,Ligue_1,2021_2022
Nayef Aguerd,MAR,DF,Rennes,25,1996,30.4,27,18,16,11,0,14,24,58.3,10,24,14,10,24,51,127,1,Ligue_1,2021_2022
Ruben Aguilar,FRA,DF,Monaco,28,1993,23.8,78,53,39,32,7,43,68,63.2,25,19,4,15,44,122,57,0,Ligue_1,2021_2022
Anel Ahmedhodžić,BIH,DF,Bordeaux,22,1999,15.0,38,26,27,9,2,20,31,64.5,11,16,8,8,22,60,44,0,Ligue_1,2021_2022
Jean-Eudes Aholou,CIV,MF,Strasbourg,27,1994,11.2,16,9,4,9,3,5,19,26.3,14,8,1,7,19,35,7,0,Ligue_1,2021_2022
Ludovic Ajorque,FRA,FW,Strasbourg,27,1994,30.4,36,25,5,19,12,7,40,17.5,33,28,3,25,8,44,31,1,Ligue_1,2021_2022
Maghnes Akliouche,FRA,"MF,FW",Monaco,19,2002,0.6,2,0,0,2,0,0,1,0.0,1,2,0,2,0,2,0,0,Ligue_1,2021_2022
Sofiane Alakouch,MAR,"DF,MF",Metz,23,1998,1.8,7,4,3,4,0,2,5,40.0,3,4,0,4,1,8,4,0,Ligue_1,2021_2022
Josué Albert,GUF,DF,Clermont Foot,29,1992,0.2,0,0,0,0,0,0,0,,0,0,0,0,1,1,2,0,Ligue_1,2021_2022
Doğan Alemdar,TUR,GK,Rennes,18,2002,12.0,0,0,0,0,0,0,0,,0,0,0,0,0,0,9,1,Ligue_1,2021_2022
Mohamed Ali Cho,FRA,FW,Angers,17,2004,20.4,10,5,1,4,5,5,17,29.4,12,17,1,16,8,18,0,1,Ligue_1,2021_2022
Jim Allevinah,GAB,FW,Clermont Foot,26,1995,16.5,18,13,8,8,2,5,18,27.8,13,11,0,11,6,24,4,0,Ligue_1,2021_2022
Ibrahim Amadou,FRA,"DF,MF",Metz,28,1993,9.0,16,8,10,6,0,8,15,53.3,7,4,2,2,14,30,26,0,Ligue_1,2021_2022
Jordan Amavi,FRA,DF,Nice,27,1994,4.6,16,10,8,7,1,10,17,58.8,7,3,1,2,15,31,7,0,Ligue_1,2021_2022
Jordan Amavi,FRA,"DF,FW",Marseille,27,1994,1.4,6,5,3,1,2,5,10,50.0,5,1,0,1,1,7,3,0,Ligue_1,2021_2022
Benjamin André,FRA,MF,Lille,30,1990,30.6,123,69,49,65,9,51,113,45.1,62,49,11,38,50,173,56,0,Ligue_1,2021_2022
Houssem Aouar,ALG,"MF,FW",Lyon,23,1998,27.8,46,30,9,25,12,27,54,50.0,27,26,1,25,20,66,5,0,Ligue_1,2021_2022
Adil Aouchiche,FRA,"MF,FW",Saint-Étienne,19,2002,12.0,13,6,5,5,3,5,33,15.2,28,18,1,17,17,30,4,0,Ligue_1,2021_2022
Dennis Appiah,FRA,DF,Nantes,29,1992,23.3,55,34,35,18,2,28,48,58.3,20,30,13,17,27,82,74,0,Ligue_1,2021_2022
Lorenz Assignon,TOG,DF,Rennes,21,2000,6.8,15,10,11,3,1,5,9,55.6,4,3,1,2,11,26,19,0,Ligue_1,2021_2022
Youcef Atal,ALG,DF,Nice,25,1996,12.7,29,19,17,10,2,14,25,56.0,11,13,2,11,32,61,21,0,Ligue_1,2021_2022
Jean-Kévin Augustin,FRA,"FW,MF",Nantes,24,1997,0.9,1,0,0,0,1,0,3,0.0,3,1,0,1,0,1,0,0,Ligue_1,2021_2022
Karim Azamoum,FRA,DF,Troyes,31,1990,4.3,6,5,4,2,0,3,5,60.0,2,4,2,2,1,7,10,0,Ligue_1,2021_2022
Loïc Bade,FRA,DF,Rennes,21,2000,10.9,6,5,4,2,0,3,5,60.0,2,12,10,2,12,18,48,0,Ligue_1,2021_2022
Benoît Badiashile,FRA,DF,Monaco,20,2001,20.4,36,19,21,15,0,14,23,60.9,9,18,12,6,28,64,68,1,Ligue_1,2021_2022
Youssouph Badji,SEN,"FW,MF",Brest,19,2001,1.5,1,0,0,1,0,0,1,0.0,1,0,0,0,0,1,0,0,Ligue_1,2021_2022
Stéphane Bahoken,CMR,FW,Angers,29,1992,12.2,13,8,2,7,4,1,9,11.1,8,15,0,15,3,16,3,0,Ligue_1,2021_2022
Dénys Bain,FRA,DF,Brest,28,1993,2.0,3,3,1,2,0,1,1,100.0,0,3,1,2,3,6,5,0,Ligue_1,2021_2022
Stefan Bajic,FRA,GK,Saint-Étienne,19,2001,5.7,0,0,0,0,0,0,0,,0,0,0,0,0,0,4,0,Ligue_1,2021_2022
Cédric Bakambu,COD,FW,Marseille,30,1991,4.0,2,0,1,0,1,0,3,0.0,3,2,0,2,0,2,1,0,Ligue_1,2021_2022
Abdoulaye Bakayoko,FRA,DF,Saint-Étienne,18,2002,3.4,15,9,13,2,0,8,12,66.7,4,5,4,1,12,27,15,0,Ligue_1,2021_2022
Dilane Bakwa,FRA,"FW,MF",Bordeaux,18,2002,0.5,1,1,0,1,0,1,2,50.0,1,0,0,0,0,1,1,0,Ligue_1,2021_2022
Ibrahima Baldé,FRA,"FW,MF",Lens,18,2003,0.6,0,0,0,0,0,0,0,,0,0,0,0,0,0,0,0,Ligue_1,2021_2022
Leonardo Balerdi,ARG,DF,Marseille,22,1999,10.6,9,6,9,0,0,5,14,35.7,9,11,4,7,19,28,30,0,Ligue_1,2021_2022
Abdoulaye Bamba,CIV,"DF,FW",Angers,31,1990,5.1,6,5,6,0,0,4,11,36.4,7,5,1,4,9,15,13,0,Ligue_1,2021_2022
Jonathan Bamba,CIV,"MF,FW",Lille,25,1996,27.0,30,12,13,9,8,13,36,36.1,23,24,1,23,21,51,10,0,Ligue_1,2021_2022
Simon Banza,COD,FW,Lens,24,1996,1.4,2,1,0,0,2,0,2,0.0,2,1,0,1,1,3,2,0,Ligue_1,2021_2022
Danilo Barbosa,BRA,DF,Nice,25,1996,1.0,0,0,0,0,0,0,0,,0,1,1,0,2,2,10,0,Ligue_1,2021_2022
Bradley Barcola,FRA,"FW,MF",Lyon,18,2002,2.9,7,4,2,3,2,1,8,12.5,7,7,1,6,2,9,1,0,Ligue_1,2021_2022
Melvin Bard,FRA,DF,Nice,20,2000,28.8,59,37,38,17,4,41,63,65.1,22,33,10,23,51,110,56,0,Ligue_1,2021_2022
Toma Bašić,CRO,MF,Bordeaux,24,1996,2.3,2,2,1,0,1,0,4,0.0,4,4,1,3,2,4,0,0,Ligue_1,2021_2022
Amine Bassi,FRA,"MF,FW",Metz,23,1997,2.0,6,3,2,3,1,1,3,33.3,2,5,0,5,0,6,0,0,Ligue_1,2021_2022
Paul Baysse,FRA,"MF,DF",Bordeaux,33,1988,0.1,1,1,0,1,0,0,0,,0,0,0,0,0,1,1,0,Ligue_1,2021_2022
Youcef Belaïli,ALG,"MF,FW",Brest,29,1992,9.2,2,1,0,0,2,2,9,22.2,7,5,1,4,7,9,4,0,Ligue_1,2021_2022
Haris Belkebla,ALG,MF,Brest,27,1994,25.7,46,23,21,21,4,18,39,46.2,21,26,6,20,48,94,30,1,Ligue_1,2021_2022
Jean-Ricner Bellegarde,FRA,MF,Strasbourg,23,1998,25.9,51,32,21,21,9,17,41,41.5,24,29,4,25,27,78,19,0,Ligue_1,2021_2022
Jeanuël Belocian,FRA,DF,Rennes,16,2005,0.1,0,0,0,0,0,0,0,,0,0,0,0,0,0,0,0,Ligue_1,2021_2022
Hatem Ben Arfa,FRA,"FW,MF",Lille,34,1987,3.5,4,2,2,1,1,2,4,50.0,2,3,0,3,0,4,1,0,Ligue_1,2021_2022
Salim Ben Seghir,FRA,MF,Marseille,18,2003,0.0,0,0,0,0,0,0,0,,0,0,0,0,0,0,0,0,Ligue_1,2021_2022
Wissam Ben Yedder,FRA,FW,Monaco,30,1990,28.1,18,8,1,11,6,6,15,40.0,9,12,1,11,0,18,1,0,Ligue_1,2021_2022
Darío Benedetto,ARG,"FW,MF",Marseille,31,1990,0.6,0,0,0,0,0,0,0,,0,2,0,2,0,0,0,0,Ligue_1,2021_2022
Walter Benítez,ARG,GK,Nice,28,1993,37.0,0,0,0,0,0,0,2,0.0,2,1,0,1,0,0,12,2,Ligue_1,2021_2022
Loris Benito,SUI,DF,Bordeaux,29,1992,0.7,0,0,0,0,0,0,0,,0,0,0,0,1,1,3,1,Ligue_1,2021_2022
Nabil Bentaleb,ALG,MF,Angers,26,1994,16.8,42,24,15,20,7,16,29,55.2,13,24,9,15,28,70,13,0,Ligue_1,2021_2022
Patrick Berg,NOR,MF,Lens,23,1997,3.4,14,6,6,8,0,0,4,0.0,4,2,1,1,4,18,3,0,Ligue_1,2021_2022
Mitchell van Bergen,NED,"FW,MF",Reims,21,1999,10.9,8,5,7,0,1,6,15,40.0,9,9,0,9,4,12,7,0,Ligue_1,2021_2022
Valon Berisha,KVX,"MF,FW",Reims,28,1993,5.1,10,7,2,5,3,2,10,20.0,8,9,0,9,4,14,3,0,Ligue_1,2021_2022
Paul Bernardoni,FRA,GK,Angers,24,1997,13.0,3,2,3,0,0,3,4,75.0,1,0,0,0,0,3,8,1,Ligue_1,2021_2022
Paul Bernardoni,FRA,GK,Saint-Étienne,24,1997,19.0,0,0,0,0,0,0,0,,0,0,0,0,0,0,14,2,Ligue_1,2021_2022
Juan Bernat,ESP,"DF,MF",Paris S-G,28,1993,10.6,24,14,10,10,4,13,18,72.2,5,8,0,8,8,32,16,0,Ligue_1,2021_2022
Dimitry Bertaud,COD,GK,Montpellier,23,1998,9.3,0,0,0,0,0,0,1,0.0,1,0,0,0,0,0,5,1,Ligue_1,2021_2022
Jason Berthomier,FRA,MF,Clermont Foot,31,1990,19.2,29,14,5,17,7,12,34,35.3,22,14,2,12,8,37,4,1,Ligue_1,2021_2022
Giulian Biancone,FRA,"DF,MF",Troyes,21,2000,25.5,70,42,44,22,4,40,69,58.0,29,23,8,15,53,123,71,1,Ligue_1,2021_2022
El Bilal Touré,MLI,FW,Reims,19,2001,13.3,13,6,4,6,3,2,7,28.6,5,10,3,7,6,19,19,0,Ligue_1,2021_2022
Jean-Claude Billong,CMR,DF,Clermont Foot,27,1993,10.9,17,8,14,1,2,8,11,72.7,3,9,1,8,10,27,35,0,Ligue_1,2021_2022
Nathan Bitumazala,FRA,DF,Paris S-G,18,2002,0.1,0,0,0,0,0,0,0,,0,1,0,1,0,0,0,0,Ligue_1,2021_2022
Marco Bizot,NED,GK,Brest,30,1991,38.0,3,1,3,0,0,3,5,60.0,2,1,0,1,0,3,24,1,Ligue_1,2021_2022
Ludovic Blas,FRA,"MF,FW",Nantes,23,1997,32.9,33,18,7,20,6,15,44,34.1,29,33,3,30,31,64,6,1,Ligue_1,2021_2022
Myron Boadu,NED,FW,Monaco,20,2001,10.7,9,7,2,3,4,1,5,20.0,4,6,0,6,2,11,1,0,Ligue_1,2021_2022
Jérôme Boateng,GER,DF,Lyon,32,1988,18.0,20,15,11,9,0,9,17,52.9,8,20,10,10,20,40,73,0,Ligue_1,2021_2022
Antonin Bobichon,FRA,"MF,FW",Angers,25,1995,0.4,1,0,0,1,0,0,0,,0,0,0,0,1,2,0,0,Ligue_1,2021_2022
Quentin Boisgard,FRA,"MF,FW",Lorient,24,1997,10.6,19,11,6,10,3,8,17,47.1,9,15,0,15,6,25,5,0,Ligue_1,2021_2022
Charles Boli,FRA,"MF,DF",Lens,22,1998,0.4,2,1,0,2,0,0,0,,0,0,0,0,0,2,0,0,Ligue_1,2021_2022
Sven Botman,NED,DF,Lille,21,2000,25.0,24,11,13,11,0,12,18,66.7,6,32,21,11,26,50,116,0,Ligue_1,2021_2022
Denis Bouanga,GAB,"FW,MF",Saint-Étienne,26,1994,27.1,46,25,14,13,19,22,63,34.9,41,30,0,30,8,54,34,1,Ligue_1,2021_2022
Hicham Boudaoui,ALG,MF,Nice,21,1999,18.0,31,18,15,10,6,13,36,36.1,23,17,4,13,18,49,15,0,Ligue_1,2021_2022
Ryad Boudebouz,ALG,"MF,FW",Saint-Étienne,31,1990,25.0,27,15,11,12,4,12,29,41.4,17,17,2,15,10,37,5,0,Ligue_1,2021_2022
Sofiane Boufal,MAR,"FW,MF",Angers,27,1993,25.9,44,29,19,16,9,18,38,47.4,20,19,2,17,7,51,1,0,Ligue_1,2021_2022
Farid Boulaya,ALG,"MF,FW",Metz,28,1993,17.0,18,10,7,9,2,14,38,36.8,24,8,2,6,12,30,5,0,Ligue_1,2021_2022
Ismaël Boura,COM,DF,Lens,20,2000,1.1,2,2,1,1,0,0,0,,0,1,1,0,2,4,5,0,Ligue_1,2021_2022
Benjamin Bourigeaud,FRA,"FW,MF",Rennes,27,1994,35.5,46,24,16,18,12,24,67,35.8,43,33,3,30,30,76,44,0,Ligue_1,2021_2022
Redwan Bourles,FRA,"MF,FW",Lorient,18,2003,0.2,0,0,0,0,0,0,0,,0,0,0,0,0,0,0,0,Ligue_1,2021_2022
Domagoj Bradarić,CRO,DF,Lille,21,1999,4.6,11,9,8,2,1,7,12,58.3,5,5,2,3,10,21,7,1,Ligue_1,2021_2022
Bilal Brahimi,ALG,MF,Nice,21,2000,4.2,1,1,0,1,0,0,2,0.0,2,1,0,1,2,3,1,0,Ligue_1,2021_2022
Bilal Brahimi,ALG,FW,Angers,21,2000,3.8,1,1,0,1,0,0,3,0.0,3,0,0,0,1,2,1,0,Ligue_1,2021_2022
Lilian Brassier,FRA,DF,Brest,21,1999,25.1,40,24,23,13,4,10,21,47.6,11,31,21,10,32,72,86,0,Ligue_1,2021_2022
Jimmy Briand,FRA,"FW,MF",Bordeaux,35,1985,2.5,2,0,2,0,0,0,2,0.0,2,0,0,0,1,3,2,0,Ligue_1,2021_2022
Dylan Bronn,TUN,DF,Metz,26,1995,28.3,47,29,33,13,1,20,31,64.5,11,32,19,13,40,87,78,1,Ligue_1,2021_2022
Osman Bukari,GHA,"FW,MF",Nantes,22,1998,11.2,18,8,7,6,5,8,22,36.4,14,8,0,8,8,26,1,0,Ligue_1,2021_2022
Maxime Busi,BEL,DF,Reims,21,1999,14.4,26,15,20,5,1,19,36,52.8,17,19,5,14,17,43,28,0,Ligue_1,2021_2022
Oriol Busquets,ESP,MF,Clermont Foot,22,1999,2.2,3,3,0,3,0,2,6,33.3,4,7,4,3,1,4,2,0,Ligue_1,2021_2022
Marcin Bułka,POL,GK,Nice,21,1999,1.0,0,0,0,0,0,0,0,,0,0,0,0,0,0,0,0,Ligue_1,2021_2022
Rémy Cabella,FRA,"MF,FW",Montpellier,31,1990,3.5,15,7,4,8,3,5,15,33.3,10,7,0,7,5,20,1,0,Ligue_1,2021_2022
Jimmy Cabot,FRA,DF,Angers,27,1994,22.3,81,44,59,15,7,47,83,56.6,36,29,0,29,32,113,30,0,Ligue_1,2021_2022
Anthony Caci,FRA,DF,Strasbourg,24,1997,26.6,65,34,35,24,6,33,55,60.0,22,22,3,19,33,98,49,1,Ligue_1,2021_2022
Mathieu Cafaro,FRA,"MF,FW",Reims,24,1997,2.1,4,2,3,1,0,0,7,0.0,7,2,0,2,3,7,1,0,Ligue_1,2021_2022
Yannick Cahuzac,FRA,MF,Lens,36,1985,6.9,5,2,2,3,0,0,5,0.0,5,8,2,6,9,14,12,0,Ligue_1,2021_2022
Marc-Aurèle Caillard,FRA,GK,Metz,27,1994,17.1,0,0,0,0,0,0,2,0.0,2,0,0,0,2,2,9,1,Ligue_1,2021_2022
Jens Cajuste,SWE,"MF,FW",Reims,21,1999,4.0,10,6,6,2,2,6,17,35.3,11,7,2,5,5,15,6,0,Ligue_1,2021_2022
Duje Ćaleta-Car,CRO,DF,Marseille,24,1996,22.9,21,8,15,6,0,11,14,78.6,3,11,7,4,24,45,55,2,Ligue_1,2021_2022
Lucas Calodat,FRA,DF,Saint-Étienne,19,2002,0.0,0,0,0,0,0,0,0,,0,0,0,0,0,0,0,0,Ligue_1,2021_2022
Mahdi Camara,FRA,"MF,DF",Saint-Étienne,23,1998,34.1,101,57,39,50,12,39,70,55.7,31,44,8,36,57,158,35,1,Ligue_1,2021_2022
Mamadou Camara,MLI,FW,Troyes,20,2001,0.4,1,1,1,0,0,0,0,,0,0,0,0,0,1,0,0,Ligue_1,2021_2022
Eduardo Camavinga,FRA,MF,Rennes,18,2002,1.6,4,1,2,1,1,2,5,40.0,3,1,1,0,1,5,3,0,Ligue_1,2021_2022
Fali Candé,GNB,DF,Metz,23,1998,10.8,30,18,13,15,2,13,31,41.9,18,11,2,9,6,36,21,0,Ligue_1,2021_2022
Pierrick Capelle,FRA,"MF,DF",Angers,34,1987,13.3,36,24,16,17,3,18,52,34.6,34,12,1,11,16,52,20,0,Ligue_1,2021_2022
Maxence Caqueret,FRA,MF,Lyon,21,2000,25.9,73,40,29,36,8,30,80,37.5,50,38,10,28,43,116,26,2,Ligue_1,2021_2022
Irvin Cardona,FRA,"FW,MF",Brest,23,1997,14.8,13,7,5,4,4,3,16,18.8,13,10,0,10,5,18,17,0,Ligue_1,2021_2022
Igor Carioca,BRA,DF,Lorient,24,1996,17.5,27,16,16,8,3,15,43,34.9,28,17,2,15,25,52,28,0,Ligue_1,2021_2022
Moreto Cassamã,GNB,MF,Reims,23,1998,8.9,12,6,7,4,1,3,19,15.8,16,10,5,5,9,21,5,0,Ligue_1,2021_2022
Jean-Charles Castelletto,CMR,DF,Nantes,26,1995,27.9,45,24,27,17,1,25,35,71.4,10,38,27,11,30,75,73,0,Ligue_1,2021_2022
Zeki Çelik,TUR,DF,Lille,24,1997,30.0,64,37,43,17,4,36,63,57.1,27,32,9,23,43,107,62,2,Ligue_1,2021_2022
Fabien Centonze,FRA,DF,Metz,25,1996,17.6,33,21,22,9,2,13,32,40.6,19,37,8,29,32,65,51,0,Ligue_1,2021_2022
El Chadaille Bitshiabu,FRA,DF,Paris S-G,16,2005,0.1,0,0,0,0,0,0,0,,0,0,0,0,0,0,2,0,Ligue_1,2021_2022
Nassim Chadli,FRA,"MF,DF",Troyes,20,2001,1.1,5,3,3,0,2,2,4,50.0,2,1,0,1,0,5,0,0,Ligue_1,2021_2022
Mehdi Chahiri,MAR,DF,Strasbourg,25,1996,0.2,1,1,1,0,0,1,1,100.0,0,0,0,0,0,1,0,0,Ligue_1,2021_2022
Dylan Chambost,FRA,"MF,FW",Troyes,23,1997,8.4,16,11,6,9,1,4,25,16.0,21,9,2,7,8,24,4,0,Ligue_1,2021_2022
Brendan Chardonnet,FRA,DF,Brest,26,1994,29.8,44,25,32,11,1,29,40,72.5,11,42,29,13,55,99,141,0,Ligue_1,2021_2022
Xavier Chavalerin,FRA,MF,Troyes,30,1991,30.2,49,26,19,25,5,12,55,21.8,43,32,5,27,39,88,36,0,Ligue_1,2021_2022
Xavier Chavalerin,FRA,MF,Reims,30,1991,2.4,4,4,2,1,1,1,3,33.3,2,2,0,2,5,9,2,1,Ligue_1,2021_2022
Rayan Cherki,FRA,"FW,MF",Lyon,17,2003,4.9,6,2,1,3,2,4,9,44.4,5,2,0,2,1,7,0,0,Ligue_1,2021_2022
Pedro Chirivella,ESP,MF,Nantes,24,1997,29.3,49,31,14,26,9,25,70,35.7,45,23,2,21,37,86,11,0,Ligue_1,2021_2022
Joris Chotard,FRA,MF,Montpellier,19,2001,32.6,59,30,33,23,3,36,78,46.2,42,27,15,12,42,101,56,0,Ligue_1,2021_2022
Alexis Claude-Maurice,FRA,MF,Nice,23,1998,2.3,2,0,1,0,1,1,4,25.0,3,7,0,7,3,5,1,0,Ligue_1,2021_2022
Jonathan Clauss,FRA,DF,Lens,28,1992,33.8,63,34,33,20,10,22,55,40.0,33,43,1,42,73,136,51,0,Ligue_1,2021_2022
Marcus Coco,FRA,"MF,FW",Nantes,25,1996,10.3,34,14,17,11,6,8,18,44.4,10,11,1,10,10,44,15,0,Ligue_1,2021_2022
Abdu Conté,POR,DF,Troyes,23,1998,15.0,22,12,16,5,1,12,24,50.0,12,12,2,10,4,26,10,0,Ligue_1,2021_2022
Sébastien Corchia,FRA,DF,Nantes,30,1990,14.7,33,20,17,11,5,24,42,57.1,18,24,3,21,13,46,36,0,Ligue_1,2021_2022
Maxwel Cornet,CIV,DF,Lyon,24,1996,0.7,3,1,1,0,2,3,4,75.0,1,0,0,0,1,4,1,0,Ligue_1,2021_2022
David Costa,POR,"MF,FW",Lens,20,2001,16.3,22,12,9,6,7,11,26,42.3,15,12,0,12,13,35,5,0,Ligue_1,2021_2022
Benoît Costil,FRA,GK,Bordeaux,34,1987,25.0,1,0,1,0,0,1,2,50.0,1,0,0,0,0,1,6,3,Ligue_1,2021_2022
Kalifa Coulibaly,MLI,FW,Nantes,29,1991,9.4,5,1,1,1,3,0,4,0.0,4,2,2,0,0,5,11,0,Ligue_1,2021_2022
Nicolas Cozza,FRA,DF,Montpellier,22,1999,30.8,80,47,50,23,7,35,65,53.8,30,35,19,16,38,118,82,1,Ligue_1,2021_2022
Enzo Crivelli,FRA,"FW,MF",Saint-Étienne,26,1995,1.1,1,0,0,0,1,0,0,,0,0,0,0,0,1,1,0,Ligue_1,2021_2022
Wylan Cyprien,FRA,MF,Nantes,26,1995,16.6,33,17,12,18,3,13,32,40.6,19,16,6,10,10,43,14,2,Ligue_1,2021_2022
Lucas Da Cunha,FRA,MF,Nice,20,2001,4.4,13,7,2,7,4,6,11,54.5,5,2,0,2,1,14,2,0,Ligue_1,2021_2022
Lucas Da Cunha,FRA,"FW,MF",Clermont Foot,20,2001,9.3,17,11,5,8,4,9,18,50.0,9,13,0,13,1,18,3,0,Ligue_1,2021_2022
Damien Da Silva,FRA,DF,Lyon,33,1988,12.5,13,9,7,5,1,5,9,55.6,4,15,10,5,22,35,53,1,Ligue_1,2021_2022
Colin Dagba,FRA,DF,Paris S-G,22,1998,1.8,4,2,2,2,0,3,6,50.0,3,4,2,2,2,6,1,0,Ligue_1,2021_2022
Flavius Daniliuc,AUT,DF,Nice,20,2001,14.4,46,31,26,17,3,34,43,79.1,9,13,7,6,14,60,34,1,Ligue_1,2021_2022
Kevin Danso,AUT,DF,Lens,22,1998,31.0,41,29,29,12,0,23,34,67.6,11,38,25,13,40,81,111,0,Ligue_1,2021_2022
Dante,BRA,DF,Nice,37,1983,31.9,42,29,30,12,0,23,33,69.7,10,43,27,16,49,91,96,1,Ligue_1,2021_2022
Jonathan David,CAN,FW,Lille,21,2000,31.2,24,9,7,11,6,9,30,30.0,21,14,4,10,5,29,15,0,Ligue_1,2021_2022
Konrad De La Fuente,USA,"FW,MF",Marseille,20,2001,8.7,11,7,8,2,1,7,11,63.6,4,5,0,5,2,13,4,0,Ligue_1,2021_2022
Romain Del Castillo,FRA,"MF,FW",Rennes,25,1996,0.3,2,1,0,1,1,2,2,100.0,0,0,0,0,1,3,0,0,Ligue_1,2021_2022
Romain Del Castillo,FRA,"MF,FW",Brest,25,1996,10.8,27,16,3,17,7,12,31,38.7,19,12,0,12,7,34,3,0,Ligue_1,2021_2022
Thomas Delaine,FRA,DF,Metz,29,1992,25.7,48,35,34,12,2,22,42,52.4,20,20,7,13,27,75,31,0,Ligue_1,2021_2022
Sacha Delaye,FRA,"MF,FW",Montpellier,19,2002,2.8,8,6,3,2,3,2,8,25.0,6,1,0,1,1,9,1,1,Ligue_1,2021_2022
Andy Delort,ALG,FW,Nice,29,1991,27.2,15,9,3,5,7,7,12,58.3,5,13,4,9,9,24,14,0,Ligue_1,2021_2022
Andy Delort,ALG,FW,Montpellier,29,1991,3.0,2,0,0,1,1,0,1,0.0,1,1,0,1,0,2,4,0,Ligue_1,2021_2022
Moussa Dembélé,FRA,FW,Lyon,25,1996,24.5,18,9,5,5,8,6,15,40.0,9,13,0,13,8,26,30,1,Ligue_1,2021_2022
Jason Denayer,BEL,DF,Lyon,26,1995,11.1,11,4,8,3,0,6,7,85.7,1,8,7,1,16,27,52,0,Ligue_1,2021_2022
Arthur Desmas,FRA,GK,Clermont Foot,27,1994,14.5,0,0,0,0,0,0,3,0.0,3,0,0,0,0,0,1,3,Ligue_1,2021_2022
Ángel Di María,ARG,FW,Paris S-G,33,1988,18.3,29,18,6,13,10,14,37,37.8,23,17,0,17,6,35,3,0,Ligue_1,2021_2022
Yadaly Diaby,GUI,"FW,MF",Clermont Foot,20,2000,0.7,0,0,0,0,0,0,1,0.0,1,0,0,0,2,2,2,0,Ligue_1,2021_2022
Ibrahim Diakité,GUI,MF,Reims,17,2003,0.0,0,0,0,0,0,0,1,0.0,1,0,0,0,0,0,0,0,Ligue_1,2021_2022
Abdou Diallo,SEN,DF,Paris S-G,25,1996,9.7,22,14,10,9,3,8,14,57.1,6,6,2,4,10,32,19,1,Ligue_1,2021_2022
Habib Diallo,SEN,FW,Strasbourg,26,1995,17.1,9,5,0,8,1,0,8,0.0,8,13,4,9,4,13,11,0,Ligue_1,2021_2022
Habib Diarra,SEN,MF,Strasbourg,17,2004,1.2,2,1,1,1,0,1,1,100.0,0,0,0,0,0,2,0,0,Ligue_1,2021_2022
Stéphane Diarra,FRA,"MF,FW",Lorient,22,1998,5.8,11,9,7,3,1,5,10,50.0,5,4,0,4,7,18,1,0,Ligue_1,2021_2022
Krépin Diatta,SEN,"MF,DF",Monaco,22,1999,3.2,3,2,1,0,2,1,3,33.3,2,2,0,2,1,4,0,0,Ligue_1,2021_2022
Bamba Dieng,SEN,FW,Marseille,21,2000,10.8,17,11,5,5,7,4,14,28.6,10,7,0,7,5,22,8,0,Ligue_1,2021_2022
Elhadji Dieye,SEN,"FW,MF",Saint-Étienne,19,2002,0.4,3,2,2,1,0,0,1,0.0,1,2,0,2,1,4,0,0,Ligue_1,2021_2022
Javairô Dilrosun,NED,"MF,FW",Bordeaux,23,1998,19.2,13,4,2,8,3,7,24,29.2,17,14,1,13,11,24,5,0,Ligue_1,2021_2022
Junior Dina Ebimbe,FRA,MF,Paris S-G,20,2000,3.5,9,4,3,4,2,2,3,66.7,1,5,3,2,2,11,1,0,Ligue_1,2021_2022
Tristan Dingomé,CMR,"MF,FW",Troyes,30,1991,12.0,23,11,10,12,1,10,18,55.6,8,7,1,6,9,32,3,0,Ligue_1,2021_2022
Sinaly Diomande,CIV,DF,Lyon,20,2001,6.4,6,3,4,2,0,5,6,83.3,1,6,6,0,12,18,26,0,Ligue_1,2021_2022
Sofiane Diop,FRA,"MF,FW",Monaco,21,2000,21.6,38,20,12,19,7,15,47,31.9,32,10,0,10,23,61,4,0,Ligue_1,2021_2022
Andy Diouf,FRA,MF,Rennes,18,2003,0.2,1,1,1,0,0,1,1,100.0,0,1,0,1,0,1,0,0,Ligue_1,2021_2022
Assane Dioussé,SEN,MF,Saint-Étienne,23,1997,0.3,1,1,1,0,0,1,1,100.0,0,0,0,0,0,1,0,0,Ligue_1,2021_2022
Axel Disasi,FRA,DF,Monaco,23,1998,30.2,42,27,20,21,1,23,39,59.0,16,40,30,10,26,68,75,0,Ligue_1,2021_2022
Tiago Djaló,POR,DF,Lille,21,2000,25.9,60,39,39,19,2,26,39,66.7,13,26,10,16,24,84,71,0,Ligue_1,2021_2022
Alexander Djiku,GHA,DF,Strasbourg,26,1994,29.9,50,37,33,13,4,18,35,51.4,17,30,13,17,61,111,90,2,Ligue_1,2021_2022
Bryan Djile Nokoué,CMR,"DF,MF",Saint-Étienne,19,2002,0.6,3,3,1,2,0,2,2,100.0,0,1,0,1,1,4,2,0,Ligue_1,2021_2022
Ouparine Djoco,GNB,GK,Clermont Foot,23,1998,23.5,0,0,0,0,0,0,0,,0,0,0,0,1,1,14,2,Ligue_1,2021_2022
Jeremy Doku,BEL,"FW,MF",Rennes,19,2002,5.2,10,5,3,5,2,3,6,50.0,3,4,0,4,3,13,0,0,Ligue_1,2021_2022
Kasper Dolberg,DEN,FW,Nice,23,1997,16.6,9,4,4,3,2,3,9,33.3,6,15,1,14,6,15,17,0,Ligue_1,2021_2022
Brandon Domingues,FRA,"MF,FW",Troyes,21,2000,2.6,6,2,2,4,0,2,3,66.7,1,3,0,3,3,9,0,0,Ligue_1,2021_2022
Anastasios Donis,GRE,"FW,MF",Reims,24,1996,4.1,8,7,4,2,2,2,6,33.3,4,3,0,3,0,8,1,0,Ligue_1,2021_2022
Gianluigi Donnarumma,ITA,GK,Paris S-G,22,1999,17.0,0,0,0,0,0,0,0,,0,0,0,0,0,0,9,2,Ligue_1,2021_2022
Jodel Dossou,BEN,FW,Clermont Foot,29,1992,22.3,36,17,15,14,7,15,43,34.9,28,14,0,14,5,41,7,0,Ligue_1,2021_2022
Lohann Doucet,FRA,"MF,DF",Nantes,18,2002,0.1,0,0,0,0,0,0,0,,0,0,0,0,1,1,0,0,Ligue_1,2021_2022
Cheick Doucouré,MLI,MF,Lens,21,2000,32.7,75,43,34,34,7,35,79,44.3,44,30,7,23,68,143,24,0,Ligue_1,2021_2022
Fodé Doucouré,MLI,"DF,FW",Reims,20,2001,1.7,12,9,9,3,0,9,11,81.8,2,1,0,1,4,16,6,0,Ligue_1,2021_2022
Ismaël Doukouré,FRA,DF,Strasbourg,18,2003,0.2,0,0,0,0,0,0,0,,0,0,0,0,0,0,1,0,Ligue_1,2021_2022
Kamory Doumbia,MLI,"MF,FW",Reims,18,2003,3.9,8,2,2,5,1,5,13,38.5,8,9,3,6,3,11,3,0,Ligue_1,2021_2022
Moussa Doumbia,MLI,FW,Reims,26,1994,1.0,0,0,0,0,0,0,1,0.0,1,0,0,0,0,0,0,0,Ligue_1,2021_2022
Souleyman Doumbia,CIV,"DF,FW",Angers,24,1996,24.7,30,20,16,9,5,13,27,48.1,14,25,4,21,39,69,51,0,Ligue_1,2021_2022
Julian Draxler,GER,"FW,MF",Paris S-G,27,1993,6.1,3,2,0,3,0,0,4,0.0,4,3,0,3,5,8,3,0,Ligue_1,2021_2022
Matthieu Dreyer,FRA,GK,Lorient,32,1989,16.0,1,1,1,0,0,1,1,100.0,0,0,0,0,0,1,9,0,Ligue_1,2021_2022
Leo Dubois,FRA,DF,Lyon,26,1994,19.4,43,27,22,14,7,27,46,58.7,19,27,3,24,22,65,35,1,Ligue_1,2021_2022
Jean-Kevin Duverne,HAI,DF,Brest,24,1997,33.4,71,44,43,21,7,42,90,46.7,48,40,5,35,53,124,92,0,Ligue_1,2021_2022
Enzo Ebosse,CMR,DF,Angers,22,1999,21.0,25,14,19,6,0,11,19,57.9,8,19,9,10,15,40,42,0,Ligue_1,2021_2022
Hugo Ekitike,FRA,FW,Reims,19,2002,14.1,18,10,8,6,4,4,11,36.4,7,9,2,7,6,24,15,0,Ligue_1,2021_2022
Alberth Elis,HON,"FW,MF",Bordeaux,25,1996,15.7,19,10,5,5,9,11,25,44.0,14,9,0,9,7,26,10,0,Ligue_1,2021_2022
Renaud Emond,BEL,"FW,MF",Nantes,29,1991,2.1,1,0,0,1,0,0,4,0.0,4,2,1,1,0,1,1,0,Ligue_1,2021_2022
Maxime Estève,FRA,DF,Montpellier,19,2002,20.6,27,18,22,4,1,15,27,55.6,12,31,24,7,22,49,69,1,Ligue_1,2021_2022
Fábio,BRA,DF,Nantes,31,1990,18.5,61,40,31,23,7,36,74,48.6,38,29,7,22,35,96,31,1,Ligue_1,2021_2022
Cesc Fàbregas,ESP,MF,Monaco,34,1987,0.4,1,0,0,1,0,1,1,100.0,0,0,0,0,1,2,0,0,Ligue_1,2021_2022
Wout Faes,BEL,DF,Reims,23,1998,37.0,40,24,30,9,1,25,33,75.8,8,47,37,10,53,93,169,2,Ligue_1,2021_2022
Romain Faivre,FRA,"FW,MF",Lyon,23,1998,9.9,10,4,2,6,2,4,13,30.8,9,4,0,4,3,13,2,0,Ligue_1,2021_2022
Romain Faivre,FRA,MF,Brest,23,1998,19.9,30,18,12,13,5,12,30,40.0,18,11,0,11,13,43,10,0,Ligue_1,2021_2022
Wuilker Faríñez,VEN,GK,Lens,23,1998,12.3,0,0,0,0,0,0,0,,0,0,0,0,0,0,4,0,Ligue_1,2021_2022
Noah Fatar,FRA,"DF,MF",Angers,19,2002,0.1,1,0,0,0,1,0,1,0.0,1,0,0,0,1,2,0,0,Ligue_1,2021_2022
Julien Faussurier,FRA,"MF,DF",Brest,34,1987,5.4,10,6,3,3,4,6,13,46.2,7,12,1,11,5,15,6,0,Ligue_1,2021_2022
Jordan Ferri,FRA,MF,Montpellier,29,1992,32.3,55,35,28,23,4,29,87,33.3,58,21,5,16,30,85,35,0,Ligue_1,2021_2022
Karol Fila,POL,DF,Strasbourg,23,1998,6.2,10,8,5,4,1,4,8,50.0,4,7,2,5,4,14,6,0,Ligue_1,2021_2022
Alexis Flips,FRA,"MF,DF",Reims,21,2000,11.7,37,21,21,9,7,22,45,48.9,23,21,0,21,24,61,17,0,Ligue_1,2021_2022
Mamadou Fofana,MLI,DF,Metz,23,1998,0.4,1,1,0,1,0,1,2,50.0,1,2,1,1,1,2,2,0,Ligue_1,2021_2022
Seko Fofana,CIV,MF,Lens,26,1995,37.3,27,19,11,13,3,12,58,20.7,46,24,2,22,26,53,17,1,Ligue_1,2021_2022
Youssouf Fofana,FRA,MF,Monaco,22,1999,24.3,69,43,19,41,9,29,56,51.8,27,29,7,22,32,101,22,2,Ligue_1,2021_2022
Thomas Foket,BEL,"DF,FW",Reims,26,1994,24.8,28,19,12,13,3,18,40,45.0,22,26,4,22,33,61,35,0,Ligue_1,2021_2022
Thomas Fontaine,MAD,DF,Lorient,30,1991,1.9,2,0,1,0,1,0,1,0.0,1,3,3,0,2,4,4,0,Ligue_1,2021_2022
José Fonte,POR,DF,Lille,37,1983,38.0,23,12,14,7,2,11,25,44.0,14,39,32,7,44,67,159,1,Ligue_1,2021_2022
Steven Fortes,CPV,DF,Lens,29,1992,1.0,2,0,2,0,0,1,2,50.0,1,2,1,1,0,2,4,0,Ligue_1,2021_2022
Przemysław Frankowski,POL,DF,Lens,26,1995,27.2,57,39,22,27,8,36,74,48.6,38,27,0,27,28,85,52,0,Ligue_1,2021_2022
Fransérgio,BRA,MF,Bordeaux,30,1990,14.0,24,10,8,12,4,12,43,27.9,31,18,6,12,23,47,23,0,Ligue_1,2021_2022
Angelo Fulgini,FRA,"MF,FW",Angers,24,1996,32.5,35,25,8,18,9,14,44,31.8,30,21,5,16,22,57,5,1,Ligue_1,2021_2022
Gauthier Gallon,FRA,GK,Troyes,28,1993,31.0,3,0,3,0,0,1,1,100.0,0,0,0,0,2,5,12,1,Ligue_1,2021_2022
Kévin Gameiro,FRA,FW,Strasbourg,34,1987,26.5,19,10,5,9,5,6,18,33.3,12,22,1,21,6,25,1,0,Ligue_1,2021_2022
Idrissa Gana Gueye,SEN,MF,Paris S-G,31,1989,18.2,60,36,24,24,12,18,44,40.9,26,23,4,19,24,84,13,0,Ligue_1,2021_2022
Ignatius Ganago,CMR,FW,Lens,22,1999,11.4,3,2,1,2,0,2,6,33.3,4,4,0,4,2,5,3,0,Ligue_1,2021_2022
Djeidi Gassama,FRA,FW,Paris S-G,17,2003,0.0,0,0,0,0,0,0,0,,0,1,1,0,0,0,0,0,Ligue_1,2021_2022
Johan Gastien,FRA,MF,Clermont Foot,33,1988,30.5,56,34,26,25,5,27,74,36.5,47,45,11,34,53,109,49,1,Ligue_1,2021_2022
Valère Germain,FRA,FW,Montpellier,31,1990,21.9,23,14,6,11,6,8,31,25.8,23,13,1,12,9,32,27,0,Ligue_1,2021_2022
Gerson,BRA,"MF,FW",Marseille,24,1997,28.3,42,17,16,20,6,8,35,22.9,27,26,4,22,16,58,16,2,Ligue_1,2021_2022
Willem Geubbels,FRA,"FW,MF",Nantes,19,2001,6.0,8,5,4,2,2,5,12,41.7,7,5,0,5,6,14,5,0,Ligue_1,2021_2022
Ismaël Gharbi,ESP,FW,Paris S-G,17,2004,0.0,0,0,0,0,0,0,0,,0,0,0,0,0,0,0,0,Ligue_1,2021_2022
Lamine Ghezali,FRA,DF,Saint-Étienne,22,1999,0.0,0,0,0,0,0,0,0,,0,1,0,1,0,0,0,0,Ligue_1,2021_2022
Nicholas Gioacchini,USA,"FW,MF",Montpellier,21,2000,5.5,7,5,3,2,2,4,10,40.0,6,8,0,8,4,11,5,0,Ligue_1,2021_2022
Jimmy Giraudon,FRA,DF,Troyes,29,1992,18.0,14,6,10,4,0,7,22,31.8,15,24,14,10,37,51,68,1,Ligue_1,2021_2022
Andrei Girotto,BRA,"DF,MF",Nantes,29,1992,35.0,85,52,49,32,4,52,103,50.5,51,67,33,34,69,154,143,0,Ligue_1,2021_2022
Aleksandr Golovin,RUS,"FW,MF",Monaco,25,1996,16.7,40,22,10,18,12,18,41,43.9,23,26,1,25,12,52,8,0,Ligue_1,2021_2022
Angel Gomes,ENG,"MF,FW",Lille,20,2000,10.6,23,13,6,12,5,10,15,66.7,5,4,0,4,3,26,4,0,Ligue_1,2021_2022
Alfred Gomis,SEN,GK,Rennes,27,1993,25.0,1,0,1,0,0,1,2,50.0,1,0,0,0,1,2,8,2,Ligue_1,2021_2022
Vagner Gonçalves,CPV,FW,Metz,25,1996,1.0,2,1,0,2,0,1,1,100.0,0,0,0,0,1,3,0,0,Ligue_1,2021_2022
Álvaro González,ESP,DF,Marseille,31,1990,5.0,1,1,1,0,0,1,1,100.0,0,0,0,0,1,2,9,0,Ligue_1,2021_2022
Amine Gouiri,ALG,"FW,MF",Nice,21,2000,30.6,22,13,2,13,7,10,32,31.3,22,22,5,17,11,33,17,1,Ligue_1,2021_2022
Lucas Gourna-Douath,FRA,MF,Saint-Étienne,17,2003,20.0,45,26,22,18,5,21,36,58.3,15,22,3,19,13,58,9,2,Ligue_1,2021_2022
Jonathan Gradit,FRA,DF,Lens,28,1992,34.1,60,28,24,28,8,25,45,55.6,20,39,27,12,65,125,106,0,Ligue_1,2021_2022
Andrew Gravillon,GLP,DF,Reims,23,1998,23.7,32,24,19,13,0,17,27,63.0,10,25,15,10,33,65,83,1,Ligue_1,2021_2022
Adrian Grbić,AUT,"FW,MF",Lorient,24,1996,5.8,2,1,0,2,0,2,6,33.3,4,3,1,2,0,2,7,0,Ligue_1,2021_2022
Ivo Grbić,CRO,GK,Lille,25,1996,21.0,0,0,0,0,0,0,0,,0,0,0,0,0,0,14,1,Ligue_1,2021_2022
Etienne Green,ENG,GK,Saint-Étienne,21,2000,13.3,1,1,1,0,0,0,0,,0,0,0,0,1,2,9,0,Ligue_1,2021_2022
Gabriel Gudmundsson,SWE,"DF,MF",Lille,22,1999,14.9,43,31,24,16,3,17,35,48.6,18,15,3,12,20,63,13,0,Ligue_1,2021_2022
Noah Guede-Nadje,FRA,MF,Angers,17,2003,0.0,0,0,0,0,0,0,0,,0,0,0,0,0,0,0,0,Ligue_1,2021_2022
Mattéo Guendouzi,FRA,MF,Marseille,22,1999,35.0,45,30,10,26,9,13,47,27.7,34,15,1,14,16,61,18,0,Ligue_1,2021_2022
Yanis Guermouche,FRA,"MF,FW",Montpellier,20,2001,0.1,2,1,0,1,1,1,1,100.0,0,0,0,0,0,2,0,0,Ligue_1,2021_2022
Evann Guessand,CIV,FW,Nice,20,2001,4.9,9,8,2,5,2,3,8,37.5,5,4,0,4,0,9,1,0,Ligue_1,2021_2022
Lamine Gueye,SEN,"FW,MF",Metz,23,1998,6.2,5,5,1,1,3,3,7,42.9,4,4,0,4,6,11,1,0,Ligue_1,2021_2022
Pape Gueye,SEN,MF,Marseille,22,1999,17.0,38,19,15,22,1,16,31,51.6,15,15,3,12,24,62,16,0,Ligue_1,2021_2022
Josuha Guilavogui,FRA,"MF,DF",Bordeaux,30,1990,14.8,39,16,18,17,4,14,29,48.3,15,16,8,8,36,75,23,0,Ligue_1,2021_2022
Frederic Guilbert,FRA,DF,Strasbourg,26,1994,28.0,69,39,33,24,12,32,62,51.6,30,37,11,26,55,124,39,0,Ligue_1,2021_2022
Bruno Guimarães,BRA,MF,Lyon,23,1997,18.2,50,31,20,25,5,23,59,39.0,36,21,4,17,21,71,11,1,Ligue_1,2021_2022
Serhou Guirassy,GUI,FW,Rennes,25,1996,11.3,4,2,1,2,1,1,7,14.3,6,4,0,4,1,5,8,0,Ligue_1,2021_2022
Malo Gusto,FRA,DF,Lyon,18,2003,20.9,55,35,29,21,5,24,40,60.0,16,21,6,15,33,88,41,1,Ligue_1,2021_2022
Massadio Haïdara,MLI,DF,Lens,28,1992,12.0,28,21,18,7,3,15,24,62.5,9,18,4,14,22,50,31,0,Ligue_1,2021_2022
Oualid El Hajjam,MAR,DF,Troyes,30,1991,11.9,22,11,12,6,4,15,23,65.2,8,12,6,6,22,44,28,0,Ligue_1,2021_2022
Achraf Hakimi,MAR,DF,Paris S-G,22,1998,27.5,74,51,38,27,9,40,72,55.6,32,26,5,21,28,102,23,2,Ligue_1,2021_2022
Pierre-Yves Hamel,FRA,"FW,MF",Lorient,27,1994,0.3,0,0,0,0,0,0,1,0.0,1,0,0,0,2,2,0,0,Ligue_1,2021_2022
Pierre-Yves Hamel,FRA,FW,Clermont Foot,27,1994,5.8,11,6,0,5,6,5,6,83.3,1,2,1,1,0,11,0,0,Ligue_1,2021_2022
Romain Hamouma,FRA,"FW,MF",Saint-Étienne,34,1987,9.8,10,7,1,5,4,2,13,15.4,11,8,0,8,4,14,1,0,Ligue_1,2021_2022
Amine Harit,MAR,"FW,MF",Marseille,24,1997,12.9,18,11,9,9,0,9,17,52.9,8,10,0,10,4,22,2,0,Ligue_1,2021_2022
Henrique,BRA,DF,Lyon,27,1994,12.3,13,7,10,1,2,5,16,31.3,11,13,1,12,22,35,14,0,Ligue_1,2021_2022
Luis Henrique,BRA,"FW,MF",Marseille,19,2001,7.8,4,3,2,1,1,2,5,40.0,3,2,0,2,5,9,1,0,Ligue_1,2021_2022
Christophe Hérelle,MTQ,DF,Brest,28,1992,21.5,48,28,30,16,2,17,26,65.4,9,20,15,5,44,92,84,1,Ligue_1,2021_2022
Jérôme Hergault,FRA,DF,Lorient,35,1986,3.9,3,1,1,2,0,2,5,40.0,3,4,1,3,4,7,7,0,Ligue_1,2021_2022
Ander Herrera,ESP,MF,Paris S-G,31,1989,12.1,29,17,7,16,6,14,39,35.9,25,22,8,14,14,43,8,0,Ligue_1,2021_2022
Franck Honorat,FRA,"FW,MF",Brest,24,1996,32.2,54,38,25,13,16,27,47,57.4,20,24,2,22,15,69,25,0,Ligue_1,2021_2022
Fraser Hornby,SCO,"FW,MF",Reims,21,1999,3.9,3,1,1,2,0,0,2,0.0,2,3,0,3,4,7,5,0,Ligue_1,2021_2022
Cédric Hountondji,BEN,DF,Clermont Foot,27,1994,22.6,33,17,20,12,1,16,24,66.7,8,23,12,11,34,67,76,0,Ligue_1,2021_2022
Suk Hyun-jun,KOR,"FW,MF",Troyes,30,1991,1.7,0,0,0,0,0,0,0,,0,2,0,2,0,0,2,0,Ligue_1,2021_2022
Mauro Icardi,ARG,FW,Paris S-G,28,1993,11.4,5,3,1,3,1,3,7,42.9,4,3,0,3,5,10,12,0,Ligue_1,2021_2022
Jonathan Iglesias,URU,MF,Clermont Foot,32,1988,6.4,18,11,6,10,2,10,18,55.6,8,8,2,6,5,23,2,1,Ligue_1,2021_2022
Juan Ignacio Ramírez,URU,FW,Saint-Étienne,24,1997,1.4,2,1,0,1,1,0,0,,0,0,0,0,0,2,0,0,Ligue_1,2021_2022
Danylo Ihnatenko,UKR,MF,Bordeaux,24,1997,7.7,17,9,8,7,2,10,24,41.7,14,9,2,7,6,23,17,1,Ligue_1,2021_2022
Jonathan Ikone,FRA,"MF,FW",Lille,23,1998,11.8,11,3,6,4,1,4,11,36.4,7,13,1,12,5,16,4,0,Ligue_1,2021_2022
Bonke Innocent,NGA,MF,Lorient,25,1996,9.7,27,16,10,16,1,11,26,42.3,15,11,3,8,16,43,14,0,Ligue_1,2021_2022
Wilson Isidor,FRA,"FW,MF",Monaco,20,2000,0.6,0,0,0,0,0,0,4,0.0,4,1,0,1,0,0,0,0,Ligue_1,2021_2022
Ismail Jakobs,SEN,"DF,FW",Monaco,21,1999,13.4,32,16,14,15,3,16,35,45.7,19,16,1,15,17,49,31,0,Ligue_1,2021_2022
Marin Jakoliš,CRO,FW,Angers,24,1996,2.5,2,1,0,1,1,0,6,0.0,6,0,0,0,1,3,0,0,Ligue_1,2021_2022
Abdel Jalil Medioub,ALG,DF,Bordeaux,23,1997,6.9,9,5,5,3,1,3,4,75.0,1,8,4,4,12,21,34,0,Ligue_1,2021_2022
Léo Jardim,BRA,GK,Lille,26,1995,17.0,0,0,0,0,0,0,0,,0,0,0,0,1,1,10,0,Ligue_1,2021_2022
Corentin Jean,FRA,"FW,MF",Lens,26,1995,2.8,9,6,4,4,1,3,6,50.0,3,5,0,5,1,10,0,0,Ligue_1,2021_2022
Jemerson,BRA,DF,Metz,28,1992,13.4,37,25,30,7,0,18,26,69.2,8,23,8,15,25,62,33,1,Ligue_1,2021_2022
Moritz Jenz,GER,DF,Lorient,22,1999,15.3,26,12,18,6,2,11,24,45.8,13,19,11,8,28,54,55,0,Ligue_1,2021_2022
Lenny Joseph,FRA,"FW,MF",Metz,20,2000,1.7,2,1,1,1,0,0,0,,0,3,0,3,0,2,0,0,Ligue_1,2021_2022
Issa Kaboré,BFA,"DF,MF",Troyes,20,2001,25.0,45,22,22,14,9,20,38,52.6,18,27,2,25,20,65,38,1,Ligue_1,2021_2022
Tino Kadewere,ZIM,FW,Lyon,25,1996,5.6,7,5,2,2,3,4,13,30.8,9,7,0,7,4,11,1,1,Ligue_1,2021_2022
Gaël Kakuta,COD,"MF,FW",Lens,30,1991,18.6,22,14,2,13,7,4,20,20.0,16,10,0,10,4,26,3,0,Ligue_1,2021_2022
Arnaud Kalimuendo,FRA,FW,Lens,19,2002,23.9,9,8,1,3,5,2,7,28.6,5,6,1,5,8,17,0,0,Ligue_1,2021_2022
Arnaud Kalimuendo,FRA,FW,Paris S-G,19,2002,0.1,0,0,0,0,0,0,0,,0,0,0,0,0,0,0,0,Ligue_1,2021_2022
Samuel Kalu,NGA,"FW,MF",Bordeaux,23,1997,3.6,8,5,3,4,1,2,5,40.0,3,2,0,2,3,11,1,0,Ligue_1,2021_2022
Boubacar Kamara,FRA,"MF,DF",Marseille,21,1999,30.9,68,38,27,36,5,26,47,55.3,21,29,10,19,46,114,44,1,Ligue_1,2021_2022
Hassane Kamara,CIV,"MF,DF",Nice,27,1994,6.0,13,10,4,6,3,5,8,62.5,3,10,2,8,9,22,4,0,Ligue_1,2021_2022
Jean-Armel Kana-Biyik,CMR,DF,Metz,32,1989,7.4,10,6,8,2,0,4,9,44.4,5,11,4,7,16,26,22,1,Ligue_1,2021_2022
Nordine Kandil,FRA,"MF,FW",Strasbourg,19,2001,1.0,2,1,2,0,0,1,1,100.0,0,1,1,0,0,2,0,0,Ligue_1,2021_2022
Eiji Kawashima,JPN,GK,Strasbourg,38,1983,1.0,0,0,0,0,0,0,0,,0,0,0,0,0,0,0,0,Ligue_1,2021_2022
Ilan Kebbal,ALG,"MF,FW",Reims,23,1998,19.7,31,15,13,10,8,12,44,27.3,32,16,0,16,13,44,3,0,Ligue_1,2021_2022
Thilo Kehrer,GER,DF,Paris S-G,24,1996,16.8,21,14,9,11,1,9,21,42.9,12,19,11,8,24,45,29,0,Ligue_1,2021_2022
Habib Keita,MLI,"MF,FW",Lyon,19,2002,0.1,0,0,0,0,0,0,0,,0,0,0,0,0,0,0,0,Ligue_1,2021_2022
Saîf-Eddine Khaoui,TUN,"MF,FW",Clermont Foot,26,1995,10.3,19,10,5,10,4,9,18,50.0,9,9,0,9,14,33,5,0,Ligue_1,2021_2022
Wahbi Khazri,TUN,"FW,MF",Saint-Étienne,30,1991,24.7,33,18,7,17,9,9,34,26.5,25,21,0,21,12,45,7,0,Ligue_1,2021_2022
Presnel Kimpembe,FRA,DF,Paris S-G,25,1995,28.6,34,19,18,15,1,14,23,60.9,9,20,14,6,38,72,73,1,Ligue_1,2021_2022
Thibault Klidje,TOG,"MF,FW",Bordeaux,20,2001,1.0,0,0,0,0,0,0,1,0.0,1,1,1,0,2,2,0,0,Ligue_1,2021_2022
Justin Kluivert,NED,MF,Nice,22,1999,20.8,19,9,6,12,1,5,21,23.8,16,13,1,12,14,33,6,0,Ligue_1,2021_2022
Samuel Koeberlé,FRA,FW,Reims,16,2004,0.0,0,0,0,0,0,0,0,,0,0,0,0,0,0,0,0,Ligue_1,2021_2022
Philippe Koffi,CIV,FW,Reims,19,2002,4.2,4,0,0,3,1,0,2,0.0,2,2,1,1,3,7,3,0,Ligue_1,2021_2022
Sead Kolašinac,BIH,DF,Marseille,28,1993,4.9,7,6,2,3,2,5,8,62.5,3,4,0,4,0,7,7,1,Ligue_1,2021_2022
Randal Kolo Muani,FRA,"FW,MF",Nantes,22,1998,32.8,28,14,7,10,11,10,25,40.0,15,14,3,11,6,34,31,0,Ligue_1,2021_2022
Timothée Kolodziejczak,FRA,DF,Saint-Étienne,29,1991,28.5,43,24,22,14,7,20,36,55.6,16,29,7,22,60,103,72,1,Ligue_1,2021_2022
Ghislain Konan,CIV,DF,Reims,25,1995,26.9,35,19,19,15,1,16,30,53.3,14,35,8,27,28,63,45,0,Ligue_1,2021_2022
Ibrahima Koné,MLI,FW,Lorient,22,1999,8.1,7,4,0,3,4,2,3,66.7,1,8,3,5,1,8,3,0,Ligue_1,2021_2022
Youssouf Koné,MLI,DF,Troyes,26,1995,10.9,30,18,21,8,1,19,30,63.3,11,8,3,5,10,40,25,0,Ligue_1,2021_2022
Laurent Koscielny,FRA,DF,Bordeaux,35,1985,10.4,14,9,10,3,1,8,13,61.5,5,17,12,5,12,26,39,0,Ligue_1,2021_2022
Rominigue Kouamé,MLI,MF,Troyes,24,1996,33.0,47,22,24,20,3,19,58,32.8,39,33,5,28,46,93,22,2,Ligue_1,2021_2022
Boubakar Kouyaté,MLI,DF,Metz,24,1997,29.6,84,50,56,28,0,48,77,62.3,29,63,33,30,79,163,217,3,Ligue_1,2021_2022
Jean-Philippe Krasso,CIV,FW,Saint-Étienne,24,1997,5.0,7,5,0,5,2,2,10,20.0,8,7,1,6,0,7,1,0,Ligue_1,2021_2022
Mykola Kukharevych,UKR,FW,Troyes,20,2001,0.2,0,0,0,0,0,0,0,,0,0,0,0,0,0,0,0,Ligue_1,2021_2022
Enock Kwateng,FRA,DF,Bordeaux,24,1997,22.2,54,35,31,19,4,33,72,45.8,39,17,4,13,43,97,48,1,Ligue_1,2021_2022
Grejohn Kyei,FRA,FW,Clermont Foot,25,1995,4.4,3,2,1,1,1,0,6,0.0,6,6,0,6,0,3,1,0,Ligue_1,2021_2022
Gaëtan Laborde,FRA,FW,Montpellier,27,1994,3.8,2,2,1,1,0,2,4,50.0,2,3,0,3,5,7,5,0,Ligue_1,2021_2022
Gaëtan Laborde,FRA,FW,Rennes,27,1994,30.3,19,7,5,8,6,3,22,13.6,19,29,3,26,8,27,16,0,Ligue_1,2021_2022
Tom Lacoux,FRA,"DF,MF",Bordeaux,19,2002,10.1,18,13,11,5,2,9,24,37.5,15,14,4,10,9,27,20,1,Ligue_1,2021_2022
Lenny Lacroix,FRA,DF,Metz,18,2003,2.2,9,7,8,1,0,5,8,62.5,3,5,1,4,10,19,5,0,Ligue_1,2021_2022
Alban Lafont,FRA,GK,Nantes,22,1999,38.0,3,3,3,0,0,3,8,37.5,5,1,0,1,1,4,25,2,Ligue_1,2021_2022
Mohamed Lamine Bayo,GUI,FW,Clermont Foot,23,1998,26.8,12,5,4,3,5,3,24,12.5,21,7,1,6,7,19,14,0,Ligue_1,2021_2022
Didier Lamkel Zé,CMR,FW,Metz,24,1996,6.7,3,1,1,0,2,1,3,33.3,2,3,1,2,1,4,7,0,Ligue_1,2021_2022
Julien Laporte,FRA,DF,Lorient,27,1993,32.1,63,45,35,26,2,32,64,50.0,32,37,22,15,54,117,174,0,Ligue_1,2021_2022
Yasser Larouci,ALG,DF,Troyes,20,2001,3.8,6,5,2,4,0,3,3,100.0,0,1,0,1,7,13,5,0,Ligue_1,2021_2022
Paul Lasne,FRA,MF,Brest,32,1989,9.4,26,12,6,16,4,8,18,44.4,10,11,2,9,24,50,10,0,Ligue_1,2021_2022
Armand Lauriente,FRA,"FW,MF",Lorient,22,1998,27.5,33,18,9,16,8,11,30,36.7,19,27,2,25,15,48,3,0,Ligue_1,2021_2022
Théo Le Bris,FRA,MF,Lorient,18,2002,0.7,2,1,1,1,0,1,2,50.0,1,2,0,2,0,2,1,0,Ligue_1,2021_2022
Jérémy Le Douaron,FRA,"FW,MF",Brest,23,1998,16.1,11,5,4,4,3,1,17,5.9,16,15,0,15,4,15,14,0,Ligue_1,2021_2022
Enzo Le Fée,FRA,"MF,FW",Lorient,21,2000,24.4,70,44,25,36,9,41,90,45.6,49,25,1,24,29,99,18,0,Ligue_1,2021_2022
Vincent Le Goff,FRA,DF,Lorient,31,1989,34.0,61,38,38,19,4,37,62,59.7,25,18,3,15,37,98,50,0,Ligue_1,2021_2022
Maxime Le Marchand,FRA,DF,Strasbourg,31,1989,9.6,17,8,16,1,0,8,10,80.0,2,9,5,4,14,31,32,0,Ligue_1,2021_2022
Jean-Louis Leca,FRA,GK,Lens,35,1985,25.7,0,0,0,0,0,0,0,,0,1,0,1,1,1,11,1,Ligue_1,2021_2022
Félix Lemaréchal,FRA,MF,Monaco,17,2003,0.1,0,0,0,0,0,0,1,0.0,1,0,0,0,0,0,0,0,Ligue_1,2021_2022
Mario Lemina,GAB,MF,Nice,27,1993,21.9,62,35,25,33,4,28,38,73.7,10,32,9,23,48,110,37,0,Ligue_1,2021_2022
Fabien Lemoine,FRA,MF,Lorient,34,1987,12.4,35,22,20,14,1,17,41,41.5,24,21,4,17,14,49,24,1,Ligue_1,2021_2022
Léo Leroy,FRA,MF,Montpellier,21,2000,7.0,31,21,17,11,3,12,34,35.3,22,20,4,16,8,39,8,0,Ligue_1,2021_2022
Alexandre Letellier,FRA,GK,Paris S-G,30,1990,0.1,0,0,0,0,0,0,0,,0,0,0,0,0,0,0,0,Ligue_1,2021_2022
Yanis Lhery,FRA,"FW,MF",Saint-Étienne,18,2003,0.8,0,0,0,0,0,0,0,,0,4,0,4,0,0,0,0,Ligue_1,2021_2022
Dimitri Liénard,FRA,"DF,MF",Strasbourg,33,1988,22.7,71,43,40,21,10,46,77,59.7,31,12,0,12,21,92,28,0,Ligue_1,2021_2022
Isaac Lihadji,FRA,"MF,FW",Lille,19,2002,2.6,3,3,1,1,1,1,5,20.0,4,1,0,1,2,5,0,0,Ligue_1,2021_2022
Pol Lirola,ESP,"DF,FW",Marseille,23,1997,19.7,28,16,15,9,4,13,28,46.4,15,15,0,15,13,41,22,0,Ligue_1,2021_2022
Bradley Locko,FRA,"MF,DF",Reims,19,2002,11.2,28,19,13,11,4,14,24,58.3,10,20,8,12,14,42,15,0,Ligue_1,2021_2022
Anthony Lopes,POR,GK,Lyon,30,1990,33.1,0,0,0,0,0,0,0,,0,0,0,0,3,3,12,3,Ligue_1,2021_2022
Pau López,ESP,GK,Marseille,26,1994,29.0,0,0,0,0,0,0,1,0.0,1,0,0,0,0,0,12,1,Ligue_1,2021_2022
Dion Lopy,SEN,MF,Reims,19,2002,18.2,53,29,22,24,7,21,53,39.6,32,20,4,16,22,75,17,0,Ligue_1,2021_2022
Samuel Loric,FRA,DF,Lorient,21,2000,3.0,7,5,2,3,2,5,8,62.5,3,2,0,2,5,12,9,0,Ligue_1,2021_2022
Jordan Lotomba,SUI,DF,Nice,22,1998,19.8,33,17,21,9,3,16,30,53.3,14,17,4,13,12,45,28,0,Ligue_1,2021_2022
Johaneko Louisjean,FRA,DF,Bordeaux,17,2004,0.1,0,0,0,0,0,0,0,,0,0,0,0,0,0,0,0,Ligue_1,2021_2022
Jean Lucas,BRA,MF,Monaco,23,1998,16.1,43,25,14,24,5,17,40,42.5,23,15,5,10,13,56,4,1,Ligue_1,2021_2022
Castello Lukeba,FRA,DF,Lyon,18,2002,23.3,34,19,27,7,0,15,23,65.2,8,18,9,9,38,72,64,2,Ligue_1,2021_2022
Levi Lumeka,ENG,"DF,FW",Troyes,22,1998,0.7,0,0,0,0,0,0,2,0.0,2,0,0,0,0,0,2,0,Ligue_1,2021_2022
Yannis M'Bemba,GAB,"DF,FW",Nantes,20,2001,0.1,0,0,0,0,0,0,0,,0,0,0,0,0,0,1,0,Ligue_1,2021_2022
Deiver Machado,COL,"DF,MF",Lens,27,1993,5.8,16,14,11,1,4,12,14,85.7,2,9,1,8,3,19,12,1,Ligue_1,2021_2022
Yvann Macon,FRA,DF,Saint-Étienne,22,1998,17.0,41,22,24,14,3,16,42,38.1,26,18,4,14,18,59,27,0,Ligue_1,2021_2022
Louis Mafouta,CTA,FW,Metz,27,1994,5.8,0,0,0,0,0,0,5,0.0,5,1,0,1,0,0,4,0,Ligue_1,2021_2022
Hugo Magnetti,FRA,MF,Brest,23,1998,16.3,50,34,27,20,3,22,50,44.0,28,14,3,11,25,75,13,0,Ligue_1,2021_2022
Yohann Magnin,FRA,"MF,DF",Clermont Foot,24,1997,19.1,53,31,22,26,5,24,42,57.1,18,17,7,10,20,73,36,0,Ligue_1,2021_2022
Habib Maïga,CIV,MF,Metz,25,1996,14.1,47,28,29,13,5,24,48,50.0,24,20,7,13,14,61,18,0,Ligue_1,2021_2022
Josh Maja,NGA,FW,Bordeaux,22,1998,0.1,0,0,0,0,0,0,0,,0,1,0,1,0,0,0,0,Ligue_1,2021_2022
Abdul Majeed Waris,GHA,"FW,MF",Strasbourg,29,1991,3.6,5,3,2,3,0,5,10,50.0,5,2,0,2,0,5,1,0,Ligue_1,2021_2022
Lovro Majer,CRO,"MF,FW",Rennes,23,1998,20.4,32,21,9,14,9,11,42,26.2,31,26,2,24,11,43,9,0,Ligue_1,2021_2022
Béni Makouana,CGO,"FW,MF",Montpellier,18,2002,3.6,2,2,0,0,2,0,1,0.0,1,1,0,1,3,5,2,0,Ligue_1,2021_2022
Hianga Mananga Mbock,FRA,MF,Brest,21,1999,8.9,18,12,8,7,3,9,21,42.9,12,5,2,3,5,23,6,0,Ligue_1,2021_2022
Vincent Manceau,FRA,DF,Angers,32,1989,26.2,32,19,18,13,1,14,37,37.8,23,23,6,17,32,64,72,0,Ligue_1,2021_2022
Steve Mandanda,FRA,GK,Marseille,36,1985,9.0,0,0,0,0,0,0,1,0.0,1,1,0,1,1,1,4,1,Ligue_1,2021_2022
Reinildo Mandava,MOZ,DF,Lille,27,1994,16.9,43,23,29,11,3,32,51,62.7,19,13,4,9,37,80,55,0,Ligue_1,2021_2022
Anthony Mandrea,ALG,GK,Angers,24,1996,10.0,0,0,0,0,0,0,0,,0,0,0,0,0,0,9,0,Ligue_1,2021_2022
Eliaquim Mangala,FRA,DF,Saint-Étienne,30,1991,13.1,17,12,12,5,0,8,12,66.7,4,11,8,3,17,34,61,1,Ligue_1,2021_2022
Thomas Mangani,FRA,MF,Angers,34,1987,24.4,58,30,23,34,1,31,68,45.6,37,38,11,27,36,94,29,0,Ligue_1,2021_2022
Ricardo Mangas,POR,DF,Bordeaux,23,1998,26.1,35,22,22,8,5,26,41,63.4,15,18,4,14,25,60,47,3,Ligue_1,2021_2022
Myziane Maolida,COM,MF,Nice,22,1999,0.4,1,0,0,1,0,0,0,,0,1,0,1,0,1,0,0,Ligue_1,2021_2022
Sekou Mara,FRA,"FW,MF",Bordeaux,19,2002,10.1,8,4,1,1,6,1,8,12.5,7,7,0,7,2,10,6,0,Ligue_1,2021_2022
Marcelo,BRA,DF,Bordeaux,34,1987,10.0,9,5,7,2,0,4,6,66.7,2,4,3,1,13,22,46,1,Ligue_1,2021_2022
Marcelo,BRA,DF,Lyon,34,1987,2.0,4,3,0,4,0,4,6,66.7,2,3,2,1,4,8,10,0,Ligue_1,2021_2022
Guillermo Maripán,CHI,DF,Monaco,27,1994,20.4,36,24,27,9,0,20,40,50.0,20,21,14,7,25,61,66,1,Ligue_1,2021_2022
Marquinhos,BRA,DF,Paris S-G,27,1994,31.8,37,14,25,11,1,20,35,57.1,15,35,19,16,16,53,102,0,Ligue_1,2021_2022
Jonas Martin,FRA,MF,Rennes,31,1990,23.4,35,20,12,21,2,19,53,35.8,34,17,3,14,22,57,28,1,Ligue_1,2021_2022
Gelson Martins,POR,"MF,FW",Monaco,26,1995,21.2,42,27,10,26,6,21,59,35.6,38,26,1,25,17,59,4,0,Ligue_1,2021_2022
Pape Matar Sarr,SEN,MF,Metz,18,2002,23.7,45,26,21,23,1,18,39,46.2,21,33,3,30,29,74,22,0,Ligue_1,2021_2022
Eliot Matazo,BEL,MF,Monaco,19,2002,8.8,8,7,4,4,0,2,11,18.2,9,11,3,8,13,21,9,0,Ligue_1,2021_2022
Chrislain Matsima,FRA,DF,Monaco,19,2002,1.5,3,2,1,2,0,2,7,28.6,5,3,3,0,1,4,6,1,Ligue_1,2021_2022
Azor Matusiwa,NED,MF,Reims,23,1998,27.4,58,32,28,26,4,26,55,47.3,29,49,19,30,62,120,43,0,Ligue_1,2021_2022
Stephy Mavididi,ENG,"FW,MF",Montpellier,23,1998,25.5,24,13,11,7,6,14,39,35.9,25,23,2,21,8,32,11,0,Ligue_1,2021_2022
Derek Mazou-Sacko,FRA,"FW,DF",Troyes,16,2004,0.0,1,0,0,0,1,1,1,100.0,0,0,0,0,0,1,1,0,Ligue_1,2021_2022
Kylian Mbappé,FRA,FW,Paris S-G,22,1998,33.6,11,8,1,4,6,7,13,53.8,6,6,0,6,5,16,13,0,Ligue_1,2021_2022
Amadou Mbengue,SEN,"DF,MF",Metz,19,2002,6.8,19,10,10,9,0,11,22,50.0,11,7,2,5,10,29,19,0,Ligue_1,2021_2022
Jason Mbock,FRA,FW,Angers,21,1999,0.2,0,0,0,0,0,0,0,,0,0,0,0,0,0,0,0,Ligue_1,2021_2022
Moustapha Mbow,SEN,DF,Reims,21,2000,1.0,6,6,3,2,1,3,3,100.0,0,0,0,0,1,7,6,0,Ligue_1,2021_2022
Nathanael Mbuku,FRA,"FW,MF",Reims,19,2002,15.8,14,13,4,7,3,2,8,25.0,6,14,0,14,11,25,4,0,Ligue_1,2021_2022
Facundo Medina,ARG,DF,Lens,22,1999,28.8,61,42,34,23,4,38,62,61.3,24,24,8,16,37,98,78,3,Ligue_1,2021_2022
Farid El Melali,ALG,FW,Angers,24,1997,0.2,0,0,0,0,0,0,1,0.0,1,1,0,1,0,0,1,0,Ligue_1,2021_2022
Birger Meling,NOR,DF,Rennes,26,1994,20.3,43,27,25,11,7,23,31,74.2,8,23,7,16,22,65,40,0,Ligue_1,2021_2022
Houboulang Mendes,GNB,DF,Lorient,23,1998,35.8,58,28,37,18,3,40,57,70.2,17,41,21,20,41,99,128,4,Ligue_1,2021_2022
Nuno Mendes,POR,DF,Paris S-G,19,2002,18.4,48,29,23,18,7,25,47,53.2,22,27,5,22,21,69,17,1,Ligue_1,2021_2022
Pedro Mendes,POR,DF,Montpellier,30,1990,0.2,1,1,1,0,0,0,0,,0,1,1,0,0,1,2,0,Ligue_1,2021_2022
Thiago Mendes,BRA,"MF,DF",Lyon,29,1992,20.7,36,22,18,16,2,12,30,40.0,18,24,5,19,34,70,56,1,Ligue_1,2021_2022
Arial Mendy,SEN,"DF,FW",Clermont Foot,26,1994,8.8,6,4,4,2,0,2,11,18.2,9,6,1,5,7,13,17,0,Ligue_1,2021_2022
Batista Mendy,FRA,"MF,DF",Angers,21,2000,26.8,49,28,21,22,6,23,45,51.1,22,37,6,31,34,83,40,0,Ligue_1,2021_2022
Gideon Mensah,GHA,DF,Bordeaux,23,1998,13.4,37,24,19,12,6,18,38,47.4,20,11,2,9,16,53,21,0,Ligue_1,2021_2022
Quentin Merlin,FRA,"DF,MF",Nantes,19,2002,21.4,45,28,19,20,6,26,49,53.1,23,25,4,21,27,72,29,2,Ligue_1,2021_2022
Lionel Messi,ARG,"FW,MF",Paris S-G,34,1987,23.9,10,3,1,5,4,3,13,23.1,10,5,0,5,4,14,0,0,Ligue_1,2021_2022
Mexer,MOZ,DF,Bordeaux,32,1988,13.6,14,10,11,3,0,11,17,64.7,6,12,7,5,21,35,60,2,Ligue_1,2021_2022
Edouard Michut,FRA,MF,Paris S-G,18,2003,0.8,0,0,0,0,0,0,2,0.0,2,2,0,2,1,1,2,0,Ligue_1,2021_2022
Georges Mikautadze,GEO,FW,Metz,20,2000,0.0,0,0,0,0,0,0,0,,0,0,0,0,0,0,0,0,Ligue_1,2021_2022
William Mikelbrencis,FRA,DF,Metz,17,2004,6.8,11,5,6,4,1,6,9,66.7,3,6,3,3,5,16,9,0,Ligue_1,2021_2022
Arkadiusz Milik,POL,FW,Marseille,27,1994,15.7,9,2,0,5,4,4,18,22.2,14,9,1,8,3,12,10,1,Ligue_1,2021_2022
Terem Moffi,NGA,FW,Lorient,22,1999,30.1,17,10,3,12,2,9,32,28.1,23,11,2,9,4,21,22,0,Ligue_1,2021_2022
Dion Moise Sahi,CIV,"FW,MF",Strasbourg,19,2001,1.4,0,0,0,0,0,0,0,,0,1,0,1,1,1,1,0,Ligue_1,2021_2022
Florent Mollet,FRA,"FW,MF",Montpellier,29,1991,29.2,31,22,14,12,5,14,57,24.6,43,27,4,23,24,55,13,0,Ligue_1,2021_2022
Thomas Monconduit,FRA,MF,Lorient,30,1991,25.0,41,25,19,17,5,20,57,35.1,37,21,10,11,22,63,51,1,Ligue_1,2021_2022
Jérémy Morel,MAD,DF,Lorient,37,1984,6.7,13,9,8,4,1,6,6,100.0,0,9,7,2,7,20,31,0,Ligue_1,2021_2022
Lebo Mothiba,RSA,"FW,MF",Troyes,25,1996,5.8,8,4,4,3,1,2,5,40.0,3,3,0,3,2,10,0,0,Ligue_1,2021_2022
Lebo Mothiba,RSA,FW,Strasbourg,25,1996,0.0,0,0,0,0,0,0,0,,0,0,0,0,0,0,0,0,Ligue_1,2021_2022
Baptiste Mouazan,FRA,MF,Lorient,19,2001,1.1,4,3,2,2,0,1,3,33.3,2,3,0,3,1,5,1,0,Ligue_1,2021_2022
Aimen Moueffek,FRA,MF,Saint-Étienne,20,2001,4.8,7,4,2,3,2,2,8,25.0,6,3,0,3,2,9,4,0,Ligue_1,2021_2022
Harold Moukoudi,CMR,DF,Saint-Étienne,23,1997,18.5,25,12,17,8,0,14,25,56.0,11,27,14,13,35,60,48,0,Ligue_1,2021_2022
Jessy Moulin,FRA,GK,Troyes,35,1986,7.0,0,0,0,0,0,0,0,,0,0,0,0,1,1,7,0,Ligue_1,2021_2022
Steve Mounié,BEN,FW,Brest,26,1994,25.7,17,6,3,12,2,4,27,14.8,23,13,1,12,6,23,12,0,Ligue_1,2021_2022
Samuel Moutoussamy,COD,MF,Nantes,24,1996,16.8,48,32,20,20,8,23,62,37.1,39,14,2,12,17,65,16,0,Ligue_1,2021_2022
Marshall Munetsi,ZIM,"MF,DF",Reims,25,1996,20.9,34,17,21,11,2,17,39,43.6,22,39,13,26,43,77,72,2,Ligue_1,2021_2022
Junior Mwanga,FRA,DF,Bordeaux,18,2003,1.0,5,2,4,1,0,3,3,100.0,0,1,0,1,0,5,1,0,Ligue_1,2021_2022
Kévin N'Doram,FRA,MF,Metz,25,1996,13.7,10,8,3,5,2,3,20,15.0,17,24,5,19,19,29,21,0,Ligue_1,2021_2022
Eric N'Jo,FRA,DF,Troyes,17,2004,1.1,0,0,0,0,0,0,1,0.0,1,1,1,0,2,2,1,0,Ligue_1,2021_2022
Vital N'Simba,COD,DF,Clermont Foot,28,1993,31.0,66,45,38,23,5,36,63,57.1,27,28,7,21,29,95,30,0,Ligue_1,2021_2022
Mickael Nade,FRA,DF,Saint-Étienne,22,1999,28.5,57,35,37,18,2,23,38,60.5,15,29,15,14,60,117,84,0,Ligue_1,2021_2022
Paul Nardi,FRA,GK,Lorient,27,1994,22.0,1,0,1,0,0,1,2,50.0,1,0,0,0,0,1,10,2,Ligue_1,2021_2022
Keylor Navas,CRC,GK,Paris S-G,34,1986,20.6,0,0,0,0,0,0,0,,0,0,0,0,0,0,5,1,Ligue_1,2021_2022
Papa Ndiaga Yade,MTN,"DF,FW",Metz,21,2000,7.7,15,10,8,7,0,8,18,44.4,10,4,1,3,10,25,9,0,Ligue_1,2021_2022
Tanguy Ndombele,FRA,MF,Lyon,24,1996,7.8,25,14,5,17,3,12,19,63.2,7,8,3,5,3,28,6,2,Ligue_1,2021_2022
Dan Ndoye,SUI,"FW,MF",Nice,20,2000,2.3,0,0,0,0,0,0,2,0.0,2,4,0,4,0,0,0,0,Ligue_1,2021_2022
Neymar,BRA,"FW,MF",Paris S-G,29,1992,20.6,29,19,5,12,12,12,36,33.3,24,9,1,8,4,33,2,1,Ligue_1,2021_2022
Yvan Neyou,CMR,MF,Saint-Étienne,24,1997,10.4,29,13,14,12,3,9,27,33.3,18,8,3,5,23,52,13,0,Ligue_1,2021_2022
Opa Nguette,SEN,"FW,MF",Metz,27,1994,11.6,21,14,9,6,6,5,14,35.7,9,13,3,10,2,23,9,0,Ligue_1,2021_2022
Sikou Niakaté,MLI,DF,Metz,22,1999,7.3,8,7,8,0,0,4,11,36.4,7,5,3,2,27,35,34,0,Ligue_1,2021_2022
Ibrahima Niane,SEN,FW,Metz,22,1999,17.6,1,1,0,1,0,0,5,0.0,5,6,1,5,3,4,16,0,Ligue_1,2021_2022
M'Baye Niang,SEN,FW,Bordeaux,26,1994,8.6,4,0,0,2,2,0,4,0.0,4,9,1,8,1,5,4,0,Ligue_1,2021_2022
Cheikh Niasse,SEN,"FW,MF",Lille,21,2000,0.5,2,2,0,2,0,2,3,66.7,1,1,1,0,1,3,2,0,Ligue_1,2021_2022
Casimir Ninga,CHA,FW,Angers,28,1993,4.5,5,1,1,4,0,2,5,40.0,3,2,0,2,1,6,0,0,Ligue_1,2021_2022
Arnaud Nordin,FRA,"FW,MF",Saint-Étienne,23,1998,20.8,21,11,8,8,5,8,22,36.4,14,19,0,19,6,27,8,0,Ligue_1,2021_2022
Alexander Nübel,GER,GK,Monaco,24,1996,38.0,0,0,0,0,0,0,1,0.0,1,0,0,0,0,0,11,1,Ligue_1,2021_2022
Gerzino Nyamsi,FRA,DF,Strasbourg,24,1997,33.2,35,21,24,9,2,20,27,74.1,7,25,16,9,25,60,90,1,Ligue_1,2021_2022
Florent Ogier,FRA,DF,Clermont Foot,32,1989,27.0,31,17,18,12,1,17,31,54.8,14,41,27,14,37,68,89,0,Ligue_1,2021_2022
Warmed Omari,COM,DF,Rennes,21,2000,31.1,33,17,22,10,1,15,23,65.2,8,20,13,7,31,64,94,5,Ligue_1,2021_2022
Jonas Omlin,SUI,GK,Montpellier,27,1994,28.7,2,1,2,0,0,2,3,66.7,1,0,0,0,0,2,12,3,Ligue_1,2021_2022
Amadou Onana,BEL,MF,Lille,19,2001,15.1,48,31,17,27,4,18,25,72.0,7,10,3,7,30,78,19,0,Ligue_1,2021_2022
Jean Onana,CMR,MF,Bordeaux,21,2000,20.4,70,49,33,33,4,35,86,40.7,51,37,5,32,36,106,23,1,Ligue_1,2021_2022
Otávio,BRA,MF,Bordeaux,27,1994,12.7,36,23,13,21,2,16,39,41.0,23,9,3,6,18,54,11,0,Ligue_1,2021_2022
Dango Ouattara,BFA,"MF,FW",Lorient,19,2002,9.0,21,15,9,11,1,11,23,47.8,12,10,1,9,14,35,15,1,Ligue_1,2021_2022
Remi Oudin,FRA,"MF,FW",Bordeaux,24,1996,19.3,34,18,19,13,2,18,32,56.3,14,14,3,11,27,61,21,0,Ligue_1,2021_2022
Alexandre Oukidja,ALG,GK,Metz,33,1988,20.8,0,0,0,0,0,0,1,0.0,1,1,0,1,1,1,17,2,Ligue_1,2021_2022
Azzedine Ounahi,MAR,MF,Angers,21,2000,18.1,39,22,16,22,1,11,40,27.5,29,19,1,18,26,65,13,0,Ligue_1,2021_2022
Ambroise Oyongo,CMR,DF,Montpellier,30,1991,7.3,13,4,7,4,2,9,15,60.0,6,5,1,4,6,19,17,0,Ligue_1,2021_2022
Vincent Pajot,FRA,MF,Metz,30,1990,25.7,86,56,35,47,4,20,46,43.5,26,33,6,27,51,137,38,0,Ligue_1,2021_2022
Nicolas Pallois,FRA,DF,Nantes,33,1987,27.2,51,33,40,11,0,34,59,57.6,25,40,19,21,53,104,116,1,Ligue_1,2021_2022
Erik Palmer-Brown,USA,DF,Troyes,24,1997,19.3,37,22,29,8,0,20,26,76.9,6,26,18,8,34,71,87,1,Ligue_1,2021_2022
Emerson Palmieri,ITA,DF,Lyon,26,1994,25.2,46,25,16,22,8,22,34,64.7,12,23,8,15,27,73,66,0,Ligue_1,2021_2022
Lucas Paquetá,BRA,"MF,FW",Lyon,23,1997,30.0,68,38,24,26,18,17,51,33.3,34,43,5,38,9,77,22,0,Ligue_1,2021_2022
Rubén Pardo,ESP,MF,Bordeaux,28,1992,0.1,0,0,0,0,0,0,0,,0,0,0,0,0,0,0,0,Ligue_1,2021_2022
Leandro Paredes,ARG,MF,Paris S-G,27,1994,9.3,23,13,9,11,3,12,24,50.0,12,10,6,4,10,33,5,2,Ligue_1,2021_2022
Strahinja Pavlović,SRB,DF,Monaco,20,2001,5.0,23,16,8,13,2,8,12,66.7,4,5,3,2,9,32,15,0,Ligue_1,2021_2022
Dimitri Payet,FRA,"FW,MF",Marseille,34,1987,28.8,16,8,4,10,2,7,31,22.6,24,9,0,9,9,25,3,0,Ligue_1,2021_2022
Timothee Pembele,FRA,DF,Bordeaux,18,2002,15.7,20,8,8,10,2,10,29,34.5,19,12,3,9,16,36,24,0,Ligue_1,2021_2022
Brayann Pereira,FRA,"DF,MF",Lens,18,2003,0.2,1,1,1,0,0,1,1,100.0,0,0,0,0,0,1,1,0,Ligue_1,2021_2022
Danilo Pereira,POR,MF,Paris S-G,29,1991,22.6,33,17,10,20,3,14,28,50.0,14,19,10,9,37,70,29,1,Ligue_1,2021_2022
Mathias Pereira Lage,POR,DF,Angers,24,1996,11.6,21,7,10,7,4,8,30,26.7,22,18,7,11,21,42,22,0,Ligue_1,2021_2022
Luan Peres Petroni,BRA,DF,Marseille,27,1994,29.8,65,35,33,25,7,36,52,69.2,16,26,12,14,43,108,64,1,Ligue_1,2021_2022
Lucas Perrin,FRA,DF,Strasbourg,22,1998,27.8,43,32,24,17,2,26,45,57.8,19,28,11,17,42,85,67,0,Ligue_1,2021_2022
Danijel Petković,MNE,GK,Angers,28,1993,15.0,0,0,0,0,0,0,1,0.0,1,0,0,0,1,1,9,5,Ligue_1,2021_2022
Léo Pétrot,FRA,DF,Lorient,24,1997,20.2,31,17,23,8,0,21,29,72.4,8,33,17,16,22,53,86,0,Ligue_1,2021_2022
Romain Philippoteaux,FRA,MF,Brest,33,1988,0.3,1,1,0,1,0,0,0,,0,0,0,0,0,1,0,0,Ligue_1,2021_2022
Jérôme Phojo,FRA,DF,Clermont Foot,28,1993,0.1,0,0,0,0,0,0,0,,0,0,0,0,0,0,1,0,Ligue_1,2021_2022
Jérémy Pied,FRA,"DF,FW",Lille,32,1989,0.1,0,0,0,0,0,0,0,,0,0,0,0,1,1,0,0,Ligue_1,2021_2022
Ronaël Pierre-Gabriel,FRA,DF,Brest,23,1998,28.3,79,45,52,21,6,42,73,57.5,31,22,7,15,48,127,74,0,Ligue_1,2021_2022
Julian Pollersbeck,GER,GK,Lyon,26,1994,4.8,0,0,0,0,0,0,0,,0,0,0,0,1,1,1,0,Ligue_1,2021_2022
Gaëtan Poussin,FRA,GK,Bordeaux,22,1999,13.0,1,1,1,0,0,1,1,100.0,0,0,0,0,0,1,15,1,Ligue_1,2021_2022
Sanjin Prcić,BIH,MF,Strasbourg,27,1993,24.3,47,28,14,27,6,14,29,48.3,15,18,3,15,47,94,19,0,Ligue_1,2021_2022
Nicolas de Préville,FRA,"FW,MF",Metz,30,1991,21.9,17,8,7,8,2,3,19,15.8,16,12,4,8,5,22,11,0,Ligue_1,2021_2022
Nemanja Radonjić,SRB,FW,Marseille,25,1996,0.2,0,0,0,0,0,0,0,,0,0,0,0,0,0,0,0,Ligue_1,2021_2022
Rafinha,BRA,"FW,MF",Paris S-G,28,1993,2.4,14,8,3,9,2,7,11,63.6,4,3,0,3,4,18,0,0,Ligue_1,2021_2022
Predrag Rajković,SRB,GK,Reims,25,1995,38.0,2,2,2,0,0,2,3,66.7,1,1,0,1,1,3,21,1,Ligue_1,2021_2022
Adil Rami,FRA,DF,Troyes,35,1985,13.0,10,9,6,4,0,7,8,87.5,1,17,9,8,16,26,43,0,Ligue_1,2021_2022
Sergio Ramos,ESP,DF,Paris S-G,35,1986,8.9,12,5,6,6,0,8,15,53.3,7,4,2,2,8,20,27,0,Ligue_1,2021_2022
Elba Rashani,KVX,"FW,MF",Clermont Foot,28,1993,19.5,40,21,15,21,4,17,55,30.9,38,34,3,31,11,51,20,0,Ligue_1,2021_2022
Jeff Reine-Adélaïde,FRA,"MF,DF",Lyon,23,1998,2.2,5,3,4,1,0,4,5,80.0,1,2,0,2,0,5,0,1,Ligue_1,2021_2022
Tiago Ribeiro,POR,FW,Monaco,19,2002,0.0,0,0,0,0,0,0,0,,0,0,0,0,0,0,0,0,Ligue_1,2021_2022
Sergio Rico,ESP,GK,Paris S-G,27,1993,0.3,0,0,0,0,0,0,0,,0,0,0,0,0,0,1,0,Ligue_1,2021_2022
Renaud Ripart,FRA,"MF,FW",Troyes,28,1993,21.0,38,21,18,15,5,18,50,36.0,32,21,1,20,19,57,21,1,Ligue_1,2021_2022
Mihailo Ristić,SRB,DF,Montpellier,25,1995,20.0,44,32,26,16,2,25,43,58.1,18,16,6,10,17,61,48,0,Ligue_1,2021_2022
Maxence Rivera,FRA,FW,Saint-Étienne,19,2002,0.1,0,0,0,0,0,0,0,,0,0,0,0,0,0,0,0,Ligue_1,2021_2022
Patrick Roberts,ENG,MF,Troyes,24,1997,0.2,0,0,0,0,0,0,0,,0,0,0,0,0,0,0,0,Ligue_1,2021_2022
Stian Rode Gregersen,NOR,DF,Bordeaux,26,1995,21.7,39,26,23,12,4,18,33,54.5,15,26,16,10,38,77,103,2,Ligue_1,2021_2022
Gerson Rodrigues,LUX,"FW,MF",Troyes,26,1995,9.4,12,9,2,6,4,1,17,5.9,16,8,1,7,0,12,2,0,Ligue_1,2021_2022
Valentin Rongier,FRA,"MF,DF",Marseille,26,1994,24.4,77,51,36,36,5,28,60,46.7,32,26,5,21,33,110,14,0,Ligue_1,2021_2022
Pablo Rosario,NED,MF,Nice,24,1997,30.3,59,37,18,32,9,26,66,39.4,40,33,7,26,38,97,43,0,Ligue_1,2021_2022
Roli Pereira de Sa,FRA,MF,Nantes,24,1996,6.4,12,4,3,5,4,3,20,15.0,17,6,0,6,6,18,3,0,Ligue_1,2021_2022
Mathys Saban,FRA,"FW,MF",Saint-Étienne,19,2002,0.8,4,2,2,2,0,1,1,100.0,0,1,0,1,0,4,0,0,Ligue_1,2021_2022
Falaye Sacko,MLI,DF,Saint-Étienne,26,1995,7.4,15,10,14,1,0,13,16,81.3,3,11,7,4,4,19,18,2,Ligue_1,2021_2022
Rafiki Said,COM,"MF,FW",Brest,21,2000,1.4,4,3,1,2,1,3,4,75.0,1,2,0,2,0,4,0,0,Ligue_1,2021_2022
Wesley Saïd,FRA,"FW,MF",Lens,26,1995,7.3,10,5,1,8,1,1,9,11.1,8,4,0,4,2,12,0,0,Ligue_1,2021_2022
Mamadou Sakho,FRA,DF,Montpellier,31,1990,28.6,34,22,26,8,0,16,26,61.5,10,41,34,7,41,75,134,4,Ligue_1,2021_2022
Bakary Sako,MLI,"FW,MF",Saint-Étienne,33,1988,1.7,0,0,0,0,0,0,1,0.0,1,3,1,2,0,0,0,0,Ligue_1,2021_2022
William Saliba,FRA,DF,Marseille,20,2001,36.0,54,32,36,16,2,27,35,77.1,8,24,16,8,48,102,85,0,Ligue_1,2021_2022
Romain Salin,FRA,GK,Rennes,37,1984,1.0,0,0,0,0,0,0,0,,0,0,0,0,0,0,0,0,Ligue_1,2021_2022
Yoann Salmier,GUF,DF,Troyes,28,1992,29.6,58,33,44,11,3,26,34,76.5,8,30,14,16,40,98,94,0,Ligue_1,2021_2022
Mama Samba Baldé,GNB,"MF,FW",Troyes,25,1995,19.1,40,28,16,14,10,8,26,30.8,18,32,1,31,5,45,9,0,Ligue_1,2021_2022
Junior Sambia,FRA,"DF,FW",Montpellier,24,1996,17.0,22,13,12,7,3,13,22,59.1,9,22,3,19,21,43,31,0,Ligue_1,2021_2022
Renato Sanches,POR,"MF,FW",Lille,23,1997,18.3,19,7,8,10,1,9,26,34.6,17,14,3,11,14,33,7,0,Ligue_1,2021_2022
Philippe Sandler,NED,DF,Troyes,24,1997,0.8,0,0,0,0,0,0,0,,0,1,1,0,3,3,6,0,Ligue_1,2021_2022
Baptiste Santamaria,FRA,"MF,DF",Rennes,26,1995,28.0,52,27,15,31,6,24,44,54.5,20,33,12,21,33,85,42,0,Ligue_1,2021_2022
Pablo Sarabia,ESP,FW,Paris S-G,29,1992,0.2,0,0,0,0,0,0,1,0.0,1,0,0,0,0,0,0,0,Ligue_1,2021_2022
Martin Satriano,URU,FW,Brest,20,2001,10.4,5,2,1,1,3,2,7,28.6,5,8,0,8,2,7,3,0,Ligue_1,2021_2022
Téji Savanier,FRA,MF,Montpellier,29,1991,26.8,46,27,18,19,9,21,59,35.6,38,23,1,22,25,71,12,1,Ligue_1,2021_2022
Morgan Schneiderlin,FRA,MF,Nice,31,1989,7.2,21,12,9,11,1,6,13,46.2,7,8,2,6,20,41,18,0,Ligue_1,2021_2022
Alidu Seidu,GHA,DF,Clermont Foot,21,2000,15.7,34,20,20,13,1,16,27,59.3,11,25,11,14,34,68,49,1,Ligue_1,2021_2022
Matz Sels,BEL,GK,Strasbourg,29,1992,37.0,1,1,1,0,0,0,0,,0,0,0,0,1,2,22,0,Ligue_1,2021_2022
Xherdan Shaqiri,SUI,"FW,MF",Lyon,29,1991,7.5,7,3,0,5,2,2,10,20.0,8,2,0,2,2,9,2,0,Ligue_1,2021_2022
Mahame Siby,MLI,DF,Strasbourg,25,1996,0.2,0,0,0,0,0,0,0,,0,0,0,0,1,1,2,0,Ligue_1,2021_2022
Aboubakar Sidibé,FRA,DF,Clermont Foot,25,1996,0.1,0,0,0,0,0,0,0,,0,0,0,0,0,0,0,0,Ligue_1,2021_2022
Djibril Sidibé,FRA,DF,Monaco,29,1992,10.5,24,13,13,8,3,9,24,37.5,15,10,1,9,16,40,13,0,Ligue_1,2021_2022
Kaj Sierhuis,NED,FW,Reims,23,1998,0.9,1,1,1,0,0,1,3,33.3,2,0,0,0,0,1,1,0,Ligue_1,2021_2022
Caio Henrique Oliveira Silva,BRA,DF,Monaco,24,1997,29.6,53,30,31,18,4,28,59,47.5,31,30,6,24,27,80,37,3,Ligue_1,2021_2022
Gabriel Silva,BRA,"DF,MF",Saint-Étienne,30,1991,7.9,12,7,7,2,3,9,13,69.2,4,9,3,6,18,30,13,0,Ligue_1,2021_2022
Moses Simon,NGA,"FW,MF",Nantes,26,1995,25.9,17,11,6,5,6,11,23,47.8,12,14,3,11,12,29,5,0,Ligue_1,2021_2022
Xavi Simons,NED,"MF,FW",Paris S-G,18,2003,1.5,1,1,0,1,0,1,2,50.0,1,3,0,3,0,1,0,0,Ligue_1,2021_2022
Issouf Sissokho,MLI,MF,Bordeaux,19,2002,4.8,17,8,2,13,2,8,17,47.1,9,8,1,7,7,24,0,0,Ligue_1,2021_2022
Ibrahima Sissoko,MLI,"MF,DF",Strasbourg,23,1997,25.6,47,23,18,20,9,19,46,41.3,27,32,11,21,35,82,31,0,Ligue_1,2021_2022
Nelson Sissoko,FRA,DF,Saint-Étienne,24,1997,0.5,2,0,2,0,0,1,1,100.0,0,0,0,0,0,2,2,0,Ligue_1,2021_2022
Sambou Sissoko,FRA,"MF,DF",Reims,22,1999,2.0,12,6,6,4,2,6,8,75.0,2,2,0,2,2,14,7,0,Ligue_1,2021_2022
Islam Slimani,ALG,FW,Lyon,33,1988,6.4,3,2,0,1,2,1,6,16.7,5,4,0,4,2,5,5,0,Ligue_1,2021_2022
Florian Sotoca,FRA,"FW,MF",Lens,30,1990,27.6,31,19,7,20,4,12,51,23.5,39,31,4,27,25,56,41,0,Ligue_1,2021_2022
Sambou Soumano,SEN,"FW,MF",Lorient,20,2001,5.0,4,1,1,2,1,2,2,100.0,0,3,0,3,1,5,7,0,Ligue_1,2021_2022
Arnaud Souquet,FRA,DF,Montpellier,29,1992,25.9,56,35,30,17,9,32,65,49.2,33,21,7,14,34,90,60,1,Ligue_1,2021_2022
Saidou Sow,GUI,DF,Saint-Étienne,19,2002,11.0,28,17,21,6,1,16,21,76.2,5,15,5,10,23,51,34,0,Ligue_1,2021_2022
Calvin Stengs,NED,MF,Nice,22,1998,11.9,16,7,6,9,1,7,20,35.0,13,10,0,10,8,24,6,0,Ligue_1,2021_2022
Kamaldeen Sulemana,GHA,"MF,FW",Rennes,19,2002,11.3,23,12,7,9,7,10,17,58.8,7,10,1,9,4,27,5,0,Ligue_1,2021_2022
Abdoulaye Sylla,GUI,DF,Nantes,21,2000,1.7,4,4,2,1,1,2,4,50.0,2,5,3,2,1,5,3,0,Ligue_1,2021_2022
Waniss Taibi,FRA,"MF,FW",Angers,19,2002,1.5,8,7,4,4,0,2,4,50.0,2,0,0,0,1,9,1,0,Ligue_1,2021_2022
Flavien Tait,FRA,MF,Rennes,28,1993,23.6,28,19,13,9,6,13,40,32.5,27,15,4,11,19,47,13,1,Ligue_1,2021_2022
Florian Tardieu,FRA,MF,Troyes,29,1992,29.2,58,25,31,21,6,31,71,43.7,40,31,9,22,42,100,38,0,Ligue_1,2021_2022
Oussama Targhalline,MAR,FW,Marseille,19,2002,0.1,0,0,0,0,0,0,0,,0,0,0,0,0,0,0,0,Ligue_1,2021_2022
Loum Tchaouna,FRA,"FW,MF",Rennes,17,2003,1.0,3,1,1,2,0,1,5,20.0,4,0,0,0,2,5,0,0,Ligue_1,2021_2022
Enzo Tchato,CMR,FW,Montpellier,18,2002,0.1,0,0,0,0,0,0,0,,0,0,0,0,0,0,1,0,Ligue_1,2021_2022
Warren Tchimbembé,CGO,MF,Metz,23,1998,2.3,1,1,0,1,0,0,1,0.0,1,2,1,1,2,3,2,0,Ligue_1,2021_2022
Aurélien Tchouaméni,FRA,MF,Monaco,21,2000,32.5,86,45,33,49,4,29,55,52.7,26,39,7,32,101,187,34,0,Ligue_1,2021_2022
Mathys Tel,FRA,"FW,MF",Rennes,16,2005,0.6,2,1,1,1,0,0,0,,0,0,0,0,1,3,2,0,Ligue_1,2021_2022
Jordan Tell,GLP,FW,Clermont Foot,24,1997,3.2,5,5,0,3,2,1,4,25.0,3,3,0,3,0,5,1,0,Ligue_1,2021_2022
Martin Terrier,FRA,"FW,MF",Rennes,24,1997,30.9,55,33,22,16,17,25,43,58.1,18,29,3,26,18,73,17,0,Ligue_1,2021_2022
Tetê,BRA,"FW,MF",Lyon,21,2000,6.5,10,5,4,5,1,3,13,23.1,10,4,0,4,3,13,1,0,Ligue_1,2021_2022
Sada Thioub,SEN,FW,Angers,26,1995,0.0,0,0,0,0,0,0,0,,0,0,0,0,0,0,0,0,Ligue_1,2021_2022
Sada Thioub,SEN,"DF,MF",Saint-Étienne,26,1995,10.6,13,8,5,8,0,6,14,42.9,8,9,0,9,10,23,8,0,Ligue_1,2021_2022
Romain Thomas,FRA,DF,Angers,33,1988,28.5,49,37,28,21,0,30,57,52.6,27,35,19,16,44,93,126,0,Ligue_1,2021_2022
Adrien Thomasson,FRA,MF,Strasbourg,27,1993,26.5,64,31,18,27,19,30,93,32.3,63,56,4,52,29,93,16,1,Ligue_1,2021_2022
Matheus Thuler,BRA,DF,Montpellier,22,1999,9.5,21,12,17,4,0,8,15,53.3,7,9,7,2,9,30,30,0,Ligue_1,2021_2022
Khéphren Thuram,FRA,MF,Nice,20,2001,21.1,33,19,11,18,4,17,35,48.6,18,31,11,20,28,61,19,0,Ligue_1,2021_2022
Cheikh Tidiane Sabaly,SEN,"FW,MF",Metz,22,1999,1.7,6,3,1,4,1,2,2,100.0,0,1,0,1,0,6,1,0,Ligue_1,2021_2022
Jean-Clair Todibo,FRA,DF,Nice,21,1999,34.6,59,37,43,15,1,39,60,65.0,21,45,21,24,51,110,130,2,Ligue_1,2021_2022
Karl Toko Ekambi,CMR,FW,Lyon,28,1992,25.5,13,7,4,6,3,4,21,19.0,17,26,0,26,20,33,5,0,Ligue_1,2021_2022
Yoann Touzghar,TUN,FW,Troyes,34,1986,16.2,5,2,1,3,1,1,3,33.3,2,3,1,2,3,8,8,0,Ligue_1,2021_2022
Amadou Traore,FRA,FW,Bordeaux,19,2002,0.2,0,0,0,0,0,0,0,,0,0,0,0,0,0,0,0,Ligue_1,2021_2022
Boubacar Traoré,MLI,MF,Metz,19,2001,19.2,43,26,18,23,2,10,39,25.6,29,29,5,24,25,68,11,1,Ligue_1,2021_2022
Charles Traore,MLI,DF,Nantes,29,1992,8.0,16,12,10,4,2,2,13,15.4,11,11,4,7,15,31,30,0,Ligue_1,2021_2022
Hamari Traoré,MLI,DF,Rennes,29,1992,32.1,63,36,25,26,12,41,59,69.5,18,29,8,21,37,100,81,1,Ligue_1,2021_2022
Ismaël Traoré,CIV,DF,Angers,34,1986,35.7,28,17,16,11,1,13,28,46.4,15,25,17,8,44,72,122,1,Ligue_1,2021_2022
Miguel Trauco,PER,"DF,MF",Saint-Étienne,28,1992,12.4,25,18,16,8,1,12,22,54.5,10,13,4,9,23,48,17,0,Ligue_1,2021_2022
Adrien Truffert,FRA,DF,Rennes,19,2001,18.2,29,21,17,9,3,11,24,45.8,13,25,5,20,19,48,30,0,Ligue_1,2021_2022
Matthieu Udol,FRA,DF,Metz,25,1996,11.2,23,14,11,10,2,12,18,66.7,6,20,7,13,31,54,29,1,Ligue_1,2021_2022
Ike Ugbo,CAN,FW,Troyes,22,1998,9.0,3,1,0,1,2,0,1,0.0,1,4,1,3,2,5,1,0,Ligue_1,2021_2022
Lesley Ugochukwu,FRA,MF,Rennes,17,2004,4.5,13,9,5,5,3,9,19,47.4,10,7,2,5,4,17,2,0,Ligue_1,2021_2022
Hwang Ui-jo,KOR,FW,Bordeaux,28,1992,27.9,10,4,4,4,2,4,13,30.8,9,9,1,8,5,15,18,0,Ligue_1,2021_2022
Cengiz Ünder,TUR,"FW,MF",Marseille,24,1997,24.4,18,13,5,6,7,5,18,27.8,13,13,2,11,14,32,9,0,Ligue_1,2021_2022
Jere Uronen,FIN,DF,Brest,27,1994,9.8,28,15,15,10,3,14,24,58.3,10,12,3,9,16,44,21,0,Ligue_1,2021_2022
Vanderson,BRA,"FW,DF",Monaco,20,2001,12.4,35,19,10,19,6,15,23,65.2,8,17,4,13,13,48,12,0,Ligue_1,2021_2022
Jonathan Varane,FRA,MF,Lens,19,2001,0.0,0,0,0,0,0,0,0,,0,0,0,0,0,0,0,0,Ligue_1,2021_2022
Marco Verratti,ITA,MF,Paris S-G,28,1992,21.5,60,40,16,30,14,32,64,50.0,32,36,10,26,18,78,14,2,Ligue_1,2021_2022
Kevin Volland,GER,"MF,FW",Monaco,29,1992,27.1,24,10,2,18,4,6,31,19.4,25,20,0,20,3,27,9,0,Ligue_1,2021_2022
Elye Wahi,FRA,FW,Montpellier,18,2003,19.8,18,10,9,6,3,6,16,37.5,10,7,0,7,4,22,4,0,Ligue_1,2021_2022
Timothy Weah,USA,"MF,FW",Lille,21,2000,18.0,19,7,8,8,3,10,20,50.0,10,16,1,15,10,29,7,0,Ligue_1,2021_2022
Georginio Wijnaldum,NED,MF,Paris S-G,30,1990,18.4,15,9,2,12,1,11,19,57.9,8,13,3,10,9,24,7,0,Ligue_1,2021_2022
Christopher Wooh,CMR,DF,Lens,19,2001,11.7,29,11,20,8,1,11,18,61.1,7,21,14,7,21,50,40,1,Ligue_1,2021_2022
Xeka,POR,MF,Lille,26,1994,18.0,47,27,18,24,5,27,56,48.2,29,23,3,20,24,71,26,1,Ligue_1,2021_2022
Sekou Yansané,GUI,FW,Paris S-G,18,2003,0.2,0,0,0,0,0,0,1,0.0,1,0,0,0,0,0,1,0,Ligue_1,2021_2022
Yusuf Yazıcı,TUR,"MF,FW",Lille,24,1997,5.7,10,5,3,6,1,1,9,11.1,8,4,0,4,2,12,1,0,Ligue_1,2021_2022
Burak Yılmaz,TUR,FW,Lille,36,1985,24.6,7,2,0,2,5,2,17,11.8,15,8,1,7,2,9,11,0,Ligue_1,2021_2022
Leny Yoro,FRA,MF,Lille,15,2005,0.1,1,0,0,1,0,0,0,,0,1,0,1,0,1,0,0,Ligue_1,2021_2022
Zaydou Youssouf,FRA,MF,Saint-Étienne,22,1999,17.3,48,26,21,25,2,14,34,41.2,20,11,3,8,17,65,13,0,Ligue_1,2021_2022
Akim Zedadka,ALG,DF,Clermont Foot,26,1995,37.1,72,44,34,29,9,37,71,52.1,34,32,8,24,58,130,48,0,Ligue_1,2021_2022
Arber Zeneli,KVX,FW,Reims,26,1995,4.5,1,0,0,0,1,1,5,20.0,4,0,0,0,1,2,1,0,Ligue_1,2021_2022
Mehdi Zerkane,ALG,"MF,DF",Bordeaux,22,1999,0.9,0,0,0,0,0,0,1,0.0,1,1,1,0,2,2,0,0,Ligue_1,2021_2022
Edon Zhegrova,KVX,"MF,FW",Lille,22,1999,5.3,14,5,2,8,4,5,6,83.3,1,4,1,3,2,16,2,0,Ligue_1,2021_2022
Tanguy Zoukrou,FRA,DF,Troyes,18,2003,0.9,1,0,1,0,0,1,2,50.0,1,0,0,0,0,1,2,0,Ligue_1,2021_2022
Yunis Abdelhamid,MAR,DF,Reims,34,1987,37.0,82,50,47,33,2,39,52,75.0,13,65,27,38,64,146,116,1,Ligue_1,2022_2023
Himad Abdelli,ALG,"MF,FW",Angers,22,1999,23.7,64,38,22,32,10,31,67,46.3,36,30,1,29,28,92,15,0,Ligue_1,2022_2023
Salis Abdul Samed,GHA,MF,Lens,22,2000,32.2,46,26,18,23,5,29,52,55.8,23,38,9,29,36,82,26,0,Ligue_1,2022_2023
Laurent Abergel,FRA,MF,Lorient,29,1993,26.0,92,52,59,30,3,39,92,42.4,53,47,8,39,34,126,39,0,Ligue_1,2022_2023
Matthis Abline,FRA,"FW,MF",Auxerre,19,2003,9.0,4,2,0,3,1,0,5,0.0,5,6,1,5,1,5,1,0,Ligue_1,2022_2023
Matthis Abline,FRA,"FW,MF",Rennes,19,2003,1.2,1,1,0,0,1,1,1,100.0,0,1,0,1,2,3,1,0,Ligue_1,2022_2023
Zakaria Aboukhlal,MAR,"FW,MF",Toulouse,22,2000,27.5,33,23,13,9,11,14,45,31.1,31,18,1,17,22,55,23,0,Ligue_1,2022_2023
Mohamed Achi,FRA,FW,Nantes,20,2002,0.4,1,1,1,0,0,1,1,100.0,0,0,0,0,0,1,0,0,Ligue_1,2022_2023
Martin Adeline,FRA,"MF,FW",Reims,18,2003,1.2,3,3,2,1,0,3,4,75.0,1,3,1,2,3,6,3,0,Ligue_1,2022_2023
Emmanuel Agbadou,CIV,DF,Reims,25,1997,26.5,71,49,53,16,2,42,65,64.6,23,30,14,16,32,103,107,3,Ligue_1,2022_2023
Lucien Agoume,FRA,MF,Troyes,20,2002,12.2,42,25,18,15,9,17,33,51.5,16,14,5,9,27,69,24,0,Ligue_1,2022_2023
Ruben Aguilar,FRA,DF,Monaco,29,1993,13.0,19,9,7,7,5,8,22,36.4,14,13,1,12,18,37,28,1,Ligue_1,2022_2023
Amar Ahmed,SWE,FW,Troyes,18,2004,0.2,1,1,0,1,0,0,1,0.0,1,0,0,0,1,2,0,0,Ligue_1,2022_2023
Jean-Eudes Aholou,CIV,MF,Strasbourg,28,1994,14.4,34,20,10,20,4,12,31,38.7,19,25,0,25,24,58,15,0,Ligue_1,2022_2023
Ludovic Ajorque,FRA,FW,Strasbourg,28,1994,8.6,5,4,1,4,0,3,9,33.3,6,3,1,2,2,7,7,0,Ligue_1,2022_2023
Maghnes Akliouche,FRA,"MF,FW",Monaco,20,2002,4.5,7,4,4,3,0,2,8,25.0,6,2,0,2,3,10,2,0,Ligue_1,2022_2023
Doğan Alemdar,TUR,GK,Rennes,19,2002,4.5,0,0,0,0,0,0,0,,0,0,0,0,0,0,1,1,Ligue_1,2022_2023
Jim Allevinah,GAB,"DF,FW",Clermont Foot,27,1995,24.9,39,24,24,11,4,19,62,30.6,43,24,2,22,24,63,26,1,Ligue_1,2022_2023
Mickaël Alphonse,GLP,DF,Ajaccio,33,1989,15.1,35,23,20,11,4,20,33,60.6,13,17,5,12,35,70,44,1,Ligue_1,2022_2023
Ibrahim Amadou,FRA,"DF,MF",Angers,29,1993,4.7,10,7,6,3,1,7,11,63.6,4,7,3,4,10,20,20,0,Ligue_1,2022_2023
Ayoub Amraoui,MAR,"DF,FW",Nice,18,2004,3.3,6,5,3,3,0,2,5,40.0,3,1,0,1,4,10,4,0,Ligue_1,2022_2023
Benjamin André,FRA,MF,Lille,31,1990,32.4,128,74,51,60,17,65,121,53.7,56,50,8,42,47,175,60,0,Ligue_1,2022_2023
Komnen Andrić,SRB,FW,Clermont Foot,27,1995,16.1,13,5,2,7,4,2,15,13.3,13,8,1,7,8,21,13,0,Ligue_1,2022_2023
Houssem Aouar,ALG,MF,Lyon,24,1998,5.8,12,5,5,5,2,3,9,33.3,6,12,2,10,8,20,3,0,Ligue_1,2022_2023
Adil Aouchiche,FRA,MF,Lorient,20,2002,2.8,5,2,3,1,1,1,9,11.1,8,1,0,1,4,9,1,0,Ligue_1,2022_2023
Dennis Appiah,FRA,"DF,MF",Nantes,30,1992,8.8,21,11,14,7,0,10,27,37.0,17,13,5,8,10,31,16,0,Ligue_1,2022_2023
Stredair Appuah,FRA,"DF,MF",Nantes,18,2004,0.7,2,1,0,2,0,0,0,,0,2,0,2,1,3,0,0,Ligue_1,2022_2023
Taïryk Arconte,FRA,FW,Brest,18,2003,1.4,1,1,0,0,1,0,3,0.0,3,1,0,1,0,1,2,0,Ligue_1,2022_2023
Mohamed El Arouch,FRA,MF,Lyon,18,2004,0.0,1,1,1,0,0,0,0,,0,0,0,0,0,1,0,0,Ligue_1,2022_2023
Lorenz Assignon,TOG,DF,Rennes,22,2000,2.9,6,2,4,2,0,2,4,50.0,2,6,0,6,2,8,9,0,Ligue_1,2022_2023
Youcef Atal,ALG,"DF,MF",Nice,26,1996,8.7,38,22,18,15,5,23,32,71.9,9,9,0,9,14,52,13,0,Ligue_1,2022_2023
Valentin Atangana Edoa,FRA,MF,Reims,16,2005,1.9,8,3,4,2,2,3,6,50.0,3,2,1,1,0,8,1,0,Ligue_1,2022_2023
Mathias Autret,FRA,"MF,FW",Auxerre,31,1991,14.3,22,10,10,10,2,7,16,43.8,9,14,2,12,12,34,13,0,Ligue_1,2022_2023
Cédric Avinel,GLP,DF,Ajaccio,35,1986,19.9,13,7,8,5,0,8,12,66.7,4,20,13,7,15,28,91,1,Ligue_1,2022_2023
Loïc Bade,FRA,DF,Rennes,22,2000,1.0,1,1,1,0,0,0,0,,0,0,0,0,1,2,3,0,Ligue_1,2022_2023
Benoît Badiashile,FRA,DF,Monaco,21,2001,9.3,10,8,6,4,0,5,10,50.0,5,9,6,3,17,27,40,1,Ligue_1,2022_2023
Eric Bailly,CIV,DF,Marseille,28,1994,6.0,13,10,6,6,1,7,7,100.0,0,15,12,3,12,25,18,1,Ligue_1,2022_2023
Dénys Bain,FRA,DF,Auxerre,29,1993,1.4,4,3,3,1,0,1,2,50.0,1,2,1,1,2,6,4,0,Ligue_1,2022_2023
Brandon Baiye,BEL,MF,Clermont Foot,21,2000,0.6,3,2,2,1,0,2,3,66.7,1,1,0,1,1,4,3,0,Ligue_1,2022_2023
Cédric Bakambu,COD,MF,Marseille,31,1991,0.7,2,1,2,0,0,2,2,100.0,0,0,0,0,0,2,0,0,Ligue_1,2022_2023
Thierno Balde,FRA,"DF,MF",Troyes,20,2002,23.9,27,14,19,4,4,18,30,60.0,12,15,3,12,23,50,39,0,Ligue_1,2022_2023
Carlos Baleba,CMR,MF,Lille,18,2004,5.3,13,11,2,9,2,9,14,64.3,5,13,3,10,1,14,3,2,Ligue_1,2022_2023
Leonardo Balerdi,ARG,DF,Marseille,23,1999,29.3,57,37,43,12,2,32,45,71.1,13,48,29,19,63,120,91,1,Ligue_1,2022_2023
Folarin Balogun,USA,FW,Reims,21,2001,33.3,9,5,1,5,3,2,20,10.0,18,20,1,19,3,12,15,0,Ligue_1,2022_2023
Abdoulaye Bamba,CIV,DF,Angers,32,1990,15.2,22,12,15,5,2,16,19,84.2,3,7,3,4,18,40,38,0,Ligue_1,2022_2023
Jonathan Bamba,CIV,FW,Lille,26,1996,30.9,37,17,12,14,11,14,45,31.1,31,36,1,35,22,59,14,0,Ligue_1,2022_2023
Bradley Barcola,FRA,"FW,MF",Lyon,19,2002,16.0,25,16,8,10,7,8,39,20.5,31,29,0,29,19,44,10,0,Ligue_1,2022_2023
Melvin Bard,FRA,DF,Nice,21,2000,27.3,96,60,61,29,6,59,89,66.3,30,35,4,31,64,160,40,1,Ligue_1,2022_2023
Ross Barkley,ENG,"MF,FW",Nice,28,1993,10.7,16,9,7,4,5,7,13,53.8,6,7,2,5,8,24,6,0,Ligue_1,2022_2023
Mickaël Barreto,FRA,MF,Ajaccio,31,1991,14.7,32,20,12,17,3,8,45,17.8,37,17,0,17,18,50,11,0,Ligue_1,2022_2023
Cyrille Bayala,BFA,MF,Ajaccio,26,1996,22.3,53,37,16,20,17,23,48,47.9,25,20,3,17,25,78,21,0,Ligue_1,2022_2023
Yanis Begraoui,MAR,"FW,MF",Toulouse,21,2001,0.7,2,0,1,0,1,1,2,50.0,1,0,0,0,1,3,0,0,Ligue_1,2022_2023
Alexis Beka Beka,FRA,"MF,DF",Nice,21,2001,6.1,16,5,6,9,1,4,15,26.7,11,9,1,8,12,28,6,0,Ligue_1,2022_2023
Jérémie Bela,ANG,"DF,MF",Clermont Foot,29,1993,8.3,6,4,2,1,3,3,4,75.0,1,10,1,9,9,15,8,0,Ligue_1,2022_2023
Reda Belahyane,FRA,MF,Nice,18,2004,2.0,8,6,5,3,0,3,5,60.0,2,5,1,4,2,10,0,0,Ligue_1,2022_2023
Youcef Belaïli,ALG,"MF,FW",Ajaccio,30,1992,12.8,18,10,3,9,6,8,20,40.0,12,10,1,9,5,23,4,0,Ligue_1,2022_2023
Youcef Belaïli,ALG,"FW,MF",Brest,30,1992,4.0,5,2,3,2,0,2,7,28.6,5,2,0,2,1,6,1,0,Ligue_1,2022_2023
Haris Belkebla,ALG,MF,Brest,28,1994,29.5,80,48,35,40,5,44,85,51.8,41,32,6,26,52,132,21,3,Ligue_1,2022_2023
Jean-Ricner Bellegarde,FRA,"MF,FW",Strasbourg,24,1998,26.9,47,25,15,21,11,11,25,44.0,14,26,3,23,26,73,22,0,Ligue_1,2022_2023
Jeanuël Belocian,FRA,DF,Rennes,17,2005,5.6,10,7,3,5,2,5,9,55.6,4,6,3,3,6,16,11,0,Ligue_1,2022_2023
Eliesse Ben Seghir,MAR,"FW,MF",Monaco,17,2005,11.7,18,10,4,12,2,4,12,33.3,8,18,1,17,4,22,1,0,Ligue_1,2022_2023
Salim Ben Seghir,FRA,MF,Marseille,19,2003,0.0,0,0,0,0,0,0,0,,0,1,0,1,0,0,0,0,Ligue_1,2022_2023
Wissam Ben Yedder,FRA,FW,Monaco,31,1990,23.5,16,9,2,5,9,4,13,30.8,9,15,0,15,4,20,0,0,Ligue_1,2022_2023
Nabil Bentaleb,ALG,MF,Angers,27,1994,27.7,74,40,31,35,8,36,61,59.0,25,33,11,22,44,118,29,3,Ligue_1,2022_2023
Patrick Berg,NOR,"MF,FW",Lens,24,1997,0.3,0,0,0,0,0,0,1,0.0,1,0,0,0,1,1,0,0,Ligue_1,2022_2023
Mitchell van Bergen,NED,"FW,DF",Reims,22,1999,10.1,18,8,6,7,5,8,20,40.0,12,8,2,6,6,24,11,0,Ligue_1,2022_2023
Quentin Bernard,FRA,DF,Auxerre,33,1989,7.0,9,7,4,2,3,7,15,46.7,8,9,1,8,15,24,17,0,Ligue_1,2022_2023
Paul Bernardoni,FRA,GK,Angers,25,1997,27.0,2,0,2,0,0,2,3,66.7,1,1,0,1,1,3,12,1,Ligue_1,2022_2023
Juan Bernat,ESP,"DF,MF",Paris S-G,29,1993,18.3,32,16,18,9,5,21,39,53.8,18,11,2,9,9,41,22,1,Ligue_1,2022_2023
Jason Berthomier,FRA,MF,Clermont Foot,32,1990,0.3,0,0,0,0,0,0,0,,0,0,0,0,0,0,0,0,Ligue_1,2022_2023
El Bilal Touré,MLI,FW,Reims,20,2001,1.0,0,0,0,0,0,0,0,,0,2,0,2,0,0,1,0,Ligue_1,2022_2023
Jean-Claude Billong,CMR,MF,Clermont Foot,28,1993,0.3,0,0,0,0,0,0,0,,0,1,1,0,1,1,0,0,Ligue_1,2022_2023
Veljko Birmančević,SRB,"FW,MF",Toulouse,24,1998,4.9,13,7,5,4,4,7,21,33.3,14,12,2,10,7,20,1,0,Ligue_1,2022_2023
Marco Bizot,NED,GK,Brest,31,1991,37.0,0,0,0,0,0,0,1,0.0,1,1,0,1,0,0,24,4,Ligue_1,2022_2023
Rubén Blanco,ESP,GK,Marseille,27,1995,5.5,0,0,0,0,0,0,0,,0,0,0,0,0,0,1,0,Ligue_1,2022_2023
Ludovic Blas,FRA,"MF,FW",Nantes,24,1997,31.3,47,30,17,19,11,17,49,34.7,32,26,1,25,19,66,8,0,Ligue_1,2022_2023
Miha Blažič,SVN,DF,Angers,29,1993,22.0,8,6,8,0,0,7,15,46.7,8,25,19,6,22,30,80,1,Ligue_1,2022_2023
Joaquín Blázquez,ARG,GK,Brest,21,2001,1.0,0,0,0,0,0,0,0,,0,0,0,0,0,0,2,0,Ligue_1,2022_2023
Myron Boadu,NED,FW,Monaco,21,2001,3.3,3,3,0,2,1,1,7,14.3,6,1,0,1,0,3,1,0,Ligue_1,2022_2023
Jérôme Boateng,GER,DF,Lyon,33,1988,4.8,3,0,2,1,0,2,6,33.3,4,8,5,3,6,9,16,0,Ligue_1,2022_2023
Antonin Bobichon,FRA,MF,Angers,26,1995,0.2,0,0,0,0,0,0,0,,0,1,0,1,0,0,0,0,Ligue_1,2022_2023
Quentin Boisgard,FRA,MF,Lorient,25,1997,2.0,6,2,1,4,1,3,4,75.0,1,3,1,2,4,10,2,0,Ligue_1,2022_2023
Neto Borges,BRA,DF,Clermont Foot,25,1996,31.5,75,45,45,20,10,46,75,61.3,29,45,11,34,41,116,62,1,Ligue_1,2022_2023
Kenji-Van Boto,MAD,DF,Auxerre,26,1996,2.0,3,2,2,0,1,2,4,50.0,2,0,0,0,1,4,3,0,Ligue_1,2022_2023
Kouamé Botué,BFA,"FW,MF",Ajaccio,19,2002,2.5,4,2,2,1,1,0,2,0.0,2,1,0,1,0,4,1,0,Ligue_1,2022_2023
Badredine Bouanani,ALG,"FW,MF",Nice,17,2004,9.6,13,9,2,7,4,7,14,50.0,7,4,0,4,1,14,2,0,Ligue_1,2022_2023
Hicham Boudaoui,ALG,MF,Nice,22,1999,20.8,67,32,31,30,6,35,53,66.0,18,34,5,29,36,103,16,0,Ligue_1,2022_2023
Franci Bouebari,FRA,DF,Strasbourg,18,2003,0.8,3,0,1,2,0,3,5,60.0,2,0,0,0,2,5,2,0,Ligue_1,2022_2023
Sofiane Boufal,MAR,"FW,MF",Angers,28,1993,9.3,14,9,7,4,3,3,14,21.4,11,6,0,6,5,19,1,0,Ligue_1,2022_2023
Ismaël Boura,COM,"DF,FW",Lens,21,2000,1.0,6,4,4,2,0,5,6,83.3,1,2,1,1,2,8,3,0,Ligue_1,2022_2023
Benjamin Bourigeaud,FRA,"MF,FW",Rennes,28,1994,34.1,45,29,16,23,6,21,65,32.3,44,38,3,35,31,76,32,0,Ligue_1,2022_2023
Bilal Brahimi,ALG,"FW,MF",Nice,22,2000,8.9,8,5,2,5,1,1,7,14.3,6,4,0,4,4,12,0,0,Ligue_1,2022_2023
Lilian Brassier,FRA,DF,Brest,22,1999,34.4,42,30,31,8,3,23,32,71.9,9,42,19,23,53,95,132,1,Ligue_1,2022_2023
Andreas Bruus,DEN,"DF,FW",Troyes,23,1999,18.1,12,6,9,3,0,8,20,40.0,12,13,2,11,17,29,24,0,Ligue_1,2022_2023
Joe Bryan,ENG,"MF,DF",Nice,28,1993,2.0,5,4,3,2,0,4,4,100.0,0,2,0,2,1,6,1,0,Ligue_1,2022_2023
Adam Buksa,POL,"FW,MF",Lens,26,1996,1.1,1,0,0,0,1,0,3,0.0,3,0,0,0,0,1,0,0,Ligue_1,2022_2023
Maxime Busi,BEL,DF,Reims,22,1999,11.6,21,16,9,11,1,13,29,44.8,16,14,6,8,14,35,24,0,Ligue_1,2022_2023
Marcin Bułka,POL,GK,Nice,22,1999,2.0,0,0,0,0,0,0,1,0.0,1,0,0,0,1,1,0,0,Ligue_1,2022_2023
Rémy Cabella,FRA,"MF,FW",Lille,32,1990,28.1,64,37,21,28,15,29,64,45.3,35,41,5,36,17,81,7,1,Ligue_1,2022_2023
Jimmy Cabot,FRA,"DF,MF",Lens,28,1994,5.7,20,12,10,8,2,12,26,46.2,14,5,0,5,4,24,12,0,Ligue_1,2022_2023
Jens Cajuste,SWE,MF,Reims,22,1999,17.0,46,25,25,14,7,25,48,52.1,23,30,6,24,18,64,22,0,Ligue_1,2022_2023
Duje Ćaleta-Car,CRO,DF,Marseille,25,1996,0.1,0,0,0,0,0,0,0,,0,0,0,0,0,0,1,0,Ligue_1,2022_2023
Mahdi Camara,FRA,MF,Brest,24,1998,20.2,63,36,18,38,7,25,43,58.1,18,35,4,31,40,103,16,0,Ligue_1,2022_2023
Mohamed Camara,MLI,MF,Monaco,22,2000,24.4,83,45,38,39,6,48,92,52.2,44,45,6,39,27,110,14,1,Ligue_1,2022_2023
Ousmane Camara,GUI,"FW,MF",Auxerre,20,2001,0.3,1,1,0,0,1,0,0,,0,0,0,0,0,1,0,0,Ligue_1,2022_2023
Ousmane Camara,FRA,DF,Angers,19,2003,5.8,10,6,5,5,0,5,12,41.7,7,4,2,2,11,21,15,0,Ligue_1,2022_2023
Axel Camblan,FRA,"FW,MF",Brest,18,2003,0.8,2,2,1,1,0,0,1,0.0,1,0,0,0,0,2,0,0,Ligue_1,2022_2023
Pierrick Capelle,FRA,"MF,DF",Angers,35,1987,15.9,36,21,17,15,4,22,55,40.0,33,24,3,21,15,51,24,0,Ligue_1,2022_2023
Maxence Caqueret,FRA,MF,Lyon,22,2000,30.7,87,54,27,38,22,43,109,39.4,66,45,3,42,39,126,27,0,Ligue_1,2022_2023
Irvin Cardona,FRA,"FW,MF",Brest,24,1997,2.6,2,0,1,1,0,0,3,0.0,3,3,0,3,2,4,2,0,Ligue_1,2022_2023
Igor Carioca,BRA,DF,Lorient,25,1996,5.1,18,11,12,2,4,12,21,57.1,9,7,0,7,5,23,17,0,Ligue_1,2022_2023
Matis Carvalho,POR,GK,Montpellier,23,1999,1.5,0,0,0,0,0,0,0,,0,0,0,0,1,1,0,0,Ligue_1,2022_2023
Jean-Charles Castelletto,CMR,DF,Nantes,27,1995,28.5,43,26,29,12,2,22,36,61.1,14,35,22,13,58,101,90,0,Ligue_1,2022_2023
Yoann Cathline,FRA,"FW,MF",Lorient,20,2002,12.1,19,12,7,6,6,5,12,41.7,7,10,1,9,8,27,16,1,Ligue_1,2022_2023
Maximiliano Caufriez,BEL,DF,Clermont Foot,25,1997,24.7,40,24,31,8,1,20,28,71.4,8,33,18,15,34,74,70,0,Ligue_1,2022_2023
Fabien Centonze,FRA,DF,Nantes,26,1996,18.8,58,37,30,22,6,30,42,71.4,12,24,7,17,44,102,55,1,Ligue_1,2022_2023
Florian Chabrolle,FRA,MF,Ajaccio,24,1998,3.7,6,4,1,5,0,2,4,50.0,2,3,0,3,7,13,2,0,Ligue_1,2022_2023
El Chadaille Bitshiabu,FRA,DF,Paris S-G,17,2005,6.5,10,7,7,2,1,3,12,25.0,9,9,7,2,9,19,13,3,Ligue_1,2022_2023
Fares Chaïbi,ALG,"FW,MF",Toulouse,19,2002,26.0,31,18,8,15,8,17,50,34.0,33,38,5,33,19,50,36,1,Ligue_1,2022_2023
Muhammed Cham,AUT,MF,Clermont Foot,21,2000,21.9,30,15,15,4,11,13,35,37.1,22,13,0,13,7,37,5,0,Ligue_1,2022_2023
Gaëtan Charbonnier,FRA,"FW,MF",Auxerre,33,1988,2.8,2,1,0,2,0,0,4,0.0,4,2,0,2,0,2,5,0,Ligue_1,2022_2023
Brendan Chardonnet,FRA,DF,Brest,27,1994,27.7,45,27,27,18,0,20,38,52.6,18,40,19,21,63,108,86,1,Ligue_1,2022_2023
Xavier Chavalerin,FRA,MF,Troyes,31,1991,27.0,82,50,39,30,13,27,71,38.0,44,31,8,23,41,123,24,0,Ligue_1,2022_2023
Ivane Chegra,FRA,"MF,FW",Ajaccio,18,2004,2.1,8,3,6,1,1,4,11,36.4,7,0,0,0,1,9,0,0,Ligue_1,2022_2023
Rayan Cherki,FRA,"MF,FW",Lyon,18,2003,20.8,14,8,2,5,7,8,23,34.8,15,6,0,6,5,19,1,0,Ligue_1,2022_2023
Ilyes Cheti,ALG,DF,Angers,27,1995,2.3,6,4,4,0,2,5,8,62.5,3,5,1,4,4,10,7,0,Ligue_1,2022_2023
Lucas Chevalier,FRA,GK,Lille,20,2001,32.0,2,1,2,0,0,2,2,100.0,0,1,0,1,2,4,7,2,Ligue_1,2022_2023
Pedro Chirivella,ESP,MF,Nantes,25,1997,22.5,33,22,12,15,6,17,44,38.6,27,24,1,23,20,53,7,0,Ligue_1,2022_2023
Joris Chotard,FRA,MF,Montpellier,20,2001,27.3,64,34,37,23,4,40,78,51.3,38,40,11,29,40,104,42,1,Ligue_1,2022_2023
Yanis Cimignani,FRA,"MF,DF",Ajaccio,20,2002,3.1,11,5,3,7,1,4,5,80.0,1,5,1,4,2,13,2,0,Ligue_1,2022_2023
Souleymane Cissé,FRA,DF,Clermont Foot,19,2002,0.4,1,1,1,0,0,1,1,100.0,0,1,1,0,1,2,2,0,Ligue_1,2022_2023
Alexis Claude-Maurice,FRA,FW,Nice,24,1998,0.7,3,2,2,1,0,3,3,100.0,0,0,0,0,2,5,1,0,Ligue_1,2022_2023
Alexis Claude-Maurice,FRA,"MF,FW",Lens,24,1998,6.7,14,9,5,8,1,6,16,37.5,10,6,0,6,2,16,1,0,Ligue_1,2022_2023
Jonathan Clauss,FRA,DF,Marseille,29,1992,28.8,46,28,21,16,9,23,52,44.2,29,29,4,25,31,77,40,2,Ligue_1,2022_2023
Marcus Coco,FRA,"FW,MF",Nantes,26,1996,7.1,24,15,11,9,4,11,23,47.8,12,13,3,10,14,38,7,0,Ligue_1,2022_2023
Alexandre Coeff,FRA,DF,Auxerre,30,1992,6.5,10,5,6,4,0,4,9,44.4,5,9,4,5,8,18,35,1,Ligue_1,2022_2023
Abdu Conté,POR,DF,Troyes,24,1998,14.6,25,17,14,8,3,12,22,54.5,10,13,6,7,6,31,25,0,Ligue_1,2022_2023
Sébastien Corchia,FRA,DF,Nantes,31,1990,8.7,16,6,10,2,4,11,22,50.0,11,9,3,6,14,30,21,0,Ligue_1,2022_2023
David Costa,POR,"MF,FW",Lens,21,2001,15.6,13,7,1,10,2,7,19,36.8,12,19,1,18,11,24,6,0,Ligue_1,2022_2023
Logan Costa,CPV,DF,Toulouse,21,2001,4.6,9,4,7,1,1,6,9,66.7,3,6,3,3,4,13,12,0,Ligue_1,2022_2023
Nuno da Costa,CPV,"FW,MF",Auxerre,31,1991,22.3,45,23,14,23,8,11,46,23.9,35,21,1,20,20,65,15,0,Ligue_1,2022_2023
Benoît Costil,FRA,GK,Auxerre,35,1987,19.0,2,0,2,0,0,2,4,50.0,2,0,0,0,0,2,5,0,Ligue_1,2022_2023
Mathieu Coutadeur,FRA,MF,Ajaccio,36,1986,21.6,23,13,13,10,0,8,28,28.6,20,19,3,16,19,42,21,0,Ligue_1,2022_2023
Nicolas Cozza,FRA,DF,Montpellier,23,1999,14.2,38,21,27,9,2,26,38,68.4,12,11,5,6,21,59,35,1,Ligue_1,2022_2023
Damien Da Silva,FRA,DF,Lyon,34,1988,3.8,8,7,5,3,0,3,3,100.0,0,4,3,1,5,13,12,0,Ligue_1,2022_2023
Andréa Dacourt,FRA,MF,Nice,17,2005,0.0,0,0,0,0,0,0,0,,0,0,0,0,0,0,0,0,Ligue_1,2022_2023
Colin Dagba,FRA,"DF,MF",Strasbourg,23,1998,10.6,32,20,17,10,5,19,26,73.1,7,18,2,16,17,49,19,0,Ligue_1,2022_2023
Thijs Dallinga,NED,FW,Toulouse,21,2000,26.1,8,6,2,2,4,1,13,7.7,12,17,3,14,3,11,20,0,Ligue_1,2022_2023
Flavius Daniliuc,AUT,DF,Nice,21,2001,1.0,2,0,2,0,0,1,1,100.0,0,4,1,3,0,2,1,0,Ligue_1,2022_2023
Kévin Danois,FRA,MF,Auxerre,18,2004,0.0,1,1,0,1,0,0,0,,0,0,0,0,1,2,0,0,Ligue_1,2022_2023
Kevin Danso,AUT,DF,Lens,23,1998,35.9,37,19,25,11,1,19,30,63.3,11,48,34,14,33,70,124,0,Ligue_1,2022_2023
Dante,BRA,DF,Nice,38,1983,36.7,70,40,45,21,4,36,59,61.0,23,52,31,21,47,117,125,2,Ligue_1,2022_2023
Achraf Dari,MAR,DF,Brest,23,1999,14.6,21,14,15,5,1,14,20,70.0,6,16,10,6,19,40,65,2,Ligue_1,2022_2023
Jonathan David,CAN,FW,Lille,22,2000,35.2,24,17,6,11,7,10,27,37.0,17,20,2,18,8,32,13,0,Ligue_1,2022_2023
Thibault De Smet,BEL,DF,Reims,24,1998,19.5,24,17,10,14,0,11,37,29.7,26,28,5,23,20,44,40,1,Ligue_1,2022_2023
Brecht Dejaegere,BEL,MF,Toulouse,31,1991,20.1,40,23,10,20,10,15,51,29.4,36,25,5,20,14,54,11,0,Ligue_1,2022_2023
Romain Del Castillo,FRA,"MF,FW",Brest,26,1996,15.8,39,24,13,17,9,16,36,44.4,20,14,1,13,11,50,5,0,Ligue_1,2022_2023
Thomas Delaine,FRA,"DF,MF",Strasbourg,30,1992,11.9,28,14,16,6,6,13,26,50.0,13,8,3,5,16,44,9,0,Ligue_1,2022_2023
Sacha Delaye,FRA,"FW,MF",Montpellier,20,2002,0.2,1,0,0,0,1,1,1,100.0,0,0,0,0,0,1,0,0,Ligue_1,2022_2023
Andy Delort,ALG,FW,Nice,30,1991,8.7,2,0,1,1,0,1,2,50.0,1,0,0,0,1,3,7,0,Ligue_1,2022_2023
Andy Delort,ALG,FW,Nantes,30,1991,5.2,5,4,1,2,2,2,6,33.3,4,3,0,3,0,5,2,0,Ligue_1,2022_2023
Karamoko Dembélé,ENG,"FW,MF",Brest,19,2003,2.0,2,0,1,1,0,2,2,100.0,0,1,0,1,1,3,0,0,Ligue_1,2022_2023
Moussa Dembélé,FRA,"FW,MF",Lyon,26,1996,9.7,8,4,3,3,2,4,7,57.1,3,5,0,5,2,10,6,0,Ligue_1,2022_2023
Siriki Dembélé,CIV,"MF,FW",Auxerre,25,1996,4.1,10,6,4,3,3,4,12,33.3,8,2,0,2,1,11,2,0,Ligue_1,2022_2023
Branco van den Boomen,NED,MF,Toulouse,27,1995,32.1,71,36,26,32,13,36,89,40.4,53,27,4,23,10,81,27,2,Ligue_1,2022_2023
Rémy Descamps,FRA,GK,Nantes,26,1996,1.0,0,0,0,0,0,0,0,,0,0,0,0,0,0,0,0,Ligue_1,2022_2023
Mikkel Desler,DEN,DF,Toulouse,27,1995,25.1,71,38,36,27,8,43,67,64.2,24,35,6,29,36,107,48,2,Ligue_1,2022_2023
Mamadou Diakhon,FRA,FW,Reims,16,2005,0.2,2,0,2,0,0,0,1,0.0,1,1,0,1,1,3,0,0,Ligue_1,2022_2023
Bafodé Diakité,FRA,DF,Lille,21,2001,29.5,54,35,23,24,7,32,57,56.1,25,37,8,29,17,71,58,0,Ligue_1,2022_2023
Ibrahim Diakité,GUI,DF,Reims,18,2003,1.5,3,3,3,0,0,2,3,66.7,1,0,0,0,5,8,6,0,Ligue_1,2022_2023
Baila Diallo,FRA,"DF,MF",Clermont Foot,21,2001,1.0,1,0,1,0,0,0,0,,0,1,1,0,0,1,1,0,Ligue_1,2022_2023
Habib Diallo,SEN,FW,Strasbourg,27,1995,32.0,18,10,8,7,3,6,16,37.5,10,19,4,15,12,30,26,0,Ligue_1,2022_2023
Ismael Diallo,CIV,DF,Ajaccio,25,1997,24.2,46,33,35,9,2,35,63,55.6,28,26,12,14,30,76,46,1,Ligue_1,2022_2023
Habib Diarra,SEN,"MF,FW",Strasbourg,18,2004,18.1,24,16,10,11,3,15,29,51.7,14,17,1,16,11,35,13,0,Ligue_1,2022_2023
Moussa Diarra,MLI,DF,Toulouse,21,2000,13.6,20,9,9,9,2,9,15,60.0,6,25,10,15,19,39,27,1,Ligue_1,2022_2023
Stéphane Diarra,FRA,"FW,MF",Lorient,23,1998,11.8,25,17,14,9,2,11,29,37.9,18,13,1,12,22,47,9,0,Ligue_1,2022_2023
Krépin Diatta,SEN,"MF,FW",Monaco,23,1999,23.0,30,21,4,17,9,13,32,40.6,19,29,1,28,17,47,12,0,Ligue_1,2022_2023
Mory Diaw,SEN,GK,Clermont Foot,29,1993,37.0,0,0,0,0,0,0,4,0.0,4,0,0,0,2,2,13,5,Ligue_1,2022_2023
Bamba Dieng,SEN,"FW,MF",Marseille,22,2000,2.2,4,4,2,1,1,3,4,75.0,1,5,1,4,0,4,0,0,Ligue_1,2022_2023
Bamba Dieng,SEN,FW,Lorient,22,2000,8.3,19,10,5,12,2,3,11,27.3,8,6,0,6,2,21,6,0,Ligue_1,2022_2023
Tristan Dingomé,CMR,MF,Troyes,31,1991,1.1,1,1,0,1,0,0,2,0.0,2,0,0,0,0,1,0,0,Ligue_1,2022_2023
Sinaly Diomande,CIV,DF,Lyon,21,2001,21.7,42,24,26,15,1,31,49,63.3,18,26,13,13,49,91,75,1,Ligue_1,2022_2023
Lois Diony,FRA,FW,Angers,29,1992,5.6,1,0,0,1,0,1,3,33.3,2,2,0,2,0,1,1,0,Ligue_1,2022_2023
Edan Diop,FRA,"DF,FW",Monaco,17,2004,2.5,13,8,3,3,7,7,15,46.7,8,7,1,6,4,17,1,0,Ligue_1,2022_2023
Sofiane Diop,FRA,"MF,FW",Nice,22,2000,13.6,23,11,12,6,5,7,20,35.0,13,14,2,12,16,39,5,0,Ligue_1,2022_2023
Sofiane Diop,FRA,MF,Monaco,22,2000,0.7,0,0,0,0,0,0,0,,0,0,0,0,1,1,0,0,Ligue_1,2022_2023
Yehvann Diouf,FRA,GK,Reims,22,1999,31.0,2,0,2,0,0,1,3,33.3,2,0,0,0,1,3,13,5,Ligue_1,2022_2023
Axel Disasi,FRA,DF,Monaco,24,1998,37.0,30,20,13,13,4,13,27,48.1,14,51,31,20,56,86,112,2,Ligue_1,2022_2023
Tiago Djaló,POR,DF,Lille,22,2000,22.4,31,21,23,7,1,13,20,65.0,7,17,11,6,23,54,60,1,Ligue_1,2022_2023
Alexander Djiku,GHA,DF,Strasbourg,27,1994,29.7,53,36,37,16,0,26,46,56.5,20,45,19,26,66,119,151,3,Ligue_1,2022_2023
Moussa Djitte,SEN,FW,Ajaccio,22,1999,1.5,1,0,0,0,1,1,2,50.0,1,0,0,0,0,1,1,0,Ligue_1,2022_2023
Ouparine Djoco,GNB,GK,Clermont Foot,24,1998,1.0,0,0,0,0,0,0,0,,0,0,0,0,0,0,1,0,Ligue_1,2022_2023
Alan Do Marcolino,GAB,FW,Rennes,20,2002,0.2,0,0,0,0,0,0,0,,0,0,0,0,0,0,1,0,Ligue_1,2022_2023
Jeremy Doku,BEL,"MF,FW",Rennes,20,2002,14.3,25,16,6,13,6,12,24,50.0,12,10,0,10,5,30,2,0,Ligue_1,2022_2023
Kyliane Dong,FRA,"MF,FW",Troyes,17,2004,2.4,3,1,0,2,1,1,2,50.0,1,1,0,1,1,4,0,0,Ligue_1,2022_2023
Jordan Dongmo,CMR,MF,Troyes,21,2001,0.2,1,0,0,1,0,1,1,100.0,0,0,0,0,0,1,0,0,Ligue_1,2022_2023
Gianluigi Donnarumma,ITA,GK,Paris S-G,23,1999,37.9,1,0,1,0,0,1,2,50.0,1,0,0,0,0,1,12,4,Ligue_1,2022_2023
Jodel Dossou,BEN,"MF,DF",Clermont Foot,30,1992,2.9,7,4,3,2,2,4,4,100.0,0,2,1,1,1,8,0,0,Ligue_1,2022_2023
Lohann Doucet,FRA,"MF,FW",Nantes,19,2002,1.0,3,0,2,0,1,3,4,75.0,1,2,0,2,2,5,4,0,Ligue_1,2022_2023
Siriné Doucouré,MLI,"FW,MF",Lorient,20,2002,1.5,2,2,2,0,0,1,2,50.0,1,0,0,0,1,3,0,0,Ligue_1,2022_2023
Désiré Doué,FRA,"MF,FW",Rennes,17,2005,12.4,37,18,10,23,4,13,32,40.6,19,17,1,16,13,50,3,0,Ligue_1,2022_2023
Guela Doué,CIV,"FW,MF",Rennes,19,2002,0.1,0,0,0,0,0,0,0,,0,0,0,0,0,0,0,0,Ligue_1,2022_2023
Ismaël Doukouré,FRA,"DF,MF",Strasbourg,19,2003,25.5,48,24,23,21,4,20,34,58.8,14,26,8,18,27,75,54,0,Ligue_1,2022_2023
Kamory Doumbia,MLI,MF,Reims,19,2003,12.8,31,16,9,14,8,12,37,32.4,25,17,1,16,13,44,3,0,Ligue_1,2022_2023
Souleyman Doumbia,CIV,"DF,FW",Angers,25,1996,19.9,45,31,31,13,1,17,31,54.8,14,20,3,17,27,72,27,1,Ligue_1,2022_2023
Rémy Dugimont,FRA,"FW,MF",Auxerre,36,1986,1.3,2,1,0,1,1,1,2,50.0,1,3,0,3,0,2,5,0,Ligue_1,2022_2023
Maxime Dupé,FRA,GK,Toulouse,29,1993,38.0,0,0,0,0,0,0,0,,0,0,0,0,0,0,9,3,Ligue_1,2022_2023
Jean-Kevin Duverne,HAI,DF,Brest,25,1997,27.9,72,38,44,24,4,42,73,57.5,31,33,5,28,28,100,65,1,Ligue_1,2022_2023
Hugo Ekitike,FRA,FW,Paris S-G,20,2002,12.8,12,4,1,10,1,4,12,33.3,8,12,0,12,9,21,3,0,Ligue_1,2022_2023
Alberth Elis,HON,"MF,FW",Brest,26,1996,2.9,4,3,1,2,1,1,7,14.3,6,1,0,1,1,5,2,0,Ligue_1,2022_2023
Breel Embolo,SUI,FW,Monaco,25,1997,20.7,15,9,2,7,6,5,10,50.0,5,14,3,11,5,20,12,0,Ligue_1,2022_2023
Maxime Estève,FRA,DF,Montpellier,20,2002,18.3,24,13,17,5,2,12,17,70.6,5,28,17,11,34,58,90,0,Ligue_1,2022_2023
Fábio,BRA,"DF,MF",Nantes,32,1990,2.5,4,2,1,2,1,4,6,66.7,2,2,0,2,3,7,11,0,Ligue_1,2022_2023
Noah Fadiga,SEN,DF,Brest,22,1999,14.5,30,21,18,9,3,14,26,53.8,12,17,7,10,26,56,18,0,Ligue_1,2022_2023
Wout Faes,BEL,DF,Reims,24,1998,3.0,1,1,1,0,0,1,2,50.0,1,6,3,3,7,8,19,0,Ligue_1,2022_2023
Romain Faivre,FRA,"MF,FW",Lorient,24,1998,13.8,13,8,5,4,4,5,25,20.0,20,11,0,11,1,14,4,0,Ligue_1,2022_2023
Romain Faivre,FRA,MF,Lyon,24,1998,3.3,6,3,2,2,2,1,3,33.3,2,3,0,3,0,6,0,0,Ligue_1,2022_2023
Fallou Fall,SEN,DF,Reims,18,2004,0.4,0,0,0,0,0,0,1,0.0,1,3,3,0,0,0,4,0,Ligue_1,2022_2023
Khalil Fayad,FRA,MF,Montpellier,18,2004,8.0,30,14,12,16,2,12,21,57.1,9,8,1,7,9,39,4,0,Ligue_1,2022_2023
Cheikh Faye,SEN,FW,Montpellier,23,1999,0.4,0,0,0,0,0,0,0,,0,0,0,0,1,1,0,0,Ligue_1,2022_2023
Jordan Ferri,FRA,MF,Montpellier,30,1992,30.4,55,35,32,19,4,30,89,33.7,59,22,6,16,26,81,21,0,Ligue_1,2022_2023
Karol Fila,POL,DF,Strasbourg,24,1998,0.5,0,0,0,0,0,0,0,,0,0,0,0,1,1,1,0,Ligue_1,2022_2023
Alexis Flips,FRA,"FW,MF",Reims,22,2000,22.0,51,30,18,17,16,27,64,42.2,37,35,5,30,24,75,12,0,Ligue_1,2022_2023
Seko Fofana,CIV,MF,Lens,27,1995,34.1,28,13,8,18,2,15,39,38.5,24,17,4,13,19,47,14,0,Ligue_1,2022_2023
Yahia Fofana,CIV,GK,Angers,21,2000,11.0,0,0,0,0,0,0,0,,0,0,0,0,1,1,4,1,Ligue_1,2022_2023
Youssouf Fofana,FRA,MF,Monaco,23,1999,34.3,81,41,31,42,8,38,74,51.4,36,50,6,44,56,137,32,1,Ligue_1,2022_2023
Thomas Foket,BEL,DF,Reims,27,1994,22.0,35,22,18,11,6,17,46,37.0,29,21,7,14,33,68,29,2,Ligue_1,2022_2023
José Fonte,POR,DF,Lille,38,1983,28.8,23,17,18,4,1,10,21,47.6,11,27,14,13,25,48,112,2,Ligue_1,2022_2023
Steven Fortes,CPV,DF,Lens,30,1992,0.1,0,0,0,0,0,0,0,,0,0,0,0,0,0,0,0,Ligue_1,2022_2023
Przemysław Frankowski,POL,"DF,MF",Lens,27,1995,31.5,77,51,37,31,9,39,80,48.8,41,38,6,32,41,118,42,2,Ligue_1,2022_2023
Angelo Fulgini,FRA,"MF,FW",Lens,25,1996,9.5,14,7,2,4,8,5,14,35.7,9,11,0,11,8,22,2,0,Ligue_1,2022_2023
Gauthier Gallon,FRA,GK,Troyes,29,1993,29.6,2,2,2,0,0,2,4,50.0,2,0,0,0,2,4,17,0,Ligue_1,2022_2023
Kévin Gameiro,FRA,FW,Strasbourg,35,1987,23.3,20,10,6,10,4,8,28,28.6,20,10,1,9,9,29,0,0,Ligue_1,2022_2023
Ignatius Ganago,CMR,"FW,MF",Nantes,23,1999,16.9,9,7,2,3,4,4,7,57.1,3,13,1,12,2,11,12,0,Ligue_1,2022_2023
Ignatius Ganago,CMR,FW,Lens,23,1999,0.7,0,0,0,0,0,0,0,,0,0,0,0,0,0,1,0,Ligue_1,2022_2023
Johan Gastien,FRA,MF,Clermont Foot,34,1988,28.9,62,34,30,23,9,38,111,34.2,73,37,7,30,36,98,25,1,Ligue_1,2022_2023
Denis Genreau,AUS,MF,Toulouse,23,1999,7.3,35,13,16,12,7,13,31,41.9,18,16,1,15,8,43,9,0,Ligue_1,2022_2023
Valère Germain,FRA,"FW,MF",Montpellier,32,1990,7.6,13,11,3,5,5,4,12,33.3,8,8,0,8,6,19,12,0,Ligue_1,2022_2023
Gerson,BRA,MF,Marseille,25,1997,4.6,6,4,1,4,1,3,5,60.0,2,5,0,5,2,8,4,0,Ligue_1,2022_2023
Ismaël Gharbi,ESP,"MF,FW",Paris S-G,18,2004,0.6,0,0,0,0,0,0,2,0.0,2,2,0,2,3,3,0,0,Ligue_1,2022_2023
Faouzi Ghoulam,ALG,DF,Angers,31,1991,5.3,3,3,1,1,1,3,5,60.0,2,4,2,2,4,7,12,1,Ligue_1,2022_2023
Samuel Gigot,FRA,DF,Marseille,28,1993,20.9,46,24,22,21,3,12,15,80.0,3,24,7,17,45,91,85,1,Ligue_1,2022_2023
Andrei Girotto,BRA,"DF,MF",Nantes,30,1992,35.0,122,73,71,45,6,74,132,56.1,58,55,24,31,73,195,176,1,Ligue_1,2022_2023
Aleksandr Golovin,RUS,"MF,FW",Monaco,26,1996,27.4,62,36,19,32,11,28,72,38.9,44,28,1,27,37,99,10,0,Ligue_1,2022_2023
André Gomes,POR,MF,Lille,29,1993,18.1,37,19,12,17,8,19,52,36.5,33,20,5,15,9,46,16,1,Ligue_1,2022_2023
Angel Gomes,ENG,MF,Lille,21,2000,31.3,41,19,12,21,8,18,49,36.7,31,22,2,20,13,54,11,1,Ligue_1,2022_2023
Maxime Gonalons,FRA,MF,Clermont Foot,33,1989,16.1,52,32,25,21,6,25,53,47.2,28,21,1,20,20,72,7,1,Ligue_1,2022_2023
Oumar Gonzalez,CMR,DF,Ajaccio,24,1998,28.6,51,28,34,13,4,23,37,62.2,14,32,11,21,52,103,82,0,Ligue_1,2022_2023
Amine Gouiri,ALG,"FW,MF",Nice,22,2000,2.5,1,1,1,0,0,0,1,0.0,1,1,0,1,0,1,3,0,Ligue_1,2022_2023
Amine Gouiri,ALG,"FW,MF",Rennes,22,2000,28.0,42,25,14,16,12,14,33,42.4,19,21,0,21,12,54,10,0,Ligue_1,2022_2023
Jonathan Gradit,FRA,DF,Lens,29,1992,31.4,62,40,30,25,7,31,53,58.5,22,40,26,14,38,100,83,0,Ligue_1,2022_2023
Andrew Gravillon,GLP,DF,Reims,24,1998,11.5,16,8,9,6,1,8,13,61.5,5,18,9,9,21,37,36,0,Ligue_1,2022_2023
Adrian Grbić,AUT,"MF,FW",Lorient,25,1996,0.3,0,0,0,0,0,0,1,0.0,1,3,0,3,0,0,0,0,Ligue_1,2022_2023
Gabriel Gudmundsson,SWE,"DF,FW",Lille,23,1999,9.3,19,11,7,10,2,12,22,54.5,10,11,2,9,10,29,20,0,Ligue_1,2022_2023
Axel Gueguin,FRA,"FW,MF",Montpellier,17,2005,0.3,0,0,0,0,0,0,0,,0,1,0,1,0,0,0,0,Ligue_1,2022_2023
Mattéo Guendouzi,FRA,MF,Marseille,23,1999,23.4,39,18,9,21,9,14,38,36.8,24,12,5,7,21,60,18,0,Ligue_1,2022_2023
Evann Guessand,CIV,"FW,MF",Nantes,21,2001,14.0,24,16,8,13,3,6,12,50.0,6,17,1,16,9,33,6,0,Ligue_1,2022_2023
Pape Gueye,SEN,"MF,DF",Marseille,23,1999,5.5,18,7,10,7,1,7,15,46.7,8,9,2,7,9,27,2,0,Ligue_1,2022_2023
Frederic Guilbert,FRA,DF,Strasbourg,27,1994,16.2,47,29,18,23,6,25,43,58.1,18,24,3,21,43,90,33,1,Ligue_1,2022_2023
Serhou Guirassy,GUI,MF,Rennes,26,1996,0.3,0,0,0,0,0,0,0,,0,0,0,0,0,0,0,0,Ligue_1,2022_2023
Rafik Guitane,FRA,FW,Reims,23,1999,0.0,0,0,0,0,0,0,0,,0,0,0,0,0,0,1,0,Ligue_1,2022_2023
Malo Gusto,FRA,DF,Lyon,19,2003,17.7,42,26,23,11,8,21,43,48.8,22,22,5,17,28,70,23,1,Ligue_1,2022_2023
Jaouen Hadjam,ALG,DF,Nantes,19,2003,8.9,27,21,13,9,5,16,25,64.0,9,10,3,7,12,39,12,0,Ligue_1,2022_2023
Massadio Haïdara,MLI,"DF,MF",Lens,29,1992,18.6,24,16,9,9,6,12,24,50.0,12,26,9,17,36,60,39,1,Ligue_1,2022_2023
Achraf Hakimi,MAR,"DF,MF",Paris S-G,23,1998,22.8,54,34,19,20,15,31,59,52.5,28,34,2,32,16,70,19,0,Ligue_1,2022_2023
Mathis Hamdi,FRA,DF,Troyes,18,2003,0.8,0,0,0,0,0,0,1,0.0,1,0,0,0,1,1,1,0,Ligue_1,2022_2023
Ben Hamed Touré,CIV,FW,Ajaccio,18,2003,2.3,4,4,2,2,0,1,5,20.0,4,2,0,2,1,5,4,0,Ligue_1,2022_2023
Romain Hamouma,FRA,"FW,MF",Ajaccio,35,1987,12.0,8,3,3,3,2,3,6,50.0,3,8,0,8,2,10,2,0,Ligue_1,2022_2023
Saïd Hamulic,BIH,FW,Toulouse,21,2000,1.2,0,0,0,0,0,0,0,,0,0,0,0,0,0,0,0,Ligue_1,2022_2023
Amine Harit,MAR,"MF,FW",Marseille,25,1997,5.7,6,4,0,3,3,3,8,37.5,5,4,1,3,4,10,6,0,Ligue_1,2022_2023
Rhys Healey,WAL,FW,Toulouse,27,1994,0.7,0,0,0,0,0,0,0,,0,0,0,0,0,0,0,0,Ligue_1,2022_2023
Gauthier Hein,FRA,"MF,FW",Auxerre,25,1996,20.8,27,20,13,11,3,18,48,37.5,30,10,0,10,6,33,10,0,Ligue_1,2022_2023
Henrique,BRA,"DF,FW",Lyon,28,1994,4.0,9,4,3,2,4,6,13,46.2,7,3,1,2,5,14,8,0,Ligue_1,2022_2023
Christophe Hérelle,MTQ,DF,Brest,29,1992,11.8,10,4,7,2,1,4,13,30.8,9,16,11,5,20,30,48,0,Ligue_1,2022_2023
Noah Holm,NOR,"FW,MF",Reims,21,2001,2.2,6,4,2,2,2,2,5,40.0,3,0,0,0,0,6,5,0,Ligue_1,2022_2023
Franck Honorat,FRA,"FW,MF",Brest,25,1996,28.2,41,29,20,8,13,19,34,55.9,15,22,2,20,21,62,18,0,Ligue_1,2022_2023
Cédric Hountondji,BEN,DF,Angers,28,1994,34.4,50,36,31,17,2,19,29,65.5,10,44,22,22,59,109,132,1,Ligue_1,2022_2023
Ilyes Housni,FRA,FW,Paris S-G,17,2005,0.1,1,1,1,0,0,1,1,100.0,0,0,0,0,0,1,0,0,Ligue_1,2022_2023
Adrien Hunou,FRA,"MF,FW",Angers,28,1994,24.8,39,20,17,16,6,16,45,35.6,29,35,0,35,7,46,7,0,Ligue_1,2022_2023
Mounaim El Idrissy,FRA,FW,Ajaccio,23,1999,27.7,32,19,5,20,7,10,36,27.8,26,22,0,22,13,45,20,0,Ligue_1,2022_2023
Rareş Ilie,ROU,"MF,FW",Nice,19,2003,1.6,3,3,0,1,2,2,4,50.0,2,2,0,2,1,4,1,0,Ligue_1,2022_2023
Bonke Innocent,NGA,MF,Lorient,26,1996,13.1,28,17,13,14,1,11,36,30.6,25,22,5,17,26,54,31,0,Ligue_1,2022_2023
Ismaily,BRA,DF,Lille,32,1990,19.8,41,18,16,16,9,17,32,53.1,15,25,5,20,21,62,39,0,Ligue_1,2022_2023
Junya Ito,JPN,FW,Reims,29,1993,32.4,40,20,14,15,11,13,53,24.5,40,29,1,28,8,48,4,1,Ligue_1,2022_2023
Ismail Jakobs,SEN,"DF,FW",Monaco,22,1999,12.4,11,5,7,3,1,5,12,41.7,7,9,1,8,9,20,18,0,Ligue_1,2022_2023
Marin Jakoliš,CRO,FW,Angers,25,1996,0.3,1,1,0,0,1,0,0,,0,0,0,0,0,1,0,0,Ligue_1,2022_2023
Léo Jardim,BRA,GK,Lille,27,1995,6.0,0,0,0,0,0,0,1,0.0,1,0,0,0,0,0,0,1,Ligue_1,2022_2023
Luis Javier Suárez,COL,FW,Marseille,24,1997,3.3,4,1,1,2,1,1,4,25.0,3,1,0,1,3,7,6,0,Ligue_1,2022_2023
Dany Jean,HAI,"DF,MF",Strasbourg,19,2002,0.1,0,0,0,0,0,0,1,0.0,1,1,0,1,0,0,0,0,Ligue_1,2022_2023
Julian Jeanvier,GUI,DF,Auxerre,30,1992,19.6,32,17,24,8,0,13,22,59.1,9,24,17,7,27,59,96,1,Ligue_1,2022_2023
Jeffinho,BRA,FW,Lyon,22,1999,5.0,17,4,4,9,4,6,15,40.0,9,6,0,6,1,18,0,0,Ligue_1,2022_2023
Paul Joly,FRA,DF,Auxerre,22,2000,9.6,33,21,21,10,2,19,35,54.3,16,13,2,11,24,57,29,2,Ligue_1,2022_2023
Jubal,BRA,DF,Auxerre,28,1993,35.7,41,26,29,11,1,19,38,50.0,19,57,34,23,53,94,193,0,Ligue_1,2022_2023
Christopher Jullien,FRA,DF,Montpellier,29,1993,29.9,46,28,29,14,3,28,51,54.9,23,35,18,17,43,89,114,1,Ligue_1,2022_2023
Eli Junior Kroupi,FRA,"FW,MF",Lorient,16,2006,0.1,0,0,0,0,0,0,1,0.0,1,0,0,0,1,1,0,0,Ligue_1,2022_2023
Issa Kaboré,BFA,DF,Marseille,21,2001,11.4,33,19,10,18,5,21,32,65.6,11,11,1,10,12,45,21,1,Ligue_1,2022_2023
Abdoul Kader Bamba,FRA,"FW,MF",Nantes,28,1994,0.9,0,0,0,0,0,0,2,0.0,2,3,1,2,0,0,1,0,Ligue_1,2022_2023
Gaël Kakuta,COD,FW,Lens,31,1991,0.2,0,0,0,0,0,0,0,,0,0,0,0,0,0,1,0,Ligue_1,2022_2023
Arnaud Kalimuendo,FRA,FW,Rennes,20,2002,20.5,15,8,3,6,6,5,20,25.0,15,15,2,13,2,17,9,0,Ligue_1,2022_2023
Gedeon Kalulu,COD,DF,Lorient,24,1997,27.1,64,34,43,14,7,30,48,62.5,18,32,3,29,28,92,79,2,Ligue_1,2022_2023
Justin-Noël Kalumba,FRA,DF,Angers,17,2004,6.1,9,5,5,2,2,5,16,31.3,11,4,1,3,4,13,5,0,Ligue_1,2022_2023
Waren Kamanzi,NOR,DF,Toulouse,21,2000,7.4,16,9,9,5,2,13,19,68.4,6,8,2,6,8,24,9,0,Ligue_1,2022_2023
Bingourou Kamara,SEN,GK,Montpellier,25,1996,4.5,0,0,0,0,0,0,0,,0,0,0,0,0,0,2,0,Ligue_1,2022_2023
Nordine Kandil,FRA,"MF,FW",Strasbourg,20,2001,1.1,3,2,1,2,0,0,3,0.0,3,2,0,2,1,4,1,0,Ligue_1,2022_2023
Ayman Kari,FRA,"MF,DF",Lorient,17,2004,1.1,0,0,0,0,0,0,0,,0,4,0,4,3,3,0,0,Ligue_1,2022_2023
Kévin Keben Biakolo,CMR,DF,Toulouse,18,2004,4.0,3,2,2,0,1,0,4,0.0,4,1,0,1,5,8,9,0,Ligue_1,2022_2023
Check Keita,FRA,DF,Reims,19,2003,7.6,12,9,9,3,0,4,9,44.4,5,6,5,1,5,17,24,1,Ligue_1,2022_2023
Saîf-Eddine Khaoui,TUN,MF,Clermont Foot,27,1995,22.5,47,28,14,25,8,15,47,31.9,32,17,2,15,33,80,8,0,Ligue_1,2022_2023
Wahbi Khazri,TUN,"FW,MF",Montpellier,31,1991,18.2,26,13,13,7,6,6,25,24.0,19,17,1,16,9,35,20,0,Ligue_1,2022_2023
Anthony Khelifa,FRA,DF,Ajaccio,16,2005,0.1,0,0,0,0,0,0,0,,0,0,0,0,0,0,0,0,Ligue_1,2022_2023
Presnel Kimpembe,FRA,DF,Paris S-G,26,1995,8.1,17,8,9,6,2,9,13,69.2,4,12,7,5,13,30,9,1,Ligue_1,2022_2023
Samuel Koeberlé,FRA,MF,Reims,17,2004,0.0,0,0,0,0,0,0,0,,0,0,0,0,0,0,0,0,Ligue_1,2022_2023
Rudy Kohon,FRA,DF,Troyes,18,2004,0.7,4,3,4,0,0,2,2,100.0,0,1,0,1,1,5,2,0,Ligue_1,2022_2023
Sead Kolašinac,BIH,DF,Marseille,29,1993,24.6,52,36,24,22,6,24,37,64.9,13,19,2,17,43,95,35,1,Ligue_1,2022_2023
Cheick Konaté,MLI,DF,Clermont Foot,18,2004,6.4,19,12,10,7,2,13,22,59.1,9,7,1,6,13,32,8,1,Ligue_1,2022_2023
Ibrahima Koné,MLI,FW,Lorient,23,1999,17.5,24,13,3,13,8,5,11,45.5,6,13,0,13,4,28,18,0,Ligue_1,2022_2023
Youssouf Koné,MLI,DF,Ajaccio,27,1995,10.2,28,19,24,4,0,18,25,72.0,7,9,2,7,12,40,32,1,Ligue_1,2022_2023
Rominigue Kouamé,MLI,MF,Troyes,25,1996,29.6,44,27,28,14,2,17,41,41.5,24,32,11,21,49,93,46,1,Ligue_1,2022_2023
Boubakar Kouyaté,MLI,DF,Montpellier,25,1997,14.0,31,18,18,11,2,19,35,54.3,16,24,14,10,34,65,73,1,Ligue_1,2022_2023
Sael Kumbedi,FRA,DF,Lyon,17,2005,14.7,47,27,27,13,7,20,38,52.6,18,23,7,16,10,57,16,0,Ligue_1,2022_2023
Grejohn Kyei,FRA,FW,Clermont Foot,26,1995,24.8,16,7,2,9,5,4,13,30.8,9,14,3,11,6,22,22,0,Ligue_1,2022_2023
Rémy Labeau Lascary,GLP,"FW,MF",Lens,19,2003,1.4,4,2,4,0,0,0,0,,0,4,0,4,1,5,0,0,Ligue_1,2022_2023
Gaëtan Laborde,FRA,FW,Nice,28,1994,27.8,45,25,13,17,15,18,40,45.0,22,27,2,25,9,54,13,0,Ligue_1,2022_2023
Gaëtan Laborde,FRA,FW,Rennes,28,1994,2.8,1,1,1,0,0,0,1,0.0,1,1,0,1,0,1,1,0,Ligue_1,2022_2023
Alexandre Lacazette,FRA,FW,Lyon,31,1991,32.5,43,23,7,17,19,10,29,34.5,19,23,3,20,15,58,4,0,Ligue_1,2022_2023
Qazim Laçi,ALB,MF,Ajaccio,26,1996,2.4,6,3,2,3,1,4,9,44.4,5,5,0,5,2,8,3,0,Ligue_1,2022_2023
Alban Lafont,FRA,GK,Nantes,23,1999,37.0,0,0,0,0,0,0,1,0.0,1,0,0,0,0,0,20,4,Ligue_1,2022_2023
Kenny Lala,MAD,DF,Brest,30,1991,15.7,36,19,19,15,2,22,38,57.9,16,15,5,10,21,57,28,0,Ligue_1,2022_2023
Mohamed Lamine Bayo,GUI,"FW,MF",Lille,24,1998,7.2,3,3,0,2,1,0,12,0.0,12,3,1,2,0,3,1,0,Ligue_1,2022_2023
Julien Laporte,FRA,DF,Lorient,28,1993,18.4,22,16,18,3,1,16,22,72.7,6,33,27,6,18,40,108,2,Ligue_1,2022_2023
Yasser Larouci,ALG,"DF,MF",Troyes,21,2001,20.0,23,13,13,8,2,15,24,62.5,9,15,1,14,26,49,46,0,Ligue_1,2022_2023
Armand Lauriente,FRA,FW,Lorient,23,1998,3.0,8,7,3,4,1,3,7,42.9,4,5,1,4,4,12,1,0,Ligue_1,2022_2023
Théo Le Bris,FRA,"MF,DF",Lorient,19,2002,16.1,31,19,17,11,3,15,33,45.5,18,21,2,19,18,49,31,0,Ligue_1,2022_2023
Julien Le Cardinal,FRA,DF,Lens,24,1997,1.8,6,4,5,0,1,4,6,66.7,2,3,0,3,2,8,5,0,Ligue_1,2022_2023
Jérémy Le Douaron,FRA,"MF,FW",Brest,24,1998,23.0,15,9,5,9,1,3,27,11.1,24,29,2,27,11,26,30,0,Ligue_1,2022_2023
Enzo Le Fée,FRA,MF,Lorient,22,2000,33.6,108,64,52,40,16,43,113,38.1,70,50,5,45,34,142,38,1,Ligue_1,2022_2023
Vincent Le Goff,FRA,DF,Lorient,32,1989,37.0,75,32,56,16,3,45,62,72.6,17,29,9,20,41,116,105,1,Ligue_1,2022_2023
Maxime Le Marchand,FRA,DF,Strasbourg,32,1989,22.4,39,24,23,14,2,19,31,61.3,12,22,14,8,37,76,74,0,Ligue_1,2022_2023
Paolo Lebas,FRA,MF,Ajaccio,19,2003,0.6,0,0,0,0,0,0,0,,0,0,0,0,0,0,0,0,Ligue_1,2022_2023
Jean-Louis Leca,FRA,GK,Lens,36,1985,1.0,0,0,0,0,0,0,0,,0,0,0,0,0,0,0,1,Ligue_1,2022_2023
Benjamin Lecomte,FRA,GK,Montpellier,31,1991,19.0,0,0,0,0,0,0,2,0.0,2,0,0,0,0,0,6,0,Ligue_1,2022_2023
Pierre Lees-Melou,FRA,MF,Brest,29,1993,30.7,97,55,55,37,5,57,123,46.3,66,48,13,35,52,149,46,1,Ligue_1,2022_2023
Félix Lemaréchal,FRA,MF,Brest,18,2003,3.2,5,5,2,1,2,0,3,0.0,3,6,0,6,1,6,2,0,Ligue_1,2022_2023
Mario Lemina,GAB,"MF,DF",Nice,28,1993,9.3,32,21,11,14,7,12,18,66.7,6,13,5,8,11,43,20,0,Ligue_1,2022_2023
Donovan Léon,GUF,GK,Auxerre,29,1992,2.0,0,0,0,0,0,0,0,,0,0,0,0,0,0,1,0,Ligue_1,2022_2023
Johann Lepenant,FRA,MF,Lyon,19,2002,21.5,58,34,24,27,7,32,86,37.2,54,29,5,24,28,86,17,3,Ligue_1,2022_2023
Benjamin Leroy,FRA,GK,Ajaccio,33,1989,31.1,0,0,0,0,0,0,2,0.0,2,0,0,0,1,1,16,2,Ligue_1,2022_2023
Léo Leroy,FRA,MF,Montpellier,22,2000,13.2,53,38,24,26,3,31,57,54.4,26,25,2,23,14,67,8,0,Ligue_1,2022_2023
Alexandre Letellier,FRA,GK,Paris S-G,31,1990,0.1,0,0,0,0,0,0,0,,0,0,0,0,0,0,0,0,Ligue_1,2022_2023
Ruan Levine,BRA,"MF,FW",Ajaccio,23,1999,0.3,2,2,1,1,0,0,0,,0,1,0,1,2,4,0,0,Ligue_1,2022_2023
Dimitri Liénard,FRA,"DF,MF",Strasbourg,34,1988,17.1,46,29,20,18,8,34,57,59.6,23,28,4,24,16,62,24,0,Ligue_1,2022_2023
Mateusz Lis,POL,GK,Troyes,25,1997,8.3,0,0,0,0,0,0,1,0.0,1,1,0,1,0,0,3,0,Ligue_1,2022_2023
Bradley Locko,FRA,DF,Reims,20,2002,11.8,31,16,21,4,6,15,27,55.6,12,17,4,13,20,51,21,0,Ligue_1,2022_2023
Bradley Locko,FRA,DF,Brest,20,2002,3.0,4,3,2,1,1,2,3,66.7,1,4,0,4,2,6,13,0,Ligue_1,2022_2023
Anthony Lopes,POR,GK,Lyon,31,1990,31.3,1,0,1,0,0,1,4,25.0,3,0,0,0,3,4,10,0,Ligue_1,2022_2023
Rony Lopes,POR,"MF,FW",Troyes,26,1995,26.1,24,12,6,15,3,7,31,22.6,24,14,2,12,9,33,10,0,Ligue_1,2022_2023
Pau López,ESP,GK,Marseille,27,1994,32.5,0,0,0,0,0,0,1,0.0,1,0,0,0,0,0,5,1,Ligue_1,2022_2023
Dion Lopy,SEN,MF,Reims,20,2002,15.3,45,24,22,16,7,23,62,37.1,39,27,3,24,22,67,18,0,Ligue_1,2022_2023
Jordan Lotomba,SUI,DF,Nice,23,1998,27.3,65,38,33,24,8,31,48,64.6,17,38,11,27,32,97,53,0,Ligue_1,2022_2023
Dejan Lovren,CRO,DF,Lyon,33,1989,16.2,25,19,20,5,0,20,29,69.0,9,20,10,10,26,51,70,1,Ligue_1,2022_2023
Jean Lucas,BRA,MF,Monaco,24,1998,3.2,9,5,3,5,1,6,12,50.0,6,2,1,1,4,13,2,0,Ligue_1,2022_2023
Castello Lukeba,FRA,DF,Lyon,19,2002,33.2,39,23,27,8,4,21,31,67.7,10,42,24,18,75,114,105,1,Ligue_1,2022_2023
Youssouf M'Changama,COM,MF,Auxerre,31,1990,12.0,22,11,7,12,3,7,13,53.8,6,6,0,6,15,37,6,1,Ligue_1,2022_2023
Deiver Machado,COL,"DF,MF",Lens,28,1993,24.3,45,26,18,20,7,21,34,61.8,13,21,4,17,21,66,27,0,Ligue_1,2022_2023
Soungoutou Magassa,FRA,MF,Monaco,18,2003,0.9,4,1,2,2,0,2,4,50.0,2,3,0,3,1,5,1,0,Ligue_1,2022_2023
Hugo Magnetti,FRA,MF,Brest,24,1998,18.8,43,27,18,23,2,23,63,36.5,40,21,1,20,25,68,12,0,Ligue_1,2022_2023
Yohann Magnin,FRA,MF,Clermont Foot,25,1997,26.7,89,54,37,45,7,54,106,50.9,52,50,12,38,25,114,46,0,Ligue_1,2022_2023
Lovro Majer,CRO,"MF,FW",Rennes,24,1998,18.5,34,23,16,13,5,8,29,27.6,21,21,1,20,21,55,5,1,Ligue_1,2022_2023
Jean-Victor Makengo,FRA,MF,Lorient,24,1998,11.8,16,8,5,10,1,6,20,30.0,14,8,5,3,10,26,13,1,Ligue_1,2022_2023
Béni Makouana,CGO,"FW,MF",Montpellier,19,2002,2.2,1,0,0,1,0,0,2,0.0,2,3,1,2,0,1,1,0,Ligue_1,2022_2023
Ruslan Malinovskyi,UKR,"MF,FW",Marseille,29,1993,13.6,21,11,3,12,6,10,26,38.5,16,13,1,12,3,24,9,0,Ligue_1,2022_2023
Hianga Mananga Mbock,FRA,MF,Brest,22,1999,0.2,0,0,0,0,0,0,1,0.0,1,0,0,0,0,0,0,0,Ligue_1,2022_2023
Steve Mandanda,FRA,GK,Rennes,37,1985,33.5,0,0,0,0,0,0,2,0.0,2,0,0,0,0,0,9,3,Ligue_1,2022_2023
Thomas Mangani,FRA,MF,Ajaccio,35,1987,14.8,32,17,14,15,3,18,47,38.3,29,22,3,19,24,56,22,1,Ligue_1,2022_2023
Vito Mannone,ITA,GK,Lorient,34,1988,17.9,0,0,0,0,0,0,0,,0,0,0,0,0,0,4,3,Ligue_1,2022_2023
Myziane Maolida,COM,"MF,FW",Reims,23,1999,2.6,8,3,2,5,1,5,12,41.7,7,1,0,1,2,10,0,0,Ligue_1,2022_2023
Faitout Maouassa,FRA,"FW,DF",Montpellier,24,1998,21.4,52,32,26,20,6,18,41,43.9,23,31,3,28,20,72,23,0,Ligue_1,2022_2023
Vincent Marchetti,FRA,MF,Ajaccio,25,1997,27.2,55,26,29,19,7,25,68,36.8,43,23,3,20,19,74,31,0,Ligue_1,2022_2023
Guillermo Maripán,CHI,DF,Monaco,28,1994,24.0,46,26,26,20,0,17,33,51.5,16,39,27,12,38,84,87,0,Ligue_1,2022_2023
Marquinhos,BRA,DF,Paris S-G,28,1994,30.2,33,25,18,12,3,18,26,69.2,8,43,27,16,23,56,83,2,Ligue_1,2022_2023
Jonas Martin,FRA,MF,Lille,32,1990,3.1,9,7,4,5,0,5,14,35.7,9,3,1,2,7,16,3,0,Ligue_1,2022_2023
Gelson Martins,POR,"MF,FW",Monaco,27,1995,3.8,15,8,6,4,5,4,13,30.8,9,4,1,3,3,18,2,0,Ligue_1,2022_2023
Han-Noah Massengo,FRA,MF,Auxerre,21,2001,12.4,27,15,10,15,2,7,16,43.8,9,12,3,9,14,41,7,0,Ligue_1,2022_2023
Yanis Massolin,FRA,MF,Clermont Foot,19,2002,0.7,2,1,1,0,1,0,1,0.0,1,1,0,1,2,4,0,0,Ligue_1,2022_2023
Eliot Matazo,BEL,MF,Monaco,20,2002,13.1,26,12,11,13,2,11,26,42.3,15,18,4,14,15,41,11,1,Ligue_1,2022_2023
Chrislain Matsima,FRA,"DF,MF",Lorient,20,2002,2.5,0,0,0,0,0,0,0,,0,3,3,0,2,2,7,0,Ligue_1,2022_2023
Chrislain Matsima,FRA,DF,Monaco,20,2002,5.0,11,6,7,2,2,4,7,57.1,3,5,5,0,9,20,16,0,Ligue_1,2022_2023
Jean Mattéo Bahoya,FRA,"FW,MF",Angers,17,2005,3.0,7,3,1,3,3,4,7,57.1,3,4,0,4,0,7,0,0,Ligue_1,2022_2023
Azor Matusiwa,NED,MF,Reims,24,1998,27.6,66,41,30,29,7,36,61,59.0,25,37,11,26,46,112,52,0,Ligue_1,2022_2023
Aïman Maurer,MAR,MF,Clermont Foot,17,2004,5.6,2,1,1,1,0,1,10,10.0,9,1,0,1,3,5,5,0,Ligue_1,2022_2023
Stephy Mavididi,ENG,FW,Montpellier,24,1998,14.3,24,19,12,8,4,13,27,48.1,14,21,1,20,4,28,10,0,Ligue_1,2022_2023
Christian Mawissa,FRA,DF,Toulouse,17,2005,1.1,2,0,1,1,0,1,3,33.3,2,0,0,0,3,5,1,0,Ligue_1,2022_2023
Fernand Mayembo,CGO,DF,Ajaccio,26,1996,7.9,8,5,6,2,0,4,9,44.4,5,2,0,2,11,19,36,0,Ligue_1,2022_2023
Derek Mazou-Sacko,FRA,MF,Troyes,17,2004,0.2,0,0,0,0,0,0,1,0.0,1,1,0,1,1,1,1,0,Ligue_1,2022_2023
Kylian Mbappé,FRA,FW,Paris S-G,23,1998,31.3,10,4,0,5,5,5,16,31.3,11,5,0,5,5,15,6,0,Ligue_1,2022_2023
Chancel Mbemba,COD,DF,Marseille,27,1994,31.7,43,26,24,17,2,22,31,71.0,9,25,12,13,42,85,89,0,Ligue_1,2022_2023
Jason Mbock,FRA,"MF,FW",Angers,22,1999,0.3,0,0,0,0,0,0,0,,0,0,0,0,0,0,0,0,Ligue_1,2022_2023
Nathanael Mbuku,FRA,"FW,MF",Reims,20,2002,0.7,2,1,2,0,0,2,2,100.0,0,0,0,0,0,2,0,0,Ligue_1,2022_2023
Facundo Medina,ARG,DF,Lens,23,1999,30.9,31,20,16,15,0,13,35,37.1,22,25,9,16,26,57,62,1,Ligue_1,2022_2023
Bamo Meïté,CIV,DF,Lorient,20,2001,16.7,18,8,13,4,1,7,16,43.8,9,33,23,10,16,34,70,0,Ligue_1,2022_2023
Farid El Melali,ALG,"DF,FW",Angers,25,1997,9.0,21,12,7,12,2,11,22,50.0,11,16,0,16,8,29,7,0,Ligue_1,2022_2023
Birger Meling,NOR,DF,Rennes,27,1994,13.4,24,15,9,12,3,12,25,48.0,13,18,2,16,23,47,26,0,Ligue_1,2022_2023
Nuno Mendes,POR,DF,Paris S-G,20,2002,17.2,45,30,29,12,4,30,41,73.2,11,19,3,16,17,62,18,0,Ligue_1,2022_2023
Pedro Mendes,POR,DF,Montpellier,31,1990,0.1,0,0,0,0,0,0,0,,0,0,0,0,0,0,0,1,Ligue_1,2022_2023
Thiago Mendes,BRA,"MF,DF",Lyon,30,1992,22.9,48,27,24,21,3,30,40,75.0,10,28,8,20,47,95,51,4,Ligue_1,2022_2023
Antoine Mendy,FRA,DF,Nice,18,2004,5.8,22,13,16,5,1,9,15,60.0,6,6,1,5,2,24,16,0,Ligue_1,2022_2023
Arial Mendy,SEN,DF,Clermont Foot,27,1994,2.5,4,2,3,0,1,2,2,100.0,0,2,0,2,4,8,4,0,Ligue_1,2022_2023
Batista Mendy,FRA,"MF,DF",Angers,22,2000,31.8,70,30,34,28,8,37,53,69.8,16,38,6,32,21,91,29,2,Ligue_1,2022_2023
Gideon Mensah,GHA,DF,Auxerre,24,1998,25.1,80,44,43,32,5,44,77,57.1,33,33,10,23,38,118,41,0,Ligue_1,2022_2023
Quentin Merlin,FRA,DF,Nantes,20,2002,19.9,31,19,19,8,4,18,38,47.4,20,27,4,23,24,55,30,0,Ligue_1,2022_2023
Lionel Messi,ARG,"FW,MF",Paris S-G,35,1987,31.5,26,18,1,13,12,11,27,40.7,16,11,0,11,2,28,0,0,Ligue_1,2022_2023
Amine Messoussa,FRA,FW,Lille,17,2004,0.0,0,0,0,0,0,0,0,,0,0,0,0,0,0,0,0,Ligue_1,2022_2023
Arkadiusz Milik,POL,FW,Marseille,28,1994,1.4,1,1,0,0,1,0,1,0.0,1,0,0,0,0,1,2,0,Ligue_1,2022_2023
Takumi Minamino,JPN,"MF,FW",Monaco,27,1995,8.0,15,8,5,7,3,7,35,20.0,28,14,0,14,6,21,4,0,Ligue_1,2022_2023
Terem Moffi,NGA,FW,Nice,23,1999,14.8,12,6,0,6,6,2,12,16.7,10,3,0,3,2,14,5,0,Ligue_1,2022_2023
Terem Moffi,NGA,FW,Lorient,23,1999,15.4,8,5,1,4,3,3,5,60.0,2,11,3,8,3,11,10,0,Ligue_1,2022_2023
Mostafa Mohamed,EGY,FW,Nantes,24,1997,21.5,18,13,5,7,6,9,20,45.0,11,23,1,22,10,28,33,0,Ligue_1,2022_2023
Florent Mollet,FRA,MF,Nantes,30,1991,12.1,14,6,5,4,5,7,24,29.2,17,12,1,11,10,24,11,0,Ligue_1,2022_2023
Marlos Moreno,COL,"MF,DF",Troyes,25,1996,0.1,2,2,2,0,0,2,3,66.7,1,1,1,0,0,2,0,0,Ligue_1,2022_2023
Lebo Mothiba,RSA,"FW,MF",Strasbourg,26,1996,4.8,1,0,1,0,0,0,1,0.0,1,6,1,5,0,1,4,0,Ligue_1,2022_2023
Steve Mounié,BEN,FW,Brest,27,1994,18.4,13,5,1,7,5,5,14,35.7,9,18,7,11,3,16,20,0,Ligue_1,2022_2023
Bevic Moussiti-Oko,CGO,FW,Ajaccio,27,1995,7.8,3,1,1,1,1,1,2,50.0,1,5,3,2,2,5,8,0,Ligue_1,2022_2023
Samuel Moutoussamy,COD,MF,Nantes,25,1996,26.7,64,34,27,28,9,26,76,34.2,50,23,2,21,24,88,15,0,Ligue_1,2022_2023
François Mughe,CMR,MF,Marseille,18,2004,0.1,0,0,0,0,0,0,0,,0,0,0,0,0,0,0,0,Ligue_1,2022_2023
Nordi Mukiele,FRA,DF,Paris S-G,24,1997,12.6,31,23,16,6,9,19,29,65.5,10,22,9,13,14,45,16,0,Ligue_1,2022_2023
Marshall Munetsi,ZIM,MF,Reims,26,1996,30.0,58,27,13,31,14,20,48,41.7,28,37,11,26,26,84,41,1,Ligue_1,2022_2023
Yvon Mvogo,SUI,GK,Lorient,28,1994,20.1,0,0,0,0,0,0,0,,0,0,0,0,2,2,6,3,Ligue_1,2022_2023
Nathan N'Goumou,FRA,FW,Toulouse,22,2000,1.0,3,2,2,1,0,1,1,100.0,0,2,0,2,2,5,0,0,Ligue_1,2022_2023
Youssouf Ndayishimiye,BDI,"MF,DF",Nice,23,1998,6.3,13,9,8,5,0,6,11,54.5,5,8,5,3,12,25,22,1,Ligue_1,2022_2023
Papa Ndiaga Yade,MTN,"DF,MF",Troyes,22,2000,6.3,10,6,6,2,2,7,22,31.8,15,10,2,8,8,18,10,0,Ligue_1,2022_2023
Neymar,BRA,"MF,FW",Paris S-G,30,1992,17.2,22,14,6,9,7,9,19,47.4,10,7,1,6,4,26,1,1,Ligue_1,2022_2023
Ibrahima Niane,SEN,FW,Angers,23,1999,12.6,6,2,1,4,1,1,6,16.7,5,8,2,6,1,7,9,0,Ligue_1,2022_2023
M'Baye Niang,SEN,FW,Auxerre,27,1994,16.5,13,7,1,8,4,3,13,23.1,10,22,1,21,1,14,20,0,Ligue_1,2022_2023
Rasmus Nicolaisen,DEN,DF,Toulouse,25,1997,33.3,48,21,34,14,0,29,46,63.0,17,58,45,13,50,98,152,0,Ligue_1,2022_2023
Arnaud Nordin,FRA,FW,Montpellier,24,1998,26.7,26,14,10,12,4,12,28,42.9,16,19,1,18,14,40,7,0,Ligue_1,2022_2023
Riad Nouri,FRA,"MF,FW",Ajaccio,37,1985,18.8,21,12,7,10,4,12,29,41.4,17,8,1,7,15,36,11,0,Ligue_1,2022_2023
Alexander Nübel,GER,GK,Monaco,25,1996,38.0,0,0,0,0,0,0,1,0.0,1,0,0,0,1,1,10,3,Ligue_1,2022_2023
Gerzino Nyamsi,FRA,DF,Strasbourg,25,1997,17.5,28,20,14,12,2,10,12,83.3,2,19,11,8,10,38,63,1,Ligue_1,2022_2023
Wilson Odobert,FRA,"MF,FW",Troyes,17,2004,19.6,20,14,10,7,3,9,25,36.0,16,11,0,11,15,35,5,0,Ligue_1,2022_2023
Florent Ogier,FRA,DF,Clermont Foot,33,1989,18.9,33,16,20,12,1,22,39,56.4,17,22,13,9,18,51,64,1,Ligue_1,2022_2023
Warmed Omari,COM,DF,Rennes,22,2000,15.1,20,11,14,6,0,14,28,50.0,14,13,7,6,17,37,43,1,Ligue_1,2022_2023
Jonas Omlin,SUI,GK,Montpellier,28,1994,13.0,1,0,1,0,0,0,0,,0,0,0,0,0,1,8,1,Ligue_1,2022_2023
Ado Onaiwu,JPN,FW,Toulouse,26,1995,12.0,11,6,4,4,3,5,13,38.5,8,5,1,4,2,13,5,0,Ligue_1,2022_2023
Jean Onana,CMR,"MF,DF",Lens,22,2000,9.0,28,17,8,17,3,10,22,45.5,12,15,5,10,18,46,20,0,Ligue_1,2022_2023
Loïs Openda,BEL,FW,Lens,22,2000,28.0,11,9,2,6,3,2,13,15.4,11,9,0,9,2,13,6,0,Ligue_1,2022_2023
Dango Ouattara,BFA,"FW,MF",Lorient,20,2002,17.2,41,26,20,11,10,15,28,53.6,13,24,6,18,19,60,21,0,Ligue_1,2022_2023
Zinédine Ould Khaled,FRA,"MF,FW",Angers,22,2000,0.6,1,1,0,1,0,0,1,0.0,1,0,0,0,2,3,0,0,Ligue_1,2022_2023
Azzedine Ounahi,MAR,"MF,FW",Marseille,22,2000,1.3,2,1,1,1,0,0,2,0.0,2,1,0,1,0,2,0,0,Ligue_1,2022_2023
Azzedine Ounahi,MAR,"MF,FW",Angers,22,2000,12.5,19,8,5,13,1,10,20,50.0,10,8,0,8,15,34,4,1,Ligue_1,2022_2023
Adam Ounas,ALG,"FW,MF",Lille,25,1996,11.8,20,11,4,10,6,8,13,61.5,5,16,0,16,7,27,5,0,Ligue_1,2022_2023
Ante Palaversa,CRO,MF,Troyes,22,2000,0.3,1,1,1,0,0,0,0,,0,0,0,0,1,2,0,0,Ligue_1,2022_2023
Nicolas Pallois,FRA,DF,Nantes,34,1987,24.6,69,44,51,16,2,42,70,60.0,28,35,18,17,30,99,131,2,Ligue_1,2022_2023
Erik Palmer-Brown,USA,DF,Troyes,25,1997,35.5,42,27,31,10,1,18,33,54.5,15,56,29,27,26,68,166,1,Ligue_1,2022_2023
Lucas Paquetá,BRA,MF,Lyon,24,1997,1.8,5,4,0,5,0,1,3,33.3,2,2,0,2,1,6,3,0,Ligue_1,2022_2023
Leandro Paredes,ARG,MF,Paris S-G,28,1994,0.6,1,1,1,0,0,1,1,100.0,0,2,1,1,1,2,0,0,Ligue_1,2022_2023
Dimitri Payet,FRA,"MF,FW",Marseille,35,1987,9.3,6,4,2,2,2,3,11,27.3,8,4,0,4,0,6,4,0,Ligue_1,2022_2023
Théo Pellenard,FRA,DF,Auxerre,28,1994,1.1,1,0,1,0,0,1,1,100.0,0,3,1,2,2,3,2,0,Ligue_1,2022_2023
Timothee Pembele,FRA,DF,Paris S-G,19,2002,2.9,5,5,3,1,1,2,4,50.0,2,2,0,2,4,9,2,0,Ligue_1,2022_2023
Patrick Pentz,AUT,GK,Reims,25,1997,7.0,0,0,0,0,0,0,0,,0,0,0,0,0,0,1,0,Ligue_1,2022_2023
Nicolas Pépé,CIV,"FW,MF",Nice,27,1995,16.6,25,13,14,5,6,11,25,44.0,14,17,0,17,3,28,1,0,Ligue_1,2022_2023
Brayann Pereira,FRA,DF,Auxerre,19,2003,2.0,6,5,5,1,0,1,5,20.0,4,2,2,0,2,8,8,1,Ligue_1,2022_2023
Danilo Pereira,POR,"DF,MF",Paris S-G,30,1991,26.8,32,17,15,14,3,19,26,73.1,7,26,19,7,36,68,59,1,Ligue_1,2022_2023
Mathias Pereira Lage,POR,"MF,FW",Brest,25,1996,14.0,20,7,5,14,1,11,29,37.9,18,10,1,9,14,34,12,0,Ligue_1,2022_2023
Gaëtan Perrin,FRA,"MF,FW",Auxerre,26,1996,15.5,17,8,5,6,6,8,30,26.7,22,15,0,15,10,27,9,0,Ligue_1,2022_2023
Lucas Perrin,FRA,DF,Strasbourg,23,1998,19.6,44,27,28,14,2,25,49,51.0,24,13,5,8,36,80,53,0,Ligue_1,2022_2023
Ronaël Pierre-Gabriel,FRA,DF,Strasbourg,24,1998,7.3,25,18,11,12,2,15,17,88.2,2,16,3,13,9,34,22,0,Ligue_1,2022_2023
Julien Ponceau,FRA,MF,Lorient,21,2000,18.4,28,19,10,14,4,10,32,31.3,22,27,3,24,14,42,12,0,Ligue_1,2022_2023
Łukasz Poręba,POL,MF,Lens,22,2000,2.9,5,4,2,1,2,2,3,66.7,1,3,0,3,4,9,2,0,Ligue_1,2022_2023
Jackson Porozo,ECU,DF,Troyes,21,2000,18.0,32,20,24,7,1,13,31,41.9,18,24,17,7,33,65,75,0,Ligue_1,2022_2023
Sanjin Prcić,BIH,MF,Strasbourg,28,1993,18.1,27,12,6,16,5,19,31,61.3,12,22,7,15,25,52,22,0,Ligue_1,2022_2023
Mehdi Puch-Herrantz,FRA,MF,Ajaccio,18,2004,0.5,2,2,0,1,1,1,2,50.0,1,1,0,1,3,5,0,0,Ligue_1,2022_2023
Ghjuvanni Quilichini,FRA,GK,Ajaccio,19,2002,0.9,0,0,0,0,0,0,0,,0,0,0,0,0,0,1,0,Ligue_1,2022_2023
Ionuț Radu,ROU,GK,Auxerre,25,1997,17.0,0,0,0,0,0,0,0,,0,0,0,0,0,0,3,3,Ligue_1,2022_2023
Simon Ramet,FRA,DF,Lille,19,2003,0.0,0,0,0,0,0,0,0,,0,0,0,0,0,0,0,0,Ligue_1,2022_2023
Adil Rami,FRA,DF,Troyes,36,1985,17.7,19,14,13,5,1,17,32,53.1,15,23,16,7,25,44,75,3,Ligue_1,2022_2023
Sergio Ramos,ESP,DF,Paris S-G,36,1986,30.0,34,26,14,18,2,23,44,52.3,21,29,13,16,34,68,93,3,Ligue_1,2022_2023
Aaron Ramsey,WAL,MF,Nice,31,1990,17.6,47,25,18,19,10,16,39,41.0,23,25,4,21,17,64,18,1,Ligue_1,2022_2023
Lilian Raolisoa,FRA,"DF,MF",Angers,22,2000,1.9,11,9,6,3,2,7,10,70.0,3,3,1,2,3,14,5,0,Ligue_1,2022_2023
Elba Rashani,KVX,"MF,FW",Clermont Foot,29,1993,24.0,39,26,13,19,7,13,39,33.3,26,27,2,25,21,60,19,0,Ligue_1,2022_2023
Rafael Ratão,BRA,"FW,MF",Toulouse,26,1995,20.6,52,36,29,16,7,27,73,37.0,46,34,0,34,21,73,7,0,Ligue_1,2022_2023
Rayan Raveloson,MAD,"DF,MF",Auxerre,25,1997,27.0,38,23,21,16,1,23,33,69.7,10,43,12,31,39,77,70,0,Ligue_1,2022_2023
Jeff Reine-Adélaïde,FRA,MF,Troyes,24,1998,2.6,3,2,2,1,0,1,2,50.0,1,2,0,2,2,5,1,0,Ligue_1,2022_2023
Jeff Reine-Adélaïde,FRA,MF,Lyon,24,1998,3.7,8,5,1,5,2,5,9,55.6,4,4,0,4,6,14,0,0,Ligue_1,2022_2023
Alexsandro Ribeiro,BRA,DF,Lille,22,1999,17.9,32,18,24,7,1,19,28,67.9,9,11,2,9,25,57,59,1,Ligue_1,2022_2023
Rémy Riou,FRA,GK,Lyon,34,1987,6.7,1,0,1,0,0,1,1,100.0,0,0,0,0,0,1,3,0,Ligue_1,2022_2023
Renaud Ripart,FRA,"FW,MF",Troyes,29,1993,14.7,40,23,14,20,6,19,52,36.5,33,29,2,27,7,47,5,0,Ligue_1,2022_2023
Joe Rodon,WAL,DF,Rennes,24,1997,15.7,11,7,9,2,0,4,10,40.0,6,16,12,4,9,20,54,1,Ligue_1,2022_2023
Valentin Rongier,FRA,MF,Marseille,27,1994,33.7,93,59,33,47,13,41,77,53.2,36,50,11,39,54,147,38,1,Ligue_1,2022_2023
Pablo Rosario,NED,"MF,DF",Nice,25,1997,19.6,46,26,22,20,4,18,34,52.9,16,15,5,10,23,69,32,1,Ligue_1,2022_2023
Anthony Rouault,FRA,DF,Toulouse,21,2001,36.8,66,37,54,10,2,30,58,51.7,28,52,26,26,56,122,126,4,Ligue_1,2022_2023
Kays Ruiz,FRA,MF,Auxerre,19,2002,0.7,1,1,1,0,0,0,1,0.0,1,2,1,1,3,4,0,0,Ligue_1,2022_2023
Fabián Ruiz Peña,ESP,MF,Paris S-G,26,1996,21.0,62,28,25,30,7,43,79,54.4,36,24,1,23,18,80,23,1,Ligue_1,2022_2023
Halid Šabanović,BIH,DF,Angers,22,1999,7.1,8,6,7,1,0,6,8,75.0,2,8,2,6,8,16,12,0,Ligue_1,2022_2023
Falaye Sacko,MLI,DF,Montpellier,27,1995,28.7,46,25,25,15,6,32,51,62.7,19,43,14,29,33,79,75,1,Ligue_1,2022_2023
Wesley Saïd,FRA,"FW,MF",Lens,27,1995,7.2,4,1,1,2,1,2,6,33.3,4,4,0,4,1,5,2,0,Ligue_1,2022_2023
Théo Sainte-Luce,FRA,DF,Montpellier,23,1998,5.9,13,11,8,5,0,7,14,50.0,7,7,2,5,10,23,11,0,Ligue_1,2022_2023
Hamza Sakhi,FRA,MF,Auxerre,26,1996,18.4,44,22,22,17,5,22,42,52.4,20,16,1,15,25,69,9,0,Ligue_1,2022_2023
Mamadou Sakho,FRA,DF,Montpellier,32,1990,8.5,9,5,4,5,0,3,5,60.0,2,17,12,5,8,17,35,1,Ligue_1,2022_2023
Ibrahim Salah,MAR,"FW,MF",Rennes,20,2001,2.5,8,1,5,3,0,2,15,13.3,13,3,0,3,2,10,0,0,Ligue_1,2022_2023
Amine Salama,FRA,"FW,MF",Angers,22,2000,13.9,11,9,3,7,1,2,12,16.7,10,8,2,6,10,21,2,0,Ligue_1,2022_2023
Yoann Salmier,GUF,DF,Troyes,29,1992,29.4,51,29,34,12,5,21,35,60.0,14,34,19,15,39,90,124,0,Ligue_1,2022_2023
Mama Samba Baldé,GNB,FW,Troyes,26,1995,29.6,46,21,14,21,11,13,28,46.4,15,30,3,27,10,56,13,0,Ligue_1,2022_2023
Brice Samba,FRA,GK,Lens,28,1994,37.0,1,0,1,0,0,1,2,50.0,1,1,0,1,0,1,12,2,Ligue_1,2022_2023
Renato Sanches,POR,MF,Paris S-G,24,1997,8.0,8,1,1,3,4,5,14,35.7,9,13,3,10,9,17,4,0,Ligue_1,2022_2023
Alexis Sánchez,CHI,"FW,MF",Marseille,33,1988,29.8,27,17,5,16,6,3,24,12.5,21,14,0,14,5,32,6,0,Ligue_1,2022_2023
Morgan Sanson,FRA,MF,Strasbourg,27,1994,15.8,36,25,10,16,10,17,56,30.4,39,21,1,20,22,58,9,0,Ligue_1,2022_2023
Baptiste Santamaria,FRA,MF,Rennes,27,1995,20.1,41,22,13,23,5,21,41,51.2,20,21,5,16,21,62,23,0,Ligue_1,2022_2023
Pablo Sarabia,ESP,"FW,MF",Paris S-G,30,1992,4.1,5,4,2,2,1,1,7,14.3,6,3,0,3,2,7,0,0,Ligue_1,2022_2023
Amin Sarr,SWE,FW,Lyon,21,2001,6.0,9,6,1,4,4,1,4,25.0,3,2,0,2,0,9,4,0,Ligue_1,2022_2023
Malang Sarr,FRA,DF,Monaco,23,1999,8.0,6,3,5,1,0,1,5,20.0,4,11,7,4,15,21,29,2,Ligue_1,2022_2023
Mamadou Sarr,FRA,MF,Lyon,16,2005,0.1,0,0,0,0,0,0,0,,0,0,0,0,0,0,0,0,Ligue_1,2022_2023
Téji Savanier,FRA,MF,Montpellier,30,1991,28.3,46,30,16,19,11,23,70,32.9,47,30,2,28,30,76,12,1,Ligue_1,2022_2023
Kasper Schmeichel,DEN,GK,Nice,35,1986,36.0,1,0,1,0,0,1,4,25.0,3,1,0,1,1,2,11,1,Ligue_1,2022_2023
Alidu Seidu,GHA,DF,Clermont Foot,22,2000,27.3,52,31,35,14,3,31,51,60.8,20,28,14,14,52,104,50,2,Ligue_1,2022_2023
Matz Sels,BEL,GK,Strasbourg,30,1992,38.0,4,3,4,0,0,4,4,100.0,0,0,0,0,4,8,23,0,Ligue_1,2022_2023
Marvin Senaya,TOG,DF,Strasbourg,21,2001,0.1,0,0,0,0,0,0,1,0.0,1,1,0,1,0,0,1,0,Ligue_1,2022_2023
Kaj Sierhuis,NED,"FW,MF",Reims,24,1998,2.4,3,3,1,0,2,0,5,0.0,5,3,1,2,1,4,2,0,Ligue_1,2022_2023
Vincent Sierro,SUI,MF,Toulouse,26,1995,7.4,19,11,9,9,1,11,29,37.9,18,12,3,9,4,23,11,1,Ligue_1,2022_2023
Caio Henrique Oliveira Silva,BRA,DF,Monaco,25,1997,32.2,74,51,42,28,4,44,76,57.9,32,28,8,20,26,100,68,1,Ligue_1,2022_2023
Abdallah Sima,SEN,FW,Angers,21,2001,20.4,22,13,4,15,3,7,19,36.8,12,8,0,8,4,26,19,0,Ligue_1,2022_2023
Moses Simon,NGA,"FW,MF",Nantes,27,1995,26.1,18,9,6,7,5,7,15,46.7,8,14,1,13,11,29,3,0,Ligue_1,2022_2023
Lassine Sinayoko,MLI,"MF,FW",Auxerre,22,1999,17.4,33,15,14,12,7,21,40,52.5,19,12,0,12,18,51,17,0,Ligue_1,2022_2023
Ibrahima Sissoko,MLI,MF,Strasbourg,24,1997,14.6,40,22,18,17,5,22,42,52.4,20,20,6,14,10,50,19,0,Ligue_1,2022_2023
Moussa Sissoko,FRA,MF,Nantes,32,1989,21.3,26,16,16,7,3,12,18,66.7,6,22,5,17,16,42,17,0,Ligue_1,2022_2023
Naatan Skyttä,FIN,MF,Toulouse,20,2002,0.3,0,0,0,0,0,0,0,,0,0,0,0,1,1,0,0,Ligue_1,2022_2023
Islam Slimani,ALG,FW,Brest,34,1988,11.0,5,3,2,2,1,0,3,0.0,3,2,0,2,1,6,11,0,Ligue_1,2022_2023
Eduard Sobol,UKR,DF,Strasbourg,27,1995,9.7,19,10,10,6,3,9,13,69.2,4,10,1,9,8,27,19,0,Ligue_1,2022_2023
Carlos Soler,ESP,MF,Paris S-G,25,1997,13.2,20,12,6,10,4,10,19,52.6,9,12,4,8,4,24,6,0,Ligue_1,2022_2023
François-Joseph Sollacaro,FRA,GK,Ajaccio,28,1994,6.0,0,0,0,0,0,0,0,,0,0,0,0,0,0,2,2,Ligue_1,2022_2023
Florian Sotoca,FRA,"MF,FW",Lens,31,1990,33.9,39,19,11,17,11,15,40,37.5,25,41,2,39,29,68,51,0,Ligue_1,2022_2023
Moussa Soumano,FRA,FW,Ajaccio,17,2005,5.5,2,2,0,1,1,0,6,0.0,6,2,0,2,0,2,0,0,Ligue_1,2022_2023
Arnaud Souquet,FRA,"DF,FW",Montpellier,30,1992,4.0,22,16,13,7,2,11,14,78.6,3,8,3,5,4,26,4,0,Ligue_1,2022_2023
Kevin Spadanuda,SUI,"MF,FW",Ajaccio,25,1997,11.8,29,18,15,9,5,12,33,36.4,21,18,0,18,11,40,5,0,Ligue_1,2022_2023
Djed Spence,ENG,DF,Rennes,21,2000,6.4,14,6,8,2,4,11,18,61.1,7,10,3,7,4,18,15,0,Ligue_1,2022_2023
Stijn Spierings,NED,MF,Toulouse,26,1996,34.7,95,67,37,49,9,43,101,42.6,58,49,11,38,53,148,44,0,Ligue_1,2022_2023
Calvin Stengs,NED,FW,Nice,23,1998,2.4,2,2,1,0,1,1,2,50.0,1,0,0,0,0,2,0,0,Ligue_1,2022_2023
Tony Strata,ROU,"MF,DF",Ajaccio,17,2004,1.5,4,3,4,0,0,4,5,80.0,1,2,0,2,1,5,7,0,Ligue_1,2022_2023
Gabriel Suazo,CHI,DF,Toulouse,24,1997,14.0,38,22,20,15,3,29,63,46.0,34,21,5,16,22,60,24,1,Ligue_1,2022_2023
Kamaldeen Sulemana,GHA,"FW,MF",Rennes,20,2002,3.6,6,3,1,4,1,1,5,20.0,4,2,0,2,4,10,2,0,Ligue_1,2022_2023
Yuito Suzuki,JPN,"FW,MF",Strasbourg,20,2001,0.4,0,0,0,0,0,0,0,,0,3,0,3,0,0,0,0,Ligue_1,2022_2023
Issiaga Sylla,GUI,DF,Montpellier,28,1994,14.5,28,16,19,8,1,15,31,48.4,16,19,3,16,32,60,35,0,Ligue_1,2022_2023
Issiaga Sylla,GUI,DF,Toulouse,28,1994,15.2,28,15,14,9,5,15,34,44.1,19,15,5,10,38,66,38,0,Ligue_1,2022_2023
Nicolás Tagliafico,ARG,DF,Lyon,29,1992,33.2,91,53,36,41,14,50,78,64.1,28,45,11,34,57,148,47,0,Ligue_1,2022_2023
Waniss Taibi,FRA,MF,Angers,20,2002,2.1,9,5,4,4,1,2,4,50.0,2,1,0,1,2,11,2,0,Ligue_1,2022_2023
Flavien Tait,FRA,MF,Rennes,29,1993,18.7,30,15,8,17,5,19,42,45.2,23,16,4,12,20,50,12,0,Ligue_1,2022_2023
Montassar Talbi,TUN,DF,Lorient,24,1998,38.0,53,25,40,13,0,22,35,62.9,13,55,34,21,40,93,190,3,Ligue_1,2022_2023
Thibault Tamas,FRA,DF,Montpellier,21,2001,0.1,0,0,0,0,0,0,0,,0,0,0,0,1,1,0,0,Ligue_1,2022_2023
Florian Tardieu,FRA,MF,Troyes,30,1992,11.2,31,20,19,12,0,12,31,38.7,19,19,4,15,23,54,15,0,Ligue_1,2022_2023
Nuno Tavares,POR,"DF,MF",Marseille,22,2000,26.1,56,30,19,24,13,28,56,50.0,28,32,4,28,15,71,25,0,Ligue_1,2022_2023
Enzo Tchato,CMR,DF,Montpellier,19,2002,12.2,26,17,14,11,1,13,22,59.1,9,17,2,15,7,33,33,0,Ligue_1,2022_2023
Martin Terrier,FRA,"FW,MF",Rennes,25,1997,14.7,25,11,7,9,9,13,24,54.2,11,15,2,13,14,39,6,0,Ligue_1,2022_2023
Tetê,BRA,"FW,MF",Lyon,22,2000,12.3,21,10,8,5,8,10,19,52.6,9,9,0,9,13,34,2,0,Ligue_1,2022_2023
Arthur Theate,BEL,DF,Rennes,22,2000,34.7,29,19,17,8,4,17,30,56.7,13,26,14,12,30,59,114,3,Ligue_1,2022_2023
Sada Thioub,SEN,"DF,FW",Angers,27,1995,11.8,19,10,9,8,2,8,17,47.1,9,13,0,13,7,26,5,1,Ligue_1,2022_2023
Adrien Thomasson,FRA,MF,Strasbourg,28,1993,10.4,19,9,8,6,5,9,30,30.0,21,18,0,18,3,22,2,0,Ligue_1,2022_2023
Adrien Thomasson,FRA,"MF,FW",Lens,28,1993,14.2,24,17,8,11,5,12,45,26.7,33,25,2,23,4,28,17,0,Ligue_1,2022_2023
Khéphren Thuram,FRA,MF,Nice,21,2001,28.3,51,25,22,23,6,19,43,44.2,24,33,13,20,38,89,34,0,Ligue_1,2022_2023
Alexis Tibidi,FRA,"FW,MF",Troyes,18,2003,0.8,1,1,1,0,0,0,0,,0,0,0,0,0,1,0,0,Ligue_1,2022_2023
Jean-Clair Todibo,FRA,DF,Nice,22,1999,31.9,76,48,54,19,3,41,56,73.2,15,41,19,22,41,117,110,2,Ligue_1,2022_2023
Karl Toko Ekambi,CMR,"FW,MF",Rennes,29,1992,10.8,3,1,1,1,1,3,9,33.3,6,5,0,5,9,12,3,0,Ligue_1,2022_2023
Karl Toko Ekambi,CMR,"FW,MF",Lyon,29,1992,15.0,9,9,2,4,3,4,15,26.7,11,12,2,10,9,18,6,0,Ligue_1,2022_2023
Corentin Tolisso,FRA,MF,Lyon,27,1994,22.6,44,27,16,23,5,25,66,37.9,41,25,5,20,24,68,23,1,Ligue_1,2022_2023
Birama Touré,MLI,MF,Auxerre,30,1992,37.8,80,47,35,35,10,34,93,36.6,59,54,9,45,67,147,49,0,Ligue_1,2022_2023
Mohamed Toure,AUS,"FW,MF",Reims,18,2004,0.3,0,0,0,0,0,0,0,,0,0,0,0,0,0,0,0,Ligue_1,2022_2023
Souleymane Touré,FRA,DF,Marseille,19,2003,0.8,2,1,1,1,0,1,2,50.0,1,1,0,1,0,2,5,0,Ligue_1,2022_2023
Souleymane Touré,FRA,DF,Auxerre,19,2003,17.6,29,13,19,9,1,16,20,80.0,4,32,12,20,26,55,56,1,Ligue_1,2022_2023
Yoann Touzghar,TUN,FW,Ajaccio,35,1986,5.0,3,2,0,2,1,0,1,0.0,1,0,0,0,0,3,1,0,Ligue_1,2022_2023
Charles Traore,MLI,DF,Nantes,30,1992,5.4,8,5,5,2,1,5,7,71.4,2,9,2,7,10,18,12,0,Ligue_1,2022_2023
Hamari Traoré,MLI,DF,Rennes,30,1992,28.1,48,32,26,15,7,28,52,53.8,24,33,7,26,38,86,64,0,Ligue_1,2022_2023
Théo Trinker,FRA,MF,Nice,21,2001,0.0,0,0,0,0,0,0,0,,0,0,0,0,0,0,0,0,Ligue_1,2022_2023
Adrien Truffert,FRA,DF,Rennes,20,2001,21.7,62,32,36,17,9,31,46,67.4,15,32,8,24,22,84,55,0,Ligue_1,2022_2023
Theocharis Tsingaras,GRE,MF,Toulouse,21,2000,0.1,0,0,0,0,0,0,0,,0,0,0,0,0,0,0,0,Ligue_1,2022_2023
Ike Ugbo,CAN,"FW,MF",Troyes,23,1998,9.9,5,2,2,2,1,3,11,27.3,8,8,2,6,2,7,4,0,Ligue_1,2022_2023
Lesley Ugochukwu,FRA,MF,Rennes,18,2004,14.8,36,19,13,20,3,16,24,66.7,8,24,10,14,21,57,16,0,Ligue_1,2022_2023
Cengiz Ünder,TUR,"MF,DF",Marseille,25,1997,27.7,37,19,15,13,9,13,34,38.2,21,18,2,16,18,55,13,0,Ligue_1,2022_2023
Jere Uronen,FIN,DF,Brest,28,1994,3.3,8,5,4,4,0,7,12,58.3,5,6,2,4,7,15,5,0,Ligue_1,2022_2023
Yan Valery,TUN,DF,Angers,23,1999,27.7,54,39,28,20,6,20,37,54.1,17,35,15,20,34,88,82,0,Ligue_1,2022_2023
Vanderson,BRA,"DF,MF",Monaco,21,2001,24.6,84,48,36,34,14,44,75,58.7,31,36,9,27,48,132,36,1,Ligue_1,2022_2023
Jordan Veretout,FRA,MF,Marseille,29,1993,31.8,56,35,17,32,7,25,53,47.2,28,22,7,15,36,92,40,2,Ligue_1,2022_2023
Marco Verratti,ITA,MF,Paris S-G,29,1992,24.4,76,49,34,36,6,38,89,42.7,51,42,6,36,27,103,11,3,Ligue_1,2022_2023
João Victor,BRA,DF,Nantes,24,1998,9.4,19,11,9,7,3,12,22,54.5,10,11,1,10,15,34,30,0,Ligue_1,2022_2023
Clément Vidal,FRA,"DF,MF",Ajaccio,22,2000,21.1,25,15,14,11,0,18,38,47.4,20,27,16,11,27,52,73,1,Ligue_1,2022_2023
Alan Virginius,FRA,FW,Lille,19,2003,2.9,3,2,1,1,1,0,4,0.0,4,0,0,0,2,5,1,0,Ligue_1,2022_2023
Mattia Viti,ITA,DF,Nice,20,2002,7.0,4,2,1,1,2,2,5,40.0,3,9,3,6,8,12,22,0,Ligue_1,2022_2023
Vitinha,POR,FW,Marseille,22,2000,5.2,15,7,0,6,9,3,11,27.3,8,3,0,3,2,17,6,0,Ligue_1,2022_2023
Vitinha,POR,MF,Paris S-G,22,2000,27.2,58,25,21,27,10,27,83,32.5,56,27,4,23,25,83,15,0,Ligue_1,2022_2023
Kevin Volland,GER,"FW,MF",Monaco,30,1992,7.1,8,4,1,5,2,2,8,25.0,6,8,0,8,2,10,0,0,Ligue_1,2022_2023
Elye Wahi,FRA,FW,Montpellier,19,2003,27.9,9,3,2,3,4,5,14,35.7,9,14,2,12,3,12,5,0,Ligue_1,2022_2023
Timothy Weah,USA,"DF,FW",Lille,22,2000,19.4,24,14,13,9,2,16,29,55.2,13,17,3,14,23,47,18,0,Ligue_1,2022_2023
Mateusz Wieteska,POL,DF,Clermont Foot,25,1997,34.6,41,23,28,13,0,19,33,57.6,14,44,28,16,56,97,97,4,Ligue_1,2022_2023
Christopher Wooh,CMR,DF,Rennes,20,2001,11.2,16,7,8,8,0,9,11,81.8,2,11,5,6,6,22,49,0,Ligue_1,2022_2023
Christopher Wooh,CMR,MF,Lens,20,2001,0.0,0,0,0,0,0,0,1,0.0,1,0,0,0,0,0,1,0,Ligue_1,2022_2023
Xeka,POR,MF,Rennes,27,1994,6.1,10,3,6,3,1,7,16,43.8,9,11,2,9,6,16,8,0,Ligue_1,2022_2023
Yusuf Yazıcı,TUR,MF,Lille,25,1997,2.2,0,0,0,0,0,0,0,,0,2,0,2,0,0,1,0,Ligue_1,2022_2023
Darlin Yongwa,CMR,DF,Lorient,21,2000,8.7,13,11,7,5,1,4,15,26.7,11,13,1,12,5,18,11,0,Ligue_1,2022_2023
Leny Yoro,FRA,DF,Lille,16,2005,8.5,11,5,8,3,0,4,9,44.4,5,6,1,5,18,29,27,1,Ligue_1,2022_2023
Mohamed Youssouf,COM,DF,Ajaccio,34,1988,27.3,72,44,41,24,7,38,61,62.3,23,32,8,24,65,137,70,0,Ligue_1,2022_2023
Warren Zaïre-Emery,FRA,"MF,DF",Paris S-G,16,2006,10.3,17,10,5,10,2,8,29,27.6,21,11,0,11,12,29,17,0,Ligue_1,2022_2023
Oliver Zandén,SWE,"DF,MF",Toulouse,20,2001,1.6,2,1,1,0,1,2,5,40.0,3,0,0,0,1,3,7,0,Ligue_1,2022_2023
Akim Zedadka,ALG,DF,Auxerre,27,1995,17.8,35,21,21,10,4,18,32,56.3,14,17,3,14,23,58,51,1,Ligue_1,2022_2023
Akim Zedadka,ALG,"DF,MF",Lille,27,1995,3.9,1,1,1,0,0,0,2,0.0,2,3,0,3,2,3,6,0,Ligue_1,2022_2023
Mehdi Zeffane,ALG,"DF,MF",Clermont Foot,30,1992,7.3,12,7,5,7,0,4,21,19.0,17,14,6,8,22,34,12,0,Ligue_1,2022_2023
Arber Zeneli,KVX,"FW,MF",Reims,27,1995,11.1,9,3,3,3,3,5,12,41.7,7,8,0,8,2,11,2,0,Ligue_1,2022_2023
Nathan Zeze,FRA,DF,Nantes,17,2005,0.7,3,2,2,1,0,1,1,100.0,0,0,0,0,0,3,1,0,Ligue_1,2022_2023
Edon Zhegrova,KVX,"FW,MF",Lille,23,1999,11.7,18,12,6,7,5,12,20,60.0,8,9,0,9,2,20,2,0,Ligue_1,2022_2023
Tanguy Zoukrou,FRA,DF,Troyes,19,2003,5.7,14,7,8,6,0,10,14,71.4,4,18,11,7,2,16,24,0,Ligue_1,2022_2023
Max Aarons,ENG,DF,Bournemouth,23,2000,13.7,29,19,20,7,2,20,34,58.8,14,9,5,4,8,37,27,0,Premier_League,2023_2024
Joshua Acheampong,ENG,DF,Chelsea,17,2006,0.1,0,0,0,0,0,0,0,,0,3,3,0,0,0,0,0,Premier_League,2023_2024
Tyler Adams,USA,MF,Bournemouth,24,1999,1.3,4,3,1,3,0,2,3,66.7,1,2,0,2,4,8,2,0,Premier_League,2023_2024
Tosin Adarabioyo,ENG,DF,Fulham,25,1997,18.0,21,11,16,5,0,12,21,57.1,9,16,11,5,25,46,80,0,Premier_League,2023_2024
Elijah Adebayo,ENG,FW,Luton Town,25,1998,15.8,4,1,1,0,3,1,12,8.3,11,13,2,11,6,10,25,0,Premier_League,2023_2024
Simon Adingra,CIV,FW,Brighton,21,2002,24.7,45,20,23,11,11,19,42,45.2,23,31,1,30,19,64,22,0,Premier_League,2023_2024
Nayef Aguerd,MAR,DF,West Ham,27,1996,20.6,26,14,19,7,0,16,22,72.7,6,33,24,9,17,43,85,2,Premier_League,2023_2024
Brandon Aguilera,CRC,FW,Nott'ham Forest,20,2003,0.1,0,0,0,0,0,0,0,,0,0,0,0,0,0,0,0,Premier_League,2023_2024
Naouirou Ahamada,FRA,"MF,FW",Crystal Palace,21,2002,3.9,13,9,5,6,2,8,17,47.1,9,3,0,3,2,15,4,0,Premier_League,2023_2024
Anel Ahmedhodžić,BIH,DF,Sheffield Utd,24,1999,29.4,64,36,48,14,2,30,49,61.2,19,43,26,17,35,99,137,2,Premier_League,2023_2024
Ola Aina,NGA,DF,Nott'ham Forest,26,1996,18.8,47,31,31,12,4,29,41,70.7,12,19,3,16,18,65,51,1,Premier_League,2023_2024
Rayan Aït-Nouri,ALG,"DF,MF",Wolves,22,2001,25.9,71,44,41,23,7,28,49,57.1,21,32,6,26,15,86,38,0,Premier_League,2023_2024
Kristoffer Ajer,NOR,DF,Brentford,25,1998,20.4,38,21,25,9,4,23,36,63.9,13,26,11,15,25,63,79,1,Premier_League,2023_2024
Manuel Akanji,SUI,"DF,MF",Manchester City,28,1995,27.9,42,28,16,18,8,22,39,56.4,17,28,12,16,23,65,70,3,Premier_League,2023_2024
Nathan Aké,NED,DF,Manchester City,28,1995,22.7,26,16,15,8,3,13,20,65.0,7,17,2,15,14,40,54,0,Premier_League,2023_2024
Thiago Alcántara,ESP,MF,Liverpool,32,1991,0.1,0,0,0,0,0,0,0,,0,0,0,0,0,0,0,0,Premier_League,2023_2024
Trent Alexander-Arnold,ENG,DF,Liverpool,24,1998,23.9,39,26,26,11,2,27,87,31.0,60,22,2,20,31,70,48,5,Premier_League,2023_2024
Alisson,BRA,GK,Liverpool,30,1992,28.0,0,0,0,0,0,0,1,0.0,1,0,0,0,0,0,11,4,Premier_League,2023_2024
Miguel Almirón,PAR,FW,Newcastle Utd,29,1994,21.5,36,24,13,15,8,11,29,37.9,18,29,2,27,10,46,13,0,Premier_League,2023_2024
Edson Álvarez,MEX,MF,West Ham,25,1997,26.4,80,39,47,26,7,31,66,47.0,35,59,20,39,42,122,81,0,Premier_League,2023_2024
Julián Álvarez,ARG,"MF,FW",Manchester City,23,2000,29.4,24,13,5,8,11,8,32,25.0,24,30,0,30,2,26,14,1,Premier_League,2023_2024
Zeki Amdouni,SUI,FW,Burnley,22,2000,21.7,27,18,1,15,11,7,25,28.0,18,23,10,13,9,36,10,0,Premier_League,2023_2024
Sofyan Amrabat,MAR,"MF,DF",Manchester Utd,26,1996,10.4,27,16,17,8,2,17,31,54.8,14,20,7,13,8,35,19,2,Premier_League,2023_2024
Joachim Andersen,DEN,DF,Crystal Palace,27,1996,37.9,56,35,33,21,2,29,39,74.4,10,33,18,15,41,97,207,1,Premier_League,2023_2024
Elliot Anderson,ENG,"MF,FW",Newcastle Utd,20,2002,11.4,24,18,12,9,3,15,29,51.7,14,23,4,19,8,32,23,0,Premier_League,2023_2024
Jaidon Anthony,ENG,FW,Bournemouth,23,1999,1.7,3,1,1,0,2,1,7,14.3,6,3,0,3,1,4,3,0,Premier_League,2023_2024
Michail Antonio,JAM,FW,West Ham,33,1990,18.8,15,8,5,6,4,3,11,27.3,8,16,3,13,4,19,4,0,Premier_League,2023_2024
Antony,BRA,FW,Manchester Utd,23,2000,14.7,40,21,15,19,6,20,40,50.0,20,29,1,28,12,52,9,0,Premier_League,2023_2024
Oliver Arblaster,ENG,MF,Sheffield Utd,19,2004,10.5,23,14,11,8,4,7,15,46.7,8,17,7,10,15,38,9,0,Premier_League,2023_2024
Cameron Archer,ENG,"FW,MF",Sheffield Utd,22,2001,20.4,18,13,6,6,6,8,18,44.4,10,22,3,19,1,19,11,0,Premier_League,2023_2024
Cameron Archer,ENG,MF,Aston Villa,22,2001,0.1,0,0,0,0,0,0,0,,0,0,0,0,0,0,0,0,Premier_League,2023_2024
Alphonse Areola,FRA,GK,West Ham,30,1993,30.0,1,1,1,0,0,1,3,33.3,2,0,0,0,1,2,16,0,Premier_League,2023_2024
Lorenz Assignon,TOG,DF,Burnley,23,2000,13.7,35,17,18,13,4,14,27,51.9,13,22,7,15,19,54,43,1,Premier_League,2023_2024
Serge Aurier,CIV,"DF,MF",Nott'ham Forest,30,1992,9.3,20,14,9,11,0,5,11,45.5,6,10,3,7,9,29,36,1,Premier_League,2023_2024
Taiwo Awoniyi,NGA,FW,Nott'ham Forest,25,1997,11.6,9,7,1,4,4,1,2,50.0,1,7,2,5,1,10,9,0,Premier_League,2023_2024
Jordan Ayew,GHA,"FW,MF",Crystal Palace,31,1991,28.3,65,36,23,28,14,21,42,50.0,21,43,2,41,16,81,15,0,Premier_League,2023_2024
Benoît Badiashile,FRA,DF,Chelsea,22,2001,14.9,21,15,12,9,0,9,14,64.3,5,21,14,7,18,39,66,2,Premier_League,2023_2024
Leon Bailey,JAM,"MF,FW",Aston Villa,25,1997,23.0,13,7,7,4,2,5,20,25.0,15,18,1,17,9,22,6,0,Premier_League,2023_2024
Stefan Bajcetic,ESP,MF,Liverpool,18,2004,0.3,4,1,3,1,0,3,5,60.0,2,0,0,0,0,4,0,0,Premier_League,2023_2024
George Baldock,GRE,DF,Sheffield Utd,30,1993,10.8,18,10,10,7,1,6,15,40.0,9,14,8,6,10,28,33,0,Premier_League,2023_2024
Carlos Baleba,CMR,MF,Brighton,19,2004,14.7,40,20,17,19,4,23,46,50.0,23,35,7,28,18,58,30,3,Premier_League,2023_2024
Fodé Ballo-Touré,SEN,"DF,MF",Fulham,26,1997,0.8,4,2,1,3,0,1,2,50.0,1,1,0,1,3,7,2,0,Premier_League,2023_2024
Shandon Baptiste,GRN,MF,Brentford,25,1998,2.5,4,4,2,2,0,1,5,20.0,4,5,1,4,3,7,6,0,Premier_League,2023_2024
Valentín Barco,ARG,"DF,FW",Brighton,19,2004,3.4,11,5,4,5,2,6,8,75.0,2,3,0,3,4,15,3,1,Premier_League,2023_2024
Ross Barkley,ENG,MF,Luton Town,29,1993,29.1,47,19,16,21,10,11,48,22.9,37,25,9,16,25,72,51,2,Premier_League,2023_2024
Harvey Barnes,ENG,"FW,MF",Newcastle Utd,25,1997,8.9,6,1,3,2,1,1,2,50.0,1,1,0,1,5,11,3,0,Premier_League,2023_2024
Chris Basham,ENG,"DF,MF",Sheffield Utd,35,1988,3.6,7,2,4,3,0,2,9,22.2,7,9,4,5,5,12,17,0,Premier_League,2023_2024
Calvin Bassey,NGA,DF,Fulham,23,1999,25.6,49,29,33,15,1,21,29,72.4,8,32,11,21,28,77,84,4,Premier_League,2023_2024
Owen Beck,WAL,DF,Liverpool,20,2002,0.1,2,1,1,1,0,0,0,,0,0,0,0,0,2,1,0,Premier_League,2023_2024
Donny van de Beek,NED,DF,Manchester Utd,26,1997,0.0,0,0,0,0,0,0,0,,0,1,0,1,0,0,0,0,Premier_League,2023_2024
Amari'i Bell,JAM,DF,Luton Town,29,1994,19.1,50,33,30,19,1,22,35,62.9,13,33,15,18,25,75,60,1,Premier_League,2023_2024
Jean-Ricner Bellegarde,FRA,"MF,FW",Wolves,25,1998,10.6,17,10,9,6,2,7,15,46.7,8,18,2,16,8,25,14,0,Premier_League,2023_2024
Anis Ben Slimane,TUN,MF,Sheffield Utd,22,2001,4.7,11,6,5,2,4,4,10,40.0,6,7,1,6,5,16,7,0,Premier_League,2023_2024
Saïd Benrahma,ALG,"FW,MF",West Ham,27,1995,6.9,8,4,5,3,0,4,15,26.7,11,8,0,8,5,13,7,0,Premier_League,2023_2024
Rodrigo Bentancur,URU,MF,Tottenham,26,1997,11.2,23,15,10,11,2,10,24,41.7,14,15,4,11,17,40,16,1,Premier_League,2023_2024
Daniel Bentley,ENG,GK,Wolves,30,1993,4.3,0,0,0,0,0,0,1,0.0,1,0,0,0,0,0,1,0,Premier_League,2023_2024
Jóhann Berg Guðmundsson,ISL,"MF,FW",Burnley,32,1990,13.2,13,4,6,5,2,7,16,43.8,9,14,0,14,16,29,16,0,Premier_League,2023_2024
Sander Berge,NOR,MF,Burnley,25,1998,33.4,76,46,35,36,5,34,58,58.6,24,49,20,29,23,99,60,2,Premier_League,2023_2024
Luke Berry,ENG,"MF,DF",Luton Town,31,1992,3.6,7,2,2,4,1,2,3,66.7,1,6,1,5,0,7,3,0,Premier_League,2023_2024
Beto,GNB,FW,Everton,25,1998,10.6,14,6,1,6,7,4,12,33.3,8,11,0,11,1,15,14,0,Premier_League,2023_2024
Jordan Beyer,GER,DF,Burnley,23,2000,13.7,35,20,22,12,1,14,24,58.3,10,22,15,7,16,51,68,1,Premier_League,2023_2024
Philip Billing,DEN,MF,Bournemouth,27,1996,15.5,33,16,7,22,4,9,27,33.3,18,31,5,26,20,53,28,1,Premier_League,2023_2024
Yves Bissouma,MLI,MF,Tottenham,26,1996,23.0,80,52,32,36,12,41,61,67.2,20,28,5,23,37,117,43,3,Premier_League,2023_2024
Benicio Boaitey,ENG,"FW,DF",Brighton,19,2004,0.4,0,0,0,0,0,0,1,0.0,1,1,0,1,0,0,2,0,Premier_League,2023_2024
Oscar Bobb,NOR,"FW,MF",Manchester City,20,2003,3.4,7,3,1,2,4,2,4,50.0,2,4,0,4,5,12,1,0,Premier_League,2023_2024
Jayden Bogle,ENG,DF,Sheffield Utd,23,2000,31.0,66,36,43,21,2,35,70,50.0,35,42,11,31,32,98,97,0,Premier_League,2023_2024
Willy Boly,CIV,DF,Nott'ham Forest,32,1991,16.0,46,29,36,9,1,22,40,55.0,18,32,21,11,25,71,90,0,Premier_League,2023_2024
Sven Botman,NED,DF,Newcastle Utd,23,2000,15.3,20,13,14,6,0,8,13,61.5,5,20,16,4,9,29,61,3,Premier_League,2023_2024
Jarrod Bowen,ENG,FW,West Ham,26,1996,33.5,42,28,14,14,14,13,35,37.1,22,37,5,32,19,61,14,0,Premier_League,2023_2024
Conor Bradley,NIR,DF,Liverpool,20,2003,8.4,33,25,14,12,7,24,38,63.2,14,17,1,16,10,43,14,0,Premier_League,2023_2024
Jarrad Branthwaite,ENG,DF,Everton,21,2002,34.6,66,32,42,22,2,45,62,72.6,17,51,36,15,50,116,163,2,Premier_League,2023_2024
Ben Brereton,CHI,"FW,MF",Sheffield Utd,24,1999,12.3,9,4,4,4,1,4,10,40.0,6,9,3,6,3,12,12,0,Premier_League,2023_2024
Rhian Brewster,ENG,"FW,MF",Sheffield Utd,23,2000,3.8,5,1,1,2,2,0,2,0.0,2,2,0,2,1,6,2,0,Premier_League,2023_2024
Armando Broja,ALB,FW,Chelsea,21,2001,5.0,3,0,0,1,2,1,2,50.0,1,5,1,4,0,3,3,0,Premier_League,2023_2024
Armando Broja,ALB,FW,Fulham,21,2001,1.0,0,0,0,0,0,0,0,,0,1,0,1,0,0,0,0,Premier_League,2023_2024
Andre Brooks,ENG,"MF,DF",Sheffield Utd,19,2003,10.4,22,13,7,11,4,9,21,42.9,12,13,1,12,14,36,20,0,Premier_League,2023_2024
David Brooks,WAL,"FW,MF",Bournemouth,26,1997,3.1,5,4,2,1,2,2,4,50.0,2,3,0,3,2,7,2,0,Premier_League,2023_2024
Jacob Brown,SCO,"MF,FW",Luton Town,25,1998,11.3,19,12,7,7,5,7,18,38.9,11,20,1,19,8,27,22,0,Premier_League,2023_2024
Josh Brownhill,ENG,MF,Burnley,27,1995,25.0,61,35,23,28,10,27,37,73.0,10,33,8,25,34,95,40,1,Premier_League,2023_2024
Jacob Bruun Larsen,DEN,"MF,FW",Burnley,24,1998,13.9,9,4,4,3,2,7,21,33.3,14,16,2,14,7,16,23,0,Premier_League,2023_2024
Hugo Bueno,ESP,"DF,MF",Wolves,20,2002,8.2,21,14,12,7,2,12,19,63.2,7,17,4,13,6,27,24,0,Premier_League,2023_2024
Santiago Bueno,URU,DF,Wolves,24,1998,9.1,13,7,5,7,1,5,11,45.5,6,22,12,10,6,19,33,0,Premier_League,2023_2024
Facundo Buonanotte,ARG,"FW,MF",Brighton,18,2004,15.2,42,22,13,22,7,14,44,31.8,30,22,3,19,8,50,5,0,Premier_League,2023_2024
Reece Burke,ENG,DF,Luton Town,26,1996,18.4,37,23,17,14,6,12,26,46.2,14,25,18,7,18,55,78,1,Premier_League,2023_2024
Dan Burn,ENG,DF,Newcastle Utd,31,1992,30.3,61,33,37,20,4,26,61,42.6,35,55,25,30,37,98,124,1,Premier_League,2023_2024
Mason Burstow,ENG,FW,Chelsea,19,2003,0.1,0,0,0,0,0,0,0,,0,0,0,0,0,0,0,0,Premier_League,2023_2024
Moisés Caicedo,ECU,MF,Chelsea,21,2001,31.8,91,46,38,42,11,36,60,60.0,24,59,25,34,37,128,44,4,Premier_League,2023_2024
Tom Cairney,SCO,MF,Fulham,32,1991,16.5,24,16,10,12,2,13,25,52.0,12,16,4,12,13,37,6,0,Premier_League,2023_2024
Dominic Calvert-Lewin,ENG,FW,Everton,26,1997,24.1,13,6,2,6,5,2,15,13.3,13,14,4,10,4,17,38,0,Premier_League,2023_2024
Thomas Cannon,IRL,FW,Everton,20,2002,0.0,0,0,0,0,0,0,0,,0,0,0,0,0,0,0,0,Premier_League,2023_2024
Diego Carlos,BRA,DF,Aston Villa,30,1993,20.2,27,16,22,4,1,13,21,61.9,8,24,19,5,13,40,78,3,Premier_League,2023_2024
Cesare Casadei,ITA,"FW,MF",Chelsea,20,2003,0.9,5,3,2,1,2,2,5,40.0,3,1,0,1,0,5,4,0,Premier_League,2023_2024
Casemiro,BRA,"MF,DF",Manchester Utd,31,1992,22.0,83,56,43,32,8,51,106,48.1,55,74,33,41,18,101,71,1,Premier_League,2023_2024
Kaelan Casey,ENG,DF,West Ham,18,2004,0.0,0,0,0,0,0,0,0,,0,0,0,0,0,0,1,0,Premier_League,2023_2024
Matty Cash,POL,DF,Aston Villa,25,1997,23.8,54,31,24,24,6,29,59,49.2,30,35,14,21,18,72,59,0,Premier_League,2023_2024
Timothy Castagne,BEL,DF,Fulham,27,1995,29.3,49,24,23,16,10,26,44,59.1,18,38,10,28,38,87,69,1,Premier_League,2023_2024
Jonny Castro,ESP,MF,Wolves,29,1994,0.1,0,0,0,0,0,0,1,0.0,1,1,1,0,0,0,0,0,Premier_League,2023_2024
Trevoh Chalobah,ENG,DF,Chelsea,24,1999,10.6,16,12,10,2,4,10,15,66.7,5,8,7,1,8,24,51,0,Premier_League,2023_2024
Calum Chambers,ENG,"MF,DF",Aston Villa,28,1995,1.7,3,0,3,0,0,0,1,0.0,1,2,1,1,2,5,4,0,Premier_League,2023_2024
Youssef Chermiti,POR,FW,Everton,19,2004,2.3,3,2,2,1,0,1,5,20.0,4,4,1,3,1,4,2,0,Premier_League,2023_2024
Ben Chilwell,ENG,DF,Chelsea,26,1996,8.4,15,10,5,9,1,5,8,62.5,3,11,3,8,4,19,19,1,Premier_League,2023_2024
Tawanda Chirewa,ZIM,"MF,FW",Wolves,19,2003,1.6,7,3,3,3,1,2,3,66.7,1,0,0,0,1,8,0,0,Premier_League,2023_2024
Leon Chiwome,ENG,FW,Wolves,17,2006,1.9,2,1,0,1,1,1,2,50.0,1,3,1,2,0,2,2,0,Premier_League,2023_2024
Tahith Chong,NED,"MF,FW",Luton Town,23,1999,22.0,36,22,19,13,4,15,33,45.5,18,30,6,24,8,44,11,1,Premier_League,2023_2024
Ryan Christie,SCO,MF,Bournemouth,28,1995,32.3,86,44,34,35,17,39,92,42.4,53,52,11,41,52,138,53,1,Premier_League,2023_2024
Carney Chukwuemeka,ENG,"MF,FW",Chelsea,19,2003,2.5,6,4,3,3,0,1,3,33.3,2,1,1,0,0,6,1,0,Premier_League,2023_2024
Bobby Clark,ENG,MF,Liverpool,18,2005,1.0,2,1,1,1,0,1,5,20.0,4,6,2,4,1,3,1,0,Premier_League,2023_2024
Jordan Clark,ENG,MF,Luton Town,29,1993,14.5,30,17,14,11,5,11,39,28.2,28,24,3,21,11,41,15,1,Premier_League,2023_2024
Nathaniel Clyne,ENG,DF,Crystal Palace,32,1991,14.9,24,15,11,11,2,14,21,66.7,7,18,6,12,10,34,33,0,Premier_League,2023_2024
Séamus Coleman,IRL,DF,Everton,34,1988,7.4,17,14,10,3,4,11,16,68.8,5,12,4,8,7,24,26,1,Premier_League,2023_2024
Nathan Collins,IRL,DF,Brentford,22,2001,29.5,38,20,24,12,2,19,29,65.5,10,46,30,16,44,82,141,4,Premier_League,2023_2024
Levi Colwill,ENG,DF,Chelsea,20,2003,20.0,48,30,26,17,5,26,34,76.5,8,28,10,18,26,74,66,0,Premier_League,2023_2024
Lewis Cook,ENG,MF,Bournemouth,26,1997,31.0,61,41,24,30,7,34,63,54.0,29,32,11,21,65,126,46,1,Premier_League,2023_2024
Jack Cork,ENG,MF,Burnley,34,1989,0.3,2,0,0,2,0,1,3,33.3,2,0,0,0,1,3,1,0,Premier_League,2023_2024
Maxwel Cornet,CIV,"MF,FW",West Ham,26,1996,1.2,3,2,3,0,0,1,5,20.0,4,2,0,2,2,5,1,0,Premier_League,2023_2024
Vladimír Coufal,CZE,DF,West Ham,30,1992,34.8,64,41,50,12,2,38,75,50.7,37,49,15,34,43,107,97,0,Premier_League,2023_2024
Philippe Coutinho,BRA,"MF,FW",Aston Villa,31,1992,0.3,0,0,0,0,0,0,1,0.0,1,0,0,0,0,0,0,0,Premier_League,2023_2024
Aaron Cresswell,ENG,"DF,FW",West Ham,33,1989,4.8,3,2,1,1,1,2,3,66.7,1,5,3,2,3,6,7,0,Premier_League,2023_2024
Marc Cucurella,ESP,DF,Chelsea,25,1998,19.8,62,38,36,21,5,34,64,53.1,30,36,13,23,22,84,48,0,Premier_League,2023_2024
Josh Cullen,IRL,MF,Burnley,27,1996,22.9,42,29,15,22,5,26,46,56.5,20,31,19,12,15,57,26,1,Premier_League,2023_2024
Matheus Cunha,BRA,"FW,MF",Wolves,24,1999,27.1,30,16,8,17,5,13,35,37.1,22,28,7,21,13,43,21,1,Premier_League,2023_2024
Sam Curtis,IRL,DF,Sheffield Utd,17,2005,0.3,1,0,1,0,0,1,2,50.0,1,2,0,2,0,1,0,0,Premier_League,2023_2024
Mahmoud Dahoud,GER,MF,Brighton,27,1996,5.0,9,4,2,4,3,3,9,33.3,6,4,1,3,1,10,5,0,Premier_League,2023_2024
Ameen Al-Dakhil,BEL,DF,Burnley,21,2002,11.7,12,5,4,7,1,1,10,10.0,9,13,6,7,12,24,38,2,Premier_League,2023_2024
Diogo Dalot,POR,DF,Manchester Utd,24,1999,35.3,81,51,58,12,11,51,74,68.9,23,44,16,28,37,118,111,0,Premier_League,2023_2024
Mikkel Damsgaard,DEN,MF,Brentford,23,2000,9.4,29,17,13,9,7,14,40,35.0,26,23,1,22,11,40,10,1,Premier_League,2023_2024
Danilo,BRA,MF,Nott'ham Forest,22,2001,19.9,36,18,22,12,2,21,46,45.7,25,33,8,25,35,71,42,0,Premier_League,2023_2024
Arnaut Danjuma,NED,"MF,FW",Everton,26,1997,6.6,6,4,2,3,1,1,4,25.0,3,4,0,4,3,9,0,0,Premier_League,2023_2024
Jayden Danns,ENG,FW,Liverpool,17,2006,0.1,0,0,0,0,0,0,0,,0,0,0,0,0,0,0,0,Premier_League,2023_2024
Josh Dasilva,ENG,"DF,FW",Brentford,24,1998,0.3,2,1,0,1,1,0,0,,0,0,0,0,0,2,0,0,Premier_League,2023_2024
David Datro Fofana,CIV,FW,Burnley,20,2002,9.8,10,5,3,5,2,3,6,50.0,3,9,3,6,1,11,2,0,Premier_League,2023_2024
Ben Davies,WAL,DF,Tottenham,30,1993,12.1,24,17,13,8,3,16,21,76.2,5,17,15,2,10,34,35,0,Premier_League,2023_2024
Tom Davies,ENG,MF,Sheffield Utd,25,1998,2.5,10,5,4,3,3,3,9,33.3,6,2,1,1,3,13,6,1,Premier_League,2023_2024
Craig Dawson,ENG,DF,Wolves,33,1990,24.5,30,20,23,6,1,22,34,64.7,12,51,39,12,16,46,120,1,Premier_League,2023_2024
Kevin De Bruyne,BEL,MF,Manchester City,32,1991,13.6,14,9,1,5,8,7,20,35.0,13,5,0,5,4,18,4,0,Premier_League,2023_2024
Hannes Delcroix,BEL,DF,Burnley,24,1999,6.5,10,6,6,4,0,3,4,75.0,1,9,3,6,9,19,26,0,Premier_League,2023_2024
Leander Dendoncker,BEL,MF,Aston Villa,28,1995,1.3,6,4,3,2,1,4,5,80.0,1,5,2,3,2,8,3,1,Premier_League,2023_2024
Moussa Diaby,FRA,"FW,MF",Aston Villa,24,1999,24.2,12,5,5,4,3,4,22,18.2,18,8,1,7,9,21,6,0,Premier_League,2023_2024
Amad Diallo,CIV,"FW,MF",Manchester Utd,21,2002,4.3,10,3,1,6,3,3,7,42.9,4,3,1,2,1,11,6,0,Premier_League,2023_2024
Amadou Diallo,ENG,MF,Newcastle Utd,20,2003,0.0,0,0,0,0,0,0,0,,0,0,0,0,0,0,0,0,Premier_League,2023_2024
Rúben Dias,POR,DF,Manchester City,26,1997,28.4,39,20,14,21,4,19,26,73.1,7,32,17,15,30,69,77,0,Premier_League,2023_2024
Luis Díaz,COL,FW,Liverpool,26,1997,29.2,35,25,5,17,13,7,30,23.3,23,15,0,15,3,38,8,0,Premier_League,2023_2024
Eric Dier,ENG,DF,Tottenham,29,1994,2.2,2,1,2,0,0,2,2,100.0,0,3,3,0,2,4,12,0,Premier_League,2023_2024
Lucas Digne,FRA,DF,Aston Villa,30,1993,26.8,47,19,35,9,3,25,44,56.8,19,20,2,18,26,73,67,0,Premier_League,2023_2024
Issa Diop,FRA,DF,Fulham,26,1997,15.8,30,16,23,5,2,15,20,75.0,5,28,19,9,17,47,80,1,Premier_League,2023_2024
Axel Disasi,FRA,DF,Chelsea,25,1998,28.7,33,19,20,10,3,23,30,76.7,7,26,19,7,18,51,102,2,Premier_League,2023_2024
Ben Doak,SCO,FW,Liverpool,17,2005,0.2,0,0,0,0,0,0,0,,0,0,0,0,0,0,0,0,Premier_League,2023_2024
Lewis Dobbin,ENG,MF,Everton,20,2003,2.6,9,7,3,5,1,5,9,55.6,4,5,1,4,1,10,0,0,Premier_League,2023_2024
Matt Doherty,IRL,"DF,MF",Wolves,31,1992,12.8,31,18,17,10,4,12,23,52.2,11,15,5,10,7,38,47,0,Premier_League,2023_2024
Jeremy Doku,BEL,"FW,MF",Manchester City,21,2002,17.7,39,22,13,12,14,9,20,45.0,11,14,0,14,9,48,5,0,Premier_League,2023_2024
Nicolás Domínguez,ARG,"MF,FW",Nott'ham Forest,25,1998,16.6,63,34,35,27,1,23,48,47.9,25,31,5,26,18,81,24,0,Premier_League,2023_2024
Jamie Donley,ENG,FW,Tottenham,18,2005,0.0,0,0,0,0,0,0,0,,0,0,0,0,0,0,3,0,Premier_League,2023_2024
Abdoulaye Doucouré,MLI,"FW,MF",Everton,30,1993,29.2,43,27,20,14,9,18,46,39.1,28,23,3,20,15,58,19,0,Premier_League,2023_2024
Cheick Doucouré,MLI,MF,Crystal Palace,23,2000,10.2,34,17,15,13,6,18,30,60.0,12,13,2,11,20,54,12,0,Premier_League,2023_2024
Alfie Doughty,ENG,DF,Luton Town,23,1999,32.5,63,40,29,18,16,37,82,45.1,45,51,9,42,31,94,43,4,Premier_League,2023_2024
Tommy Doyle,ENG,MF,Wolves,21,2001,13.6,26,13,11,10,5,14,23,60.9,9,22,9,13,12,38,18,0,Premier_League,2023_2024
Radu Drăgușin,ROU,DF,Tottenham,21,2002,4.8,5,3,5,0,0,3,3,100.0,0,5,4,1,8,13,19,0,Premier_League,2023_2024
Martin Dúbravka,SVK,GK,Newcastle Utd,34,1989,22.1,0,0,0,0,0,0,4,0.0,4,0,0,0,0,0,8,1,Premier_League,2023_2024
Paul Dummett,WAL,DF,Newcastle Utd,31,1991,0.2,1,0,1,0,0,1,1,100.0,0,0,0,0,0,1,1,0,Premier_League,2023_2024
Lewis Dunk,ENG,DF,Brighton,31,1991,31.9,27,14,17,9,1,13,36,36.1,23,49,37,12,31,58,90,1,Premier_League,2023_2024
Jhon Durán,COL,"FW,MF",Aston Villa,19,2003,5.3,6,5,3,1,2,1,6,16.7,5,6,0,6,1,7,10,0,Premier_League,2023_2024
George Earthy,ENG,FW,West Ham,18,2004,0.4,0,0,0,0,0,0,1,0.0,1,0,0,0,1,1,0,0,Premier_League,2023_2024
Ederson,BRA,GK,Manchester City,29,1993,30.9,0,0,0,0,0,0,1,0.0,1,0,0,0,0,0,10,1,Premier_League,2023_2024
Odsonne Édouard,FRA,"FW,MF",Crystal Palace,25,1998,17.3,24,12,8,8,8,4,19,21.1,15,17,1,16,6,30,19,0,Premier_League,2023_2024
John Egan,IRL,DF,Sheffield Utd,30,1992,5.4,6,4,4,2,0,4,11,36.4,7,10,4,6,13,19,39,1,Premier_League,2023_2024
Hjalmar Ekdal,SWE,DF,Burnley,24,1998,4.9,4,2,2,2,0,2,4,50.0,2,10,5,5,6,10,21,0,Premier_League,2023_2024
Anthony Elanga,SWE,"FW,MF",Nott'ham Forest,21,2002,27.0,33,19,20,6,7,17,36,47.2,19,22,2,20,8,41,20,1,Premier_League,2023_2024
Harvey Elliott,ENG,"MF,FW",Liverpool,20,2003,15.0,27,17,8,14,5,10,31,32.3,21,27,0,27,6,33,7,0,Premier_League,2023_2024
Mohamed Elneny,EGY,MF,Arsenal,31,1992,0.3,0,0,0,0,0,0,1,0.0,1,0,0,0,1,1,0,0,Premier_League,2023_2024
Emerson,BRA,DF,Tottenham,24,1999,12.9,36,24,23,10,3,21,43,48.8,22,23,10,13,20,56,50,1,Premier_League,2023_2024
Julio Enciso,PAR,"MF,FW",Brighton,19,2004,5.3,6,2,3,2,1,2,7,28.6,5,11,0,11,0,6,3,0,Premier_League,2023_2024
Wataru Endo,JPN,MF,Liverpool,30,1993,19.1,48,28,11,31,6,20,61,32.8,41,24,2,22,20,68,31,3,Premier_League,2023_2024
Christian Eriksen,DEN,MF,Manchester Utd,31,1992,12.7,18,13,5,10,3,12,33,36.4,21,17,6,11,4,22,13,0,Premier_League,2023_2024
Maxime Estève,FRA,DF,Burnley,21,2002,14.5,27,10,15,12,0,18,32,56.3,14,21,10,11,27,54,56,0,Premier_League,2023_2024
Pervis Estupiñán,ECU,DF,Brighton,25,1998,13.8,26,13,12,11,3,14,30,46.7,16,14,4,10,21,47,20,0,Premier_League,2023_2024
Jonny Evans,NIR,DF,Manchester Utd,35,1988,15.5,22,14,20,2,0,12,21,57.1,9,25,18,7,23,45,76,0,Premier_League,2023_2024
Eberechi Eze,ENG,"MF,FW",Crystal Palace,25,1998,22.8,35,17,4,18,13,15,31,48.4,16,27,2,25,11,46,6,0,Premier_League,2023_2024
Łukasz Fabiański,POL,GK,West Ham,38,1985,8.0,1,0,1,0,0,1,2,50.0,1,0,0,0,1,2,4,0,Premier_League,2023_2024
Romain Faivre,FRA,"MF,FW",Bournemouth,25,1998,0.5,1,1,0,1,0,0,3,0.0,3,0,0,0,0,1,0,0,Premier_League,2023_2024
Ansu Fati,ESP,"MF,FW",Brighton,20,2002,5.8,5,3,1,2,2,1,11,9.1,10,8,0,8,3,8,3,0,Premier_League,2023_2024
Felipe,BRA,DF,Nott'ham Forest,34,1989,4.2,12,9,9,3,0,9,12,75.0,3,4,1,3,4,16,12,0,Premier_League,2023_2024
Evan Ferguson,IRL,FW,Brighton,18,2004,15.2,14,6,4,7,3,5,14,35.7,9,10,3,7,2,16,8,0,Premier_League,2023_2024
Bruno Fernandes,POR,"MF,FW",Manchester Utd,28,1994,34.6,68,38,27,25,16,30,88,34.1,58,49,6,43,27,95,50,2,Premier_League,2023_2024
Enzo Fernández,ARG,MF,Chelsea,22,2001,24.5,50,22,22,18,10,27,65,41.5,38,36,13,23,17,67,28,0,Premier_League,2023_2024
John Fleck,SCO,"MF,DF",Sheffield Utd,31,1991,1.0,1,0,0,1,0,0,1,0.0,1,0,0,0,0,1,1,0,Premier_League,2023_2024
Mark Flekken,NED,GK,Brentford,30,1993,36.5,1,1,1,0,0,1,5,20.0,4,1,0,1,0,1,17,1,Premier_League,2023_2024
Phil Foden,ENG,"FW,MF",Manchester City,23,2000,31.7,31,20,11,10,10,13,31,41.9,18,30,0,30,13,44,18,1,Premier_League,2023_2024
Wes Foderingham,ENG,GK,Sheffield Utd,32,1991,29.4,5,3,5,0,0,5,6,83.3,1,0,0,0,0,5,18,6,Premier_League,2023_2024
Pablo Fornals,ESP,"MF,FW",West Ham,27,1996,4.7,10,6,4,3,3,5,16,31.3,11,8,1,7,6,16,7,0,Premier_League,2023_2024
Omari Forson,ENG,FW,Manchester Utd,19,2004,0.8,2,0,0,2,0,1,1,100.0,0,0,0,0,0,2,0,0,Premier_League,2023_2024
Lyle Foster,RSA,"FW,MF",Burnley,22,2000,21.1,19,10,5,6,8,6,17,35.3,11,13,3,10,3,22,34,0,Premier_League,2023_2024
Matheus França,BRA,"MF,FW",Crystal Palace,19,2004,2.6,3,3,2,1,0,1,7,14.3,6,4,0,4,1,4,1,0,Premier_League,2023_2024
Nathan Fraser,IRL,FW,Wolves,18,2005,2.1,5,2,2,1,2,1,3,33.3,2,2,1,1,1,6,2,0,Premier_League,2023_2024
Cody Gakpo,NED,"FW,MF",Liverpool,24,1999,18.3,27,17,8,14,5,8,25,32.0,17,21,4,17,14,41,7,0,Premier_League,2023_2024
Conor Gallagher,ENG,MF,Chelsea,23,2000,34.8,85,52,37,31,17,33,77,42.9,44,50,11,39,43,128,34,0,Premier_League,2023_2024
Idrissa Gana Gueye,SEN,MF,Everton,33,1989,20.9,73,44,32,27,14,29,46,63.0,17,24,7,17,28,101,16,0,Premier_League,2023_2024
Alejandro Garnacho,ARG,FW,Manchester Utd,19,2004,28.5,22,15,7,6,9,12,45,26.7,33,26,2,24,18,40,18,0,Premier_League,2023_2024
James Garner,ENG,MF,Everton,22,2001,33.4,83,44,32,38,13,35,82,42.7,47,45,14,31,45,128,47,1,Premier_League,2023_2024
Saman Ghoddos,IRN,DF,Brentford,29,1993,8.2,28,19,19,7,2,17,31,54.8,14,9,2,7,5,33,12,0,Premier_League,2023_2024
Morgan Gibbs-White,ENG,"MF,FW",Nott'ham Forest,23,2000,35.1,36,24,6,20,10,14,33,42.4,19,31,8,23,17,53,21,0,Premier_League,2023_2024
Bryan Gil,ESP,"FW,MF",Tottenham,22,2001,2.3,1,0,0,0,1,1,4,25.0,3,3,0,3,3,4,4,0,Premier_League,2023_2024
Alfie Gilchrist,ENG,DF,Chelsea,19,2003,2.3,4,0,4,0,0,2,5,40.0,3,6,3,3,3,7,11,0,Premier_League,2023_2024
Billy Gilmour,SCO,MF,Brighton,22,2001,23.6,26,16,14,10,2,11,35,31.4,24,23,9,14,11,37,14,1,Premier_League,2023_2024
Ben Godfrey,ENG,DF,Everton,25,1998,12.4,30,20,17,8,5,15,28,53.6,13,14,8,6,16,46,57,0,Premier_League,2023_2024
André Gomes,POR,"MF,FW",Everton,30,1993,5.6,7,4,2,3,2,3,13,23.1,10,10,1,9,3,10,4,1,Premier_League,2023_2024
João Gomes,BRA,MF,Wolves,22,2001,29.4,128,74,67,49,12,44,99,44.4,55,51,8,43,18,146,29,2,Premier_League,2023_2024
Toti Gomes,POR,DF,Wolves,24,1999,30.8,44,25,32,8,4,24,37,64.9,13,40,19,21,26,70,93,2,Premier_League,2023_2024
Joe Gomez,ENG,DF,Liverpool,26,1997,19.8,47,31,24,16,7,30,63,47.6,33,26,4,22,19,66,50,2,Premier_League,2023_2024
Sergio Gómez,ESP,"FW,MF",Manchester City,22,2000,0.6,1,0,0,1,0,1,2,50.0,1,0,0,0,1,2,0,0,Premier_League,2023_2024
Enso Gonzalez,PAR,"MF,DF",Wolves,18,2005,0.0,0,0,0,0,0,0,1,0.0,1,0,0,0,0,0,0,0,Premier_League,2023_2024
Anthony Gordon,ENG,FW,Newcastle Utd,22,2001,32.1,55,34,16,28,11,22,64,34.4,42,27,0,27,7,62,7,0,Premier_League,2023_2024
Kaide Gordon,ENG,FW,Liverpool,18,2004,0.0,0,0,0,0,0,0,0,,0,0,0,0,0,0,0,0,Premier_League,2023_2024
Daniel Gore,ENG,MF,Manchester Utd,18,2004,0.0,1,1,0,1,0,1,1,100.0,0,0,0,0,1,2,0,0,Premier_League,2023_2024
Ryan Gravenberch,NED,MF,Liverpool,21,2002,12.5,26,12,5,13,8,12,29,41.4,17,20,2,18,14,40,11,0,Premier_League,2023_2024
Ivo Grbić,CRO,GK,Sheffield Utd,27,1996,8.6,0,0,0,0,0,0,1,0.0,1,1,0,1,0,0,9,1,Premier_League,2023_2024
Jack Grealish,ENG,"FW,MF",Manchester City,27,1995,11.2,13,8,6,7,0,6,12,50.0,6,13,2,11,6,19,5,0,Premier_League,2023_2024
Pascal Groß,GER,"MF,DF",Brighton,32,1991,34.6,70,46,33,21,16,31,72,43.1,41,41,8,33,22,92,32,3,Premier_League,2023_2024
Marc Guéhi,ENG,DF,Crystal Palace,23,2000,22.5,28,19,21,7,0,14,24,58.3,10,22,17,5,18,46,89,1,Premier_League,2023_2024
Bruno Guimarães,BRA,MF,Newcastle Utd,25,1997,36.3,88,53,45,32,11,40,77,51.9,37,52,14,38,35,123,20,0,Premier_League,2023_2024
Malo Gusto,FRA,DF,Chelsea,20,2003,19.5,55,27,34,15,6,35,52,67.3,17,28,4,24,17,72,43,1,Premier_League,2023_2024
Joško Gvardiol,CRO,DF,Manchester City,21,2002,25.9,55,33,21,24,10,21,38,55.3,17,36,12,24,27,82,37,3,Premier_League,2023_2024
Erling Haaland,NOR,FW,Manchester City,23,2000,28.4,6,3,0,3,3,2,3,66.7,1,11,1,10,2,8,16,0,Premier_League,2023_2024
Antwoine Hackford,ENG,FW,Sheffield Utd,19,2004,0.1,0,0,0,0,0,0,0,,0,0,0,0,0,0,0,0,Premier_League,2023_2024
Lewis Hall,ENG,DF,Newcastle Utd,18,2004,8.7,28,18,17,10,1,17,28,60.7,11,17,2,15,12,40,22,1,Premier_League,2023_2024
Gustavo Hamer,NED,MF,Sheffield Utd,26,1997,32.3,39,21,17,15,7,16,59,27.1,43,33,9,24,29,68,35,0,Premier_League,2023_2024
Luke Harris,WAL,MF,Fulham,18,2005,0.8,1,1,1,0,0,0,1,0.0,1,0,0,0,0,1,0,0,Premier_League,2023_2024
Jack Harrison,ENG,"MF,FW",Everton,26,1996,24.6,37,22,12,12,13,17,49,34.7,32,25,5,20,12,49,24,0,Premier_League,2023_2024
Daiki Hashioka,JPN,DF,Luton Town,24,1999,6.6,11,5,6,4,1,5,11,45.5,6,12,7,5,8,19,20,0,Premier_League,2023_2024
Kai Havertz,GER,"MF,FW",Arsenal,24,1999,29.3,35,15,7,21,7,14,39,35.9,25,26,1,25,20,55,22,0,Premier_League,2023_2024
Jan Paul van Hecke,NED,DF,Brighton,23,2000,26.3,47,26,25,19,3,27,45,60.0,18,49,27,22,30,77,76,4,Premier_League,2023_2024
Hwang Hee-chan,KOR,"FW,MF",Wolves,27,1996,23.5,20,10,11,8,1,9,24,37.5,15,19,1,18,10,30,9,0,Premier_League,2023_2024
Dean Henderson,ENG,GK,Crystal Palace,26,1997,18.0,1,1,1,0,0,1,2,50.0,1,0,0,0,0,1,8,2,Premier_League,2023_2024
Rico Henry,ENG,DF,Brentford,26,1997,4.5,7,5,3,3,1,6,7,85.7,1,8,3,5,5,12,5,1,Premier_League,2023_2024
Son Heung-min,KOR,FW,Tottenham,31,1992,32.6,21,13,6,7,8,10,21,47.6,11,4,1,3,8,29,4,0,Premier_League,2023_2024
Aaron Hickey,SCO,DF,Brentford,21,2002,7.9,16,9,9,3,4,7,7,100.0,0,7,3,4,3,19,10,0,Premier_League,2023_2024
James Hill,ENG,DF,Bournemouth,21,2002,0.8,3,2,1,2,0,1,1,100.0,0,3,2,1,3,6,8,0,Premier_League,2023_2024
Jack Hinshelwood,ENG,DF,Brighton,18,2005,9.7,14,5,7,4,3,5,13,38.5,8,6,2,4,14,28,18,0,Premier_League,2023_2024
Mason Holgate,ENG,DF,Sheffield Utd,26,1996,7.9,12,7,5,6,1,5,12,41.7,7,12,5,7,11,23,40,0,Premier_League,2023_2024
Callum Hudson-Odoi,ENG,"FW,MF",Nott'ham Forest,22,2000,20.6,18,8,4,5,9,7,28,25.0,21,16,1,15,7,25,12,1,Premier_League,2023_2024
Will Hughes,ENG,MF,Crystal Palace,28,1995,21.0,61,33,30,20,11,24,48,50.0,24,36,14,22,21,82,25,0,Premier_League,2023_2024
Pierre Højbjerg,DEN,MF,Tottenham,27,1995,14.6,32,18,13,17,2,13,34,38.2,21,21,7,14,19,51,30,3,Premier_League,2023_2024
Rasmus Højlund,DEN,FW,Manchester Utd,20,2003,24.0,11,7,2,3,6,5,13,38.5,8,9,1,8,1,12,19,0,Premier_League,2023_2024
Igor,BRA,DF,Brighton,25,1998,18.2,25,18,7,16,2,17,29,58.6,12,22,9,13,14,39,52,1,Premier_League,2023_2024
Danny Ings,ENG,FW,West Ham,31,1992,4.5,6,2,0,6,0,4,13,30.8,9,4,1,3,3,9,7,0,Premier_League,2023_2024
Tim Iroegbunam,ENG,MF,Aston Villa,20,2003,1.8,7,5,4,2,1,4,9,44.4,5,3,0,3,2,9,3,0,Premier_League,2023_2024
Alexander Isak,SWE,FW,Newcastle Utd,23,1999,25.1,5,0,2,1,2,2,8,25.0,6,16,1,15,6,11,13,0,Premier_League,2023_2024
Alex Iwobi,NGA,MF,Everton,27,1996,1.6,2,0,1,0,1,2,3,66.7,1,2,0,2,1,3,0,0,Premier_League,2023_2024
Alex Iwobi,NGA,"FW,MF",Fulham,27,1996,24.4,29,18,12,15,2,12,25,48.0,13,16,0,16,14,43,9,0,Premier_League,2023_2024
Nicolas Jackson,SEN,FW,Chelsea,22,2001,31.1,21,13,5,8,8,5,24,20.8,19,20,5,15,4,25,17,0,Premier_League,2023_2024
Reece James,ENG,DF,Chelsea,23,1999,4.7,14,9,10,3,1,8,10,80.0,2,4,4,0,3,17,7,1,Premier_League,2023_2024
Vitaly Janelt,GER,"MF,DF",Brentford,25,1998,33.9,63,38,29,25,9,32,64,50.0,32,35,9,26,36,99,64,3,Premier_League,2023_2024
Daniel Jebbison,ENG,FW,Sheffield Utd,19,2003,0.2,0,0,0,0,0,0,0,,0,1,0,1,0,0,0,0,Premier_League,2023_2024
Mathias Jensen,DEN,MF,Brentford,27,1996,24.5,54,32,25,22,7,26,95,27.4,69,41,6,35,23,77,25,1,Premier_League,2023_2024
Gabriel Jesus,BRA,FW,Arsenal,26,1997,16.4,24,17,11,5,8,5,18,27.8,13,23,1,22,13,37,12,0,Premier_League,2023_2024
Raúl Jiménez,MEX,FW,Fulham,32,1991,15.5,18,12,4,8,6,7,20,35.0,13,11,3,8,4,22,13,0,Premier_League,2023_2024
João Pedro,BRA,"FW,MF",Brighton,21,2001,22.7,31,14,10,13,8,14,24,58.3,10,15,2,13,11,42,28,0,Premier_League,2023_2024
Joelinton,BRA,"MF,FW",Newcastle Utd,26,1996,14.2,39,27,21,15,3,14,38,36.8,24,23,7,16,19,58,11,1,Premier_League,2023_2024
Ryan John Giles,ENG,"DF,MF",Luton Town,23,2000,5.6,8,6,4,3,1,2,7,28.6,5,2,0,2,4,12,22,0,Premier_League,2023_2024
Ben Johnson,ENG,"DF,FW",West Ham,23,2000,6.0,11,7,7,3,1,9,14,64.3,5,2,1,1,5,16,14,0,Premier_League,2023_2024
Brennan Johnson,WAL,FW,Tottenham,22,2001,23.2,26,15,14,5,7,12,31,38.7,19,37,1,36,10,36,12,1,Premier_League,2023_2024
Brennan Johnson,WAL,"FW,MF",Nott'ham Forest,22,2001,2.6,4,1,1,1,2,2,4,50.0,2,4,1,3,0,4,0,0,Premier_League,2023_2024
Joseph Johnson,ENG,DF,Luton Town,17,2006,0.9,0,0,0,0,0,0,1,0.0,1,0,0,0,0,0,0,0,Premier_League,2023_2024
Sam Johnstone,ENG,GK,Crystal Palace,30,1993,20.0,1,0,1,0,0,1,1,100.0,0,0,0,0,1,2,5,0,Premier_League,2023_2024
Curtis Jones,ENG,MF,Liverpool,22,2001,13.0,27,14,12,12,3,10,23,43.5,13,22,0,22,7,34,8,0,Premier_League,2023_2024
Jorginho,ITA,MF,Arsenal,31,1991,10.2,24,10,6,10,8,11,23,47.8,12,17,1,16,12,36,7,1,Premier_League,2023_2024
Diogo Jota,POR,FW,Liverpool,26,1996,12.7,23,13,6,13,4,10,23,43.5,13,9,1,8,7,30,4,0,Premier_League,2023_2024
Mads Juel Andersen,DEN,DF,Luton Town,25,1997,4.4,6,5,4,2,0,4,4,100.0,0,9,6,3,8,14,29,0,Premier_League,2023_2024
Hamed Junior Traorè,CIV,MF,Bournemouth,23,2000,0.5,1,0,1,0,0,1,3,33.3,2,3,0,3,0,1,0,0,Premier_League,2023_2024
Mathias Jørgensen,DEN,DF,Brentford,33,1990,12.1,17,12,15,1,1,11,19,57.9,8,9,5,4,12,29,40,0,Premier_League,2023_2024
Issa Kaboré,BFA,DF,Luton Town,22,2001,19.2,52,28,23,21,8,24,45,53.3,21,22,11,11,16,68,56,2,Premier_League,2023_2024
Sasa Kalajdzic,AUT,FW,Wolves,26,1997,1.8,6,2,3,2,1,1,2,50.0,1,3,0,3,1,7,6,0,Premier_League,2023_2024
Boubacar Kamara,FRA,MF,Aston Villa,23,1999,18.4,43,29,16,21,6,24,47,51.1,23,21,7,14,21,64,16,0,Premier_League,2023_2024
Willy Kambwala,FRA,DF,Manchester Utd,18,2004,3.7,3,1,1,2,0,1,3,33.3,2,6,3,3,4,7,14,1,Premier_League,2023_2024
Thomas Kaminski,BEL,GK,Luton Town,30,1992,37.8,2,1,2,0,0,2,6,33.3,4,1,0,1,0,2,14,2,Premier_League,2023_2024
Loris Karius,GER,GK,Newcastle Utd,30,1993,1.0,0,0,0,0,0,0,0,,0,0,0,0,0,0,1,0,Premier_League,2023_2024
Michael Keane,ENG,DF,Everton,30,1993,4.9,7,3,3,3,1,1,7,14.3,6,5,4,1,5,12,18,1,Premier_League,2023_2024
Thilo Kehrer,GER,"DF,MF",West Ham,26,1996,0.2,1,1,0,1,0,0,0,,0,2,2,0,0,1,0,0,Premier_League,2023_2024
Caoimhín Kelleher,IRL,GK,Liverpool,24,1998,10.0,0,0,0,0,0,0,0,,0,0,0,0,0,0,4,1,Premier_League,2023_2024
Lloyd Kelly,ENG,DF,Bournemouth,24,1998,17.3,24,19,10,9,5,14,25,56.0,11,22,12,10,13,37,67,0,Premier_League,2023_2024
Omari Kellyman,ENG,FW,Aston Villa,17,2005,0.4,1,0,0,1,0,1,2,50.0,1,0,0,0,0,1,0,0,Premier_League,2023_2024
Milos Kerkez,HUN,DF,Bournemouth,19,2003,21.9,47,26,31,13,3,30,42,71.4,12,31,11,20,20,67,60,2,Premier_League,2023_2024
Kaine Kesler-Hayden,ENG,"MF,DF",Aston Villa,20,2002,0.1,0,0,0,0,0,0,0,,0,0,0,0,0,0,0,0,Premier_League,2023_2024
Max Kilman,ENG,DF,Wolves,26,1997,38.0,47,21,40,6,1,24,32,75.0,8,64,37,27,39,86,182,4,Premier_League,2023_2024
Jakub Kiwior,POL,DF,Arsenal,23,2000,10.5,20,12,11,8,1,14,19,73.7,5,11,3,8,8,28,28,1,Premier_League,2023_2024
Justin Kluivert,NED,"MF,FW",Bournemouth,24,1999,21.3,28,14,5,12,11,8,30,26.7,22,16,1,15,8,36,11,0,Premier_League,2023_2024
Luca Koleosho,ITA,"MF,FW",Burnley,18,2004,10.8,7,4,2,5,0,2,10,20.0,8,13,0,13,2,9,0,0,Premier_League,2023_2024
Ibrahima Konaté,FRA,DF,Liverpool,24,1999,17.5,36,22,22,13,1,18,24,75.0,6,18,12,6,20,56,51,1,Premier_League,2023_2024
Ezri Konsa,ENG,DF,Aston Villa,25,1997,34.1,54,32,28,23,3,23,27,85.2,4,36,20,16,28,82,73,3,Premier_League,2023_2024
Cheikhou Kouyaté,SEN,MF,Nott'ham Forest,33,1989,2.4,8,5,3,3,2,1,4,25.0,3,4,1,3,2,10,10,0,Premier_League,2023_2024
Mateo Kovačić,CRO,MF,Manchester City,29,1994,17.2,36,25,16,15,5,18,28,64.3,10,23,1,22,10,46,10,0,Premier_League,2023_2024
Emil Krafth,SWE,DF,Newcastle Utd,28,1994,10.1,21,14,10,7,4,12,25,48.0,13,8,3,5,9,30,21,0,Premier_League,2023_2024
Mohammed Kudus,GHA,"FW,MF",West Ham,22,2000,27.6,65,47,27,27,11,20,40,50.0,20,25,0,25,11,76,9,1,Premier_League,2023_2024
Dejan Kulusevski,SWE,"FW,MF",Tottenham,23,2000,30.7,62,33,19,20,23,25,67,37.3,42,24,1,23,18,80,2,1,Premier_League,2023_2024
Adam Lallana,ENG,"MF,FW",Brighton,35,1988,9.4,8,3,4,4,0,0,4,0.0,4,2,1,1,3,11,1,0,Premier_League,2023_2024
Tariq Lamptey,GHA,"DF,FW",Brighton,22,2000,10.2,21,14,14,5,2,13,22,59.1,9,7,3,4,6,27,6,0,Premier_League,2023_2024
Aymeric Laporte,ESP,DF,Manchester City,29,1994,0.1,0,0,0,0,0,0,0,,0,1,1,0,0,0,1,0,Premier_League,2023_2024
Yasser Larouci,ALG,DF,Sheffield Utd,22,2001,5.9,17,9,10,5,2,10,14,71.4,4,6,1,5,7,24,20,1,Premier_League,2023_2024
Jamaal Lascelles,ENG,DF,Newcastle Utd,29,1993,12.0,14,9,7,7,0,6,11,54.5,5,17,12,5,5,19,42,0,Premier_League,2023_2024
Roméo Lavia,BEL,MF,Chelsea,19,2004,0.4,1,0,0,1,0,0,0,,0,0,0,0,0,1,1,0,Premier_League,2023_2024
Mario Lemina,GAB,MF,Wolves,29,1993,33.0,90,58,46,33,11,25,47,53.2,22,36,9,27,41,131,64,0,Premier_League,2023_2024
Clément Lenglet,FRA,DF,Aston Villa,28,1995,12.8,13,9,7,5,1,7,13,53.8,6,19,11,8,7,20,47,1,Premier_League,2023_2024
Bernd Leno,GER,GK,Fulham,31,1992,38.0,0,0,0,0,0,0,0,,0,0,0,0,0,0,14,1,Premier_League,2023_2024
Jefferson Lerma,COL,"MF,DF",Crystal Palace,28,1994,26.7,42,25,15,23,4,19,40,47.5,21,31,12,19,36,78,72,0,Premier_League,2023_2024
Rico Lewis,ENG,"DF,MF",Manchester City,18,2004,9.0,10,7,4,4,2,3,7,42.9,4,7,1,6,4,14,6,0,Premier_League,2023_2024
Keane Lewis-Potter,ENG,"FW,DF",Brentford,22,2001,16.0,17,7,5,11,1,7,15,46.7,8,10,2,8,7,24,23,0,Premier_League,2023_2024
Victor Lindelöf,SWE,DF,Manchester Utd,29,1994,14.8,15,10,8,7,0,5,13,38.5,8,18,9,9,12,27,40,1,Premier_League,2023_2024
Valentino Livramento,ENG,DF,Newcastle Utd,20,2002,14.6,23,13,15,6,2,10,21,47.6,11,16,7,9,25,48,41,1,Premier_League,2023_2024
Giovani Lo Celso,ARG,MF,Tottenham,27,1996,5.6,22,13,10,8,4,9,14,64.3,5,4,1,3,5,27,2,0,Premier_League,2023_2024
Tom Lockyer,WAL,DF,Luton Town,28,1994,13.0,25,16,17,6,2,15,22,68.2,7,23,13,10,23,48,68,0,Premier_League,2023_2024
Sean Longstaff,ENG,MF,Newcastle Utd,25,1997,30.5,54,30,17,29,8,24,63,38.1,39,43,7,36,17,71,23,0,Premier_League,2023_2024
Max Lowe,ENG,"DF,MF",Sheffield Utd,26,1997,5.6,21,10,13,5,3,8,15,53.3,7,10,4,6,5,26,15,0,Premier_League,2023_2024
Douglas Luiz,BRA,MF,Aston Villa,25,1998,33.3,58,38,21,27,10,25,53,47.2,28,32,8,24,23,81,18,2,Premier_League,2023_2024
Saša Lukić,SRB,MF,Fulham,26,1996,12.5,33,19,9,17,7,18,39,46.2,21,18,5,13,16,49,19,1,Premier_League,2023_2024
Ian Maatsen,NED,"FW,MF",Chelsea,21,2002,2.3,3,2,1,1,1,0,4,0.0,4,4,0,4,3,6,10,0,Premier_League,2023_2024
Alexis Mac Allister,ARG,MF,Liverpool,24,1998,28.9,99,55,35,50,14,59,125,47.2,66,65,8,57,35,134,25,1,Premier_League,2023_2024
James Maddison,ENG,MF,Tottenham,26,1996,23.7,33,19,5,18,10,15,29,51.7,14,15,3,12,13,46,10,1,Premier_League,2023_2024
Noni Madueke,ENG,FW,Chelsea,21,2002,11.7,16,10,8,4,4,11,34,32.4,23,11,0,11,4,20,14,0,Premier_League,2023_2024
Gabriel Magalhães,BRA,DF,Arsenal,25,1997,33.8,48,28,24,22,2,17,22,77.3,5,44,33,11,31,79,100,1,Premier_League,2023_2024
Harry Maguire,ENG,DF,Manchester Utd,30,1993,18.4,24,17,14,10,0,12,22,54.5,10,33,24,9,25,49,83,1,Premier_League,2023_2024
Kobbie Mainoo,ENG,MF,Manchester Utd,18,2005,21.4,47,27,20,16,11,21,45,46.7,24,20,12,8,22,69,30,1,Premier_League,2023_2024
Orel Mangala,BEL,MF,Nott'ham Forest,25,1998,17.4,27,13,16,10,1,14,29,48.3,15,12,6,6,26,53,32,0,Premier_League,2023_2024
Benson Manuel,ANG,"MF,FW",Burnley,26,1997,1.3,3,2,2,1,0,0,0,,0,1,0,1,0,3,0,0,Premier_League,2023_2024
Solly March,ENG,"FW,DF",Brighton,29,1994,6.2,19,14,9,7,3,8,14,57.1,6,5,0,5,11,30,8,0,Premier_League,2023_2024
Anthony Martial,FRA,FW,Manchester Utd,27,1995,5.0,4,1,1,1,2,1,1,100.0,0,4,0,4,0,4,3,0,Premier_League,2023_2024
Gabriel Martinelli,BRA,FW,Arsenal,22,2001,22.4,30,24,9,12,9,13,32,40.6,19,23,1,22,5,35,9,1,Premier_League,2023_2024
Emiliano Martínez,ARG,GK,Aston Villa,30,1992,33.5,0,0,0,0,0,0,0,,0,0,0,0,0,0,12,3,Premier_League,2023_2024
Lisandro Martínez,ARG,DF,Manchester Utd,25,1998,7.2,12,8,8,4,0,5,12,41.7,7,10,8,2,5,17,26,0,Premier_League,2023_2024
Han-Noah Massengo,FRA,"MF,DF",Burnley,22,2001,0.2,1,1,1,0,0,0,0,,0,1,0,1,0,1,0,0,Premier_League,2023_2024
Pape Matar Sarr,SEN,MF,Tottenham,20,2002,23.0,34,24,11,17,6,15,36,41.7,21,21,5,16,31,65,28,1,Premier_League,2023_2024
Jean-Philippe Mateta,FRA,FW,Crystal Palace,26,1997,25.4,22,15,4,11,7,6,10,60.0,4,13,4,9,4,26,14,0,Premier_League,2023_2024
Joël Matip,CMR,DF,Liverpool,31,1991,8.7,12,6,7,4,1,8,12,66.7,4,16,12,4,9,21,43,0,Premier_League,2023_2024
Alex Matos,ENG,MF,Chelsea,18,2004,0.0,0,0,0,0,0,0,0,,0,0,0,0,0,0,0,0,Premier_League,2023_2024
Remi Matthews,ENG,GK,Crystal Palace,29,1994,0.0,0,0,0,0,0,0,0,,0,0,0,0,0,0,1,0,Premier_League,2023_2024
Neal Maupay,FRA,FW,Brentford,26,1996,14.7,10,7,4,5,1,3,13,23.1,10,11,0,11,2,12,3,0,Premier_League,2023_2024
Neal Maupay,FRA,FW,Everton,26,1996,1.2,0,0,0,0,0,0,1,0.0,1,2,0,2,0,0,1,0,Premier_League,2023_2024
Konstantinos Mavropanos,GRE,DF,West Ham,25,1997,16.7,28,16,17,9,2,17,21,81.0,4,21,13,8,23,51,79,3,Premier_League,2023_2024
Bryan Mbeumo,CMR,FW,Brentford,23,1999,21.8,15,10,6,6,3,5,19,26.3,14,26,2,24,7,22,13,0,Premier_League,2023_2024
James Mcatee,ENG,"MF,FW",Sheffield Utd,20,2002,20.2,32,21,9,13,10,13,33,39.4,20,20,0,20,11,43,18,0,Premier_League,2023_2024
James Mcatee,ENG,MF,Manchester City,20,2002,0.0,0,0,0,0,0,0,0,,0,1,0,1,0,0,0,0,Premier_League,2023_2024
Oliver McBurnie,SCO,FW,Sheffield Utd,27,1996,14.2,17,7,4,7,6,5,12,41.7,7,18,2,16,5,22,28,0,Premier_League,2023_2024
James McConnell,ENG,MF,Liverpool,18,2004,0.0,0,0,0,0,0,0,0,,0,1,0,1,1,1,0,0,Premier_League,2023_2024
John McGinn,SCO,"MF,FW",Aston Villa,28,1994,33.3,59,35,18,34,7,32,77,41.6,45,33,4,29,21,80,21,0,Premier_League,2023_2024
Scott McKenna,SCO,DF,Nott'ham Forest,26,1996,4.6,4,0,3,1,0,2,3,66.7,1,6,4,2,5,9,27,0,Premier_League,2023_2024
Dwight McNeil,ENG,"MF,FW",Everton,23,1999,32.1,44,27,16,14,14,24,55,43.6,31,44,7,37,22,66,37,0,Premier_League,2023_2024
Scott McTominay,SCO,"MF,FW",Manchester Utd,26,1996,21.1,49,25,23,24,2,22,33,66.7,11,34,12,22,14,63,54,0,Premier_League,2023_2024
Ben Mee,ENG,DF,Brentford,33,1989,14.1,26,15,12,12,2,17,22,77.3,5,21,13,8,13,39,63,1,Premier_League,2023_2024
Hannibal Mejbri,TUN,"MF,FW",Manchester Utd,20,2003,1.5,3,3,1,2,0,1,3,33.3,2,1,1,0,0,3,0,0,Premier_League,2023_2024
Teden Mengi,ENG,DF,Luton Town,21,2002,27.4,54,22,33,20,1,19,30,63.3,11,39,27,12,57,111,140,1,Premier_League,2023_2024
Chris Mepham,WAL,DF,Bournemouth,25,1997,6.9,12,11,9,3,0,9,14,64.3,5,13,6,7,7,19,30,1,Premier_League,2023_2024
Lewis Miley,ENG,MF,Newcastle Utd,17,2006,13.4,33,21,6,20,7,15,32,46.9,17,20,3,17,8,41,18,2,Premier_League,2023_2024
James Milner,ENG,"DF,MF",Brighton,37,1986,8.6,20,14,9,10,1,9,14,64.3,5,9,0,9,8,28,16,0,Premier_League,2023_2024
Tyrone Mings,ENG,DF,Aston Villa,30,1993,0.3,0,0,0,0,0,0,0,,0,0,0,0,1,1,1,0,Premier_League,2023_2024
Tyrick Mitchell,ENG,"DF,MF",Crystal Palace,23,1999,35.6,105,60,75,21,9,43,60,71.7,17,63,10,53,26,131,104,0,Premier_League,2023_2024
Kaoru Mitoma,JPN,FW,Brighton,26,1997,16.5,13,6,3,7,3,5,19,26.3,14,15,1,14,5,18,12,0,Premier_League,2023_2024
Aleksandar Mitrović,SRB,FW,Fulham,28,1994,0.4,0,0,0,0,0,0,0,,0,0,0,0,0,0,0,0,Premier_League,2023_2024
Jakub Moder,POL,"MF,DF",Brighton,24,1999,6.9,19,10,9,5,5,9,18,50.0,9,8,2,6,2,21,12,0,Premier_League,2023_2024
Gonzalo Montiel,ARG,DF,Nott'ham Forest,26,1997,8.9,22,19,12,8,2,16,29,55.2,13,8,3,5,9,31,31,1,Premier_League,2023_2024
Kieffer Moore,WAL,"FW,MF",Bournemouth,30,1992,1.2,0,0,0,0,0,0,0,,0,0,0,0,0,0,0,0,Premier_League,2023_2024
Mikey Moore,ENG,MF,Tottenham,15,2007,0.0,0,0,0,0,0,0,0,,0,0,0,0,0,0,1,0,Premier_League,2023_2024
Álex Moreno,ESP,DF,Aston Villa,30,1993,11.5,18,12,18,0,0,12,19,63.2,7,11,2,9,13,31,37,0,Premier_League,2023_2024
Carlton Morris,ENG,"FW,MF",Luton Town,27,1995,31.8,15,8,4,6,5,9,15,60.0,6,24,5,19,1,16,53,0,Premier_League,2023_2024
Mason Mount,ENG,"MF,FW",Manchester Utd,24,1999,5.7,22,14,6,10,6,6,16,37.5,10,6,1,5,6,28,3,0,Premier_League,2023_2024
Divin Mubama,ENG,FW,West Ham,18,2004,0.9,0,0,0,0,0,0,0,,0,0,0,0,0,0,0,0,Premier_League,2023_2024
Mykhailo Mudryk,UKR,FW,Chelsea,22,2001,17.5,21,12,9,7,5,10,32,31.3,22,14,1,13,9,30,9,0,Premier_League,2023_2024
Rodrigo Muniz,BRA,FW,Fulham,22,2001,17.7,7,3,1,5,1,1,6,16.7,5,9,3,6,6,13,20,0,Premier_League,2023_2024
Daniel Muñoz,COL,"DF,MF",Crystal Palace,27,1996,16.0,55,35,31,14,10,19,38,50.0,19,29,7,22,24,79,47,0,Premier_League,2023_2024
Finley Munroe,ENG,MF,Aston Villa,18,2005,0.0,0,0,0,0,0,0,0,,0,0,0,0,0,0,0,0,Premier_League,2023_2024
Arijanet Muric,KVX,GK,Burnley,24,1998,10.0,1,1,1,0,0,1,1,100.0,0,0,0,0,0,1,10,4,Premier_League,2023_2024
Murillo,BRA,DF,Nott'ham Forest,21,2002,31.0,50,31,36,13,1,19,33,57.6,14,41,24,17,37,87,188,0,Premier_League,2023_2024
Alex Murphy,IRL,"DF,FW",Newcastle Utd,19,2004,0.1,1,1,0,1,0,1,2,50.0,1,1,0,1,1,2,0,0,Premier_League,2023_2024
Jacob Murphy,ENG,"FW,DF",Newcastle Utd,28,1995,13.2,20,10,8,4,8,12,26,46.2,14,17,0,17,6,26,16,0,Premier_League,2023_2024
Vitaliy Mykolenko,UKR,DF,Everton,24,1999,27.4,69,38,46,21,2,41,66,62.1,25,36,11,25,36,105,92,0,Premier_League,2023_2024
Marvelous Nakamba,ZIM,MF,Luton Town,29,1994,12.6,40,24,24,14,2,24,42,57.1,18,23,6,17,11,51,11,1,Premier_League,2023_2024
Michael Ndiweni,ENG,FW,Newcastle Utd,19,2003,0.0,0,0,0,0,0,0,0,,0,0,0,0,0,0,0,0,Premier_League,2023_2024
Reiss Nelson,ENG,FW,Arsenal,23,1999,3.0,9,6,5,1,3,8,10,80.0,2,5,1,4,1,10,5,0,Premier_League,2023_2024
Zack Nelson,ENG,"MF,DF",Luton Town,18,2004,0.1,1,0,1,0,0,0,0,,0,0,0,0,0,1,0,0,Premier_League,2023_2024
Neto,BRA,GK,Bournemouth,34,1989,32.0,0,0,0,0,0,0,0,,0,1,0,1,1,1,12,3,Premier_League,2023_2024
Pedro Neto,POR,"FW,MF",Wolves,23,2000,16.8,7,3,3,2,2,5,15,33.3,10,5,1,4,5,12,2,0,Premier_League,2023_2024
Moussa Niakhate,SEN,DF,Nott'ham Forest,27,1996,16.2,42,25,33,9,0,20,25,80.0,5,19,12,7,14,56,51,0,Premier_League,2023_2024
Eddie Nketiah,ENG,FW,Arsenal,24,1999,12.0,12,7,2,6,4,2,7,28.6,5,11,0,11,4,16,4,0,Premier_League,2023_2024
Christopher Nkunku,FRA,"FW,MF",Chelsea,25,1997,4.9,5,4,0,4,1,1,2,50.0,1,4,1,3,2,7,4,0,Premier_League,2023_2024
Rhys Norrington-Davies,WAL,DF,Sheffield Utd,24,1999,1.2,1,1,1,0,0,0,1,0.0,1,2,0,2,1,2,2,0,Premier_League,2023_2024
Oliver Norwood,NIR,MF,Sheffield Utd,32,1991,16.0,41,26,18,18,5,20,47,42.6,27,24,9,15,21,62,39,0,Premier_League,2023_2024
Matheus Nunes,POR,MF,Wolves,24,1998,2.0,3,1,3,0,0,2,6,33.3,4,0,0,0,6,9,1,0,Premier_League,2023_2024
Matheus Nunes,POR,MF,Manchester City,24,1998,7.3,10,4,1,7,2,5,16,31.3,11,7,1,6,1,11,8,1,Premier_League,2023_2024
Darwin Núñez,URU,FW,Liverpool,24,1999,22.7,22,12,2,10,10,11,23,47.8,12,18,6,12,3,25,9,0,Premier_League,2023_2024
Ethan Nwaneri,ENG,FW,Arsenal,16,2007,0.2,0,0,0,0,0,0,0,,0,1,0,1,0,0,0,0,Premier_League,2023_2024
Christian Nørgaard,DEN,MF,Brentford,29,1994,27.8,81,50,42,31,8,32,87,36.8,55,48,6,42,54,135,50,0,Premier_League,2023_2024
Mark O'Mahony,IRL,FW,Brighton,18,2005,0.7,1,0,1,0,0,1,2,50.0,1,2,1,1,0,1,1,0,Premier_League,2023_2024
Dara O'Shea,IRL,DF,Burnley,24,1999,32.1,39,20,22,14,3,11,26,42.3,15,41,30,11,35,74,158,2,Premier_League,2023_2024
Michael Obafemi,IRL,"FW,MF",Burnley,23,2000,0.2,0,0,0,0,0,0,0,,0,1,0,1,0,0,0,0,Premier_League,2023_2024
Wilson Odobert,FRA,"MF,FW",Burnley,18,2004,23.3,17,13,8,5,4,6,22,27.3,16,26,2,24,6,23,14,0,Premier_League,2023_2024
Odeluga Offiah,ENG,DF,Brighton,20,2002,1.4,1,0,1,0,0,1,1,100.0,0,0,0,0,1,2,0,0,Premier_League,2023_2024
Chiedozie Ogbene,IRL,"MF,DF",Luton Town,26,1997,22.2,17,10,10,7,0,12,22,54.5,10,14,3,11,7,24,34,2,Premier_League,2023_2024
Angelo Ogbonna,ITA,DF,West Ham,35,1988,7.1,11,5,9,2,0,6,7,85.7,1,13,10,3,3,14,29,0,Premier_League,2023_2024
Michael Olakigbe,ENG,"DF,FW",Brentford,19,2004,0.7,3,0,2,1,0,2,4,50.0,2,7,0,7,1,4,0,1,Premier_League,2023_2024
Michael Olise,FRA,"FW,MF",Crystal Palace,21,2001,14.2,19,10,7,10,2,8,24,33.3,16,21,0,21,11,30,9,0,Premier_League,2023_2024
Robin Olsen,SWE,GK,Aston Villa,33,1990,4.5,0,0,0,0,0,0,0,,0,0,0,0,0,0,1,0,Premier_League,2023_2024
Andrew Omobamidele,IRL,DF,Nott'ham Forest,21,2002,8.7,10,3,9,1,0,5,8,62.5,3,12,8,4,13,23,42,1,Premier_League,2023_2024
Amadou Onana,BEL,MF,Everton,21,2001,23.2,71,38,32,31,8,21,42,50.0,21,25,6,19,21,92,31,0,Premier_League,2023_2024
André Onana,CMR,GK,Manchester Utd,27,1996,38.0,2,0,2,0,0,2,2,100.0,0,0,0,0,0,2,11,2,Premier_League,2023_2024
Ryan One,SCO,FW,Sheffield Utd,17,2006,0.1,0,0,0,0,0,0,0,,0,0,0,0,0,0,0,0,Premier_League,2023_2024
Tyler Onyango,ENG,MF,Everton,20,2003,0.0,0,0,0,0,0,0,0,,0,0,0,0,0,0,0,0,Premier_League,2023_2024
Fred Onyedinma,ENG,"DF,MF",Luton Town,26,1996,4.5,10,6,7,3,0,5,12,41.7,7,3,0,3,1,11,13,0,Premier_League,2023_2024
Frank Onyeka,NGA,MF,Brentford,25,1998,12.9,37,24,9,23,5,16,29,55.2,13,15,7,8,23,60,17,0,Premier_League,2023_2024
Divock Origi,BEL,FW,Nott'ham Forest,28,1995,6.7,6,4,5,0,1,0,0,,0,6,0,6,2,8,4,0,Premier_League,2023_2024
Stefan Ortega,GER,GK,Manchester City,30,1992,7.1,0,0,0,0,0,0,0,,0,0,0,0,0,0,2,1,Premier_League,2023_2024
Ben Osborn,ENG,"DF,MF",Sheffield Utd,28,1994,15.2,22,9,11,9,2,8,17,47.1,9,18,2,16,8,30,30,0,Premier_League,2023_2024
Gabriel Osho,NGA,DF,Luton Town,24,1998,20.5,41,22,21,19,1,16,27,59.3,11,37,20,17,31,72,92,0,Premier_League,2023_2024
William Osula,DEN,FW,Sheffield Utd,19,2003,8.7,2,2,1,0,1,1,2,50.0,1,3,1,2,2,4,9,0,Premier_League,2023_2024
Dango Ouattara,BFA,"FW,DF",Bournemouth,21,2002,13.7,45,27,22,11,12,19,34,55.9,15,18,3,15,22,67,35,0,Premier_League,2023_2024
David Ozoh,ENG,"MF,DF",Crystal Palace,18,2005,1.7,10,6,3,6,1,5,6,83.3,1,2,0,2,0,10,2,0,Premier_League,2023_2024
João Palhinha,POR,MF,Fulham,28,1995,30.0,152,75,80,60,12,103,152,67.8,49,57,9,48,46,198,58,0,Premier_League,2023_2024
Cole Palmer,ENG,"FW,MF",Chelsea,21,2002,29.0,23,12,9,6,8,8,19,42.1,11,20,2,18,20,43,13,2,Premier_League,2023_2024
Cole Palmer,ENG,MF,Manchester City,21,2002,0.1,0,0,0,0,0,0,0,,0,0,0,0,0,0,0,0,Premier_League,2023_2024
Emerson Palmieri,ITA,DF,West Ham,28,1994,34.9,106,68,48,42,16,57,90,63.3,33,47,15,32,43,149,96,0,Premier_League,2023_2024
Lucas Paquetá,BRA,"FW,MF",West Ham,25,1997,29.1,71,48,38,26,7,25,52,48.1,27,28,1,27,21,92,28,2,Premier_League,2023_2024
Ben Parkinson,ENG,FW,Newcastle Utd,18,2005,0.3,0,0,0,0,0,0,0,,0,1,0,1,0,0,1,0,Premier_League,2023_2024
Thomas Partey,GHA,"MF,DF",Arsenal,30,1993,8.8,14,11,9,4,1,5,10,50.0,5,9,3,6,11,25,9,0,Premier_League,2023_2024
Nathan Patterson,SCO,DF,Everton,21,2001,11.2,34,24,21,11,2,14,37,37.8,23,14,3,11,9,43,33,0,Premier_League,2023_2024
Myles Peart-Harris,ENG,"DF,MF",Brentford,20,2002,0.1,0,0,0,0,0,0,0,,0,0,0,0,0,0,1,0,Premier_League,2023_2024
Sydie Peck,ENG,MF,Sheffield Utd,18,2004,0.1,0,0,0,0,0,0,0,,0,0,0,0,0,0,0,0,Premier_League,2023_2024
Facundo Pellistri,URU,"FW,MF",Manchester Utd,21,2001,1.9,5,3,4,1,0,1,3,33.3,2,7,1,6,1,6,5,0,Premier_League,2023_2024
Andreas Pereira,BRA,MF,Fulham,27,1996,29.0,25,12,4,12,9,11,41,26.8,30,16,2,14,4,29,12,0,Premier_League,2023_2024
Ivan Perišić,CRO,FW,Tottenham,34,1989,1.1,3,2,1,1,1,3,5,60.0,2,1,0,1,2,5,1,0,Premier_League,2023_2024
Đorđe Petrović,SRB,GK,Chelsea,23,1999,22.1,0,0,0,0,0,0,0,,0,0,0,0,0,0,12,3,Premier_League,2023_2024
Kalvin Phillips,ENG,MF,West Ham,27,1995,3.4,11,6,2,8,1,5,9,55.6,4,4,1,3,4,15,2,1,Premier_League,2023_2024
Kalvin Phillips,ENG,MF,Manchester City,27,1995,1.0,3,3,1,1,1,0,0,,0,0,0,0,2,5,2,0,Premier_League,2023_2024
Jaden Philogene Bidace,ENG,FW,Aston Villa,21,2002,0.0,0,0,0,0,0,0,0,,0,0,0,0,0,0,0,0,Premier_League,2023_2024
Jordan Pickford,ENG,GK,Everton,29,1994,38.0,1,0,1,0,0,1,1,100.0,0,3,0,3,0,1,19,1,Premier_League,2023_2024
Ethan Pinnock,JAM,DF,Brentford,30,1993,28.0,35,23,22,13,0,9,20,45.0,11,40,24,16,43,78,170,3,Premier_League,2023_2024
Nick Pope,ENG,GK,Newcastle Utd,31,1992,14.9,0,0,0,0,0,0,1,0.0,1,0,0,0,0,0,7,2,Premier_League,2023_2024
Pedro Porro,ESP,DF,Tottenham,23,1999,34.3,91,63,43,34,14,62,120,51.7,58,63,18,45,34,125,102,3,Premier_League,2023_2024
Jarell Quansah,ENG,DF,Liverpool,20,2003,13.2,25,22,17,7,1,14,20,70.0,6,16,8,8,17,42,39,1,Premier_League,2023_2024
Ionuț Radu,ROU,GK,Bournemouth,26,1997,2.0,0,0,0,0,0,0,0,,0,0,0,0,0,0,0,0,Premier_League,2023_2024
Jesurun Rak Sakyi,ENG,"MF,FW",Crystal Palace,20,2002,1.5,4,1,3,1,0,2,3,66.7,1,2,0,2,3,7,1,0,Premier_League,2023_2024
Aaron Ramsdale,ENG,GK,Arsenal,25,1998,6.0,0,0,0,0,0,0,0,,0,0,0,0,0,0,3,2,Premier_League,2023_2024
Aaron Ramsey,ENG,"MF,FW",Burnley,20,2003,5.9,17,14,7,5,5,8,16,50.0,8,11,2,9,1,18,10,0,Premier_League,2023_2024
Jacob Ramsey,ENG,"FW,MF",Aston Villa,22,2001,9.5,16,8,7,6,3,5,15,33.3,10,15,2,13,3,19,8,0,Premier_League,2023_2024
Marcus Rashford,ENG,FW,Manchester Utd,25,1997,25.2,19,12,9,4,6,9,26,34.6,17,15,1,14,4,23,21,0,Premier_League,2023_2024
David Raya,ESP,GK,Arsenal,27,1995,32.0,1,1,1,0,0,1,1,100.0,0,0,0,0,0,1,8,5,Premier_League,2023_2024
Tim Ream,USA,DF,Fulham,35,1987,16.7,20,9,13,5,2,9,18,50.0,9,23,15,8,25,45,61,2,Premier_League,2023_2024
Nathan Redmond,ENG,"FW,MF",Burnley,29,1994,1.6,2,1,0,0,2,1,4,25.0,3,1,0,1,0,2,3,0,Premier_League,2023_2024
Harrison Reed,ENG,MF,Fulham,28,1995,14.7,29,18,9,17,3,13,31,41.9,18,19,9,10,11,40,24,0,Premier_League,2023_2024
Sergio Reguilón,ESP,DF,Manchester Utd,26,1996,4.6,13,8,6,2,5,8,17,47.1,9,10,0,10,5,18,7,0,Premier_League,2023_2024
Sergio Reguilón,ESP,DF,Brentford,26,1996,12.4,45,20,26,18,1,24,40,60.0,16,23,6,17,16,61,41,1,Premier_League,2023_2024
Bobby Reid,JAM,FW,Fulham,30,1993,15.8,22,14,5,15,2,4,16,25.0,12,24,2,22,5,27,14,0,Premier_League,2023_2024
Gio Reyna,USA,"FW,MF",Nott'ham Forest,20,2002,2.6,7,3,4,0,3,3,6,50.0,3,3,0,3,2,9,0,0,Premier_League,2023_2024
Rodrigo Ribeiro,POR,"MF,FW",Nott'ham Forest,18,2005,0.2,0,0,0,0,0,0,1,0.0,1,1,0,1,1,1,0,0,Premier_League,2023_2024
Declan Rice,ENG,MF,Arsenal,24,1999,35.8,83,51,37,38,8,32,57,56.1,25,37,11,26,44,127,52,0,Premier_League,2023_2024
Chris Richards,USA,"DF,MF",Crystal Palace,23,2000,23.3,46,28,21,22,3,20,30,66.7,10,32,12,20,27,73,109,0,Premier_League,2023_2024
Richarlison,BRA,FW,Tottenham,26,1997,16.6,16,11,4,8,4,2,10,20.0,8,32,6,26,8,24,23,0,Premier_League,2023_2024
Jaïro Riedewald,NED,"MF,FW",Crystal Palace,26,1996,2.6,9,3,2,4,3,3,6,50.0,3,0,0,0,2,11,2,0,Premier_League,2023_2024
Matt Ritchie,SCO,"FW,MF",Newcastle Utd,33,1989,1.4,5,3,2,2,1,2,4,50.0,2,3,2,1,1,6,5,0,Premier_League,2023_2024
Connor Roberts,WAL,DF,Burnley,27,1995,9.1,12,5,6,4,2,8,17,47.1,9,8,6,2,4,16,25,2,Premier_League,2023_2024
Andrew Robertson,SCO,DF,Liverpool,29,1994,18.8,35,24,21,11,3,26,43,60.5,17,20,6,14,13,48,40,0,Premier_League,2023_2024
Antonee Robinson,USA,DF,Fulham,25,1997,36.3,93,58,60,26,7,52,110,47.3,58,56,8,48,80,173,117,3,Premier_League,2023_2024
Jack Robinson,ENG,DF,Sheffield Utd,29,1993,32.1,43,28,29,14,0,25,39,64.1,14,49,33,16,33,76,132,2,Premier_League,2023_2024
Rodri,ESP,MF,Manchester City,27,1996,32.6,70,43,25,33,12,29,60,48.3,31,32,8,24,26,96,41,4,Premier_League,2023_2024
Jay Rodriguez,ENG,FW,Burnley,34,1989,9.1,14,9,7,4,3,7,13,53.8,6,11,1,10,1,15,8,0,Premier_League,2023_2024
Mads Roerslev,DEN,DF,Brentford,24,1999,22.1,48,31,34,9,5,27,54,50.0,27,15,3,12,19,67,71,0,Premier_League,2023_2024
Morgan Rogers,ENG,"MF,FW",Aston Villa,21,2002,7.1,8,1,3,2,3,2,11,18.2,9,11,0,11,3,11,11,0,Premier_League,2023_2024
Cristian Romero,ARG,DF,Tottenham,25,1998,31.0,66,40,35,25,6,32,44,72.7,12,46,22,24,44,110,106,1,Premier_League,2023_2024
Joe Rothwell,ENG,MF,Bournemouth,28,1995,4.3,7,2,4,2,1,2,8,25.0,6,4,2,2,3,10,2,0,Premier_League,2023_2024
Pelly Ruddock Mpanzu,COD,MF,Luton Town,30,1993,12.2,13,5,6,6,1,5,9,55.6,4,15,7,8,9,22,16,3,Premier_League,2023_2024
José Sá,POR,GK,Wolves,30,1993,33.7,0,0,0,0,0,0,1,0.0,1,3,0,3,0,0,21,5,Premier_League,2023_2024
Dominic Sadi,ENG,FW,Bournemouth,19,2003,0.0,0,0,0,0,0,0,0,,0,0,0,0,0,0,0,0,Premier_League,2023_2024
Bukayo Saka,ENG,FW,Arsenal,21,2001,32.4,66,35,22,24,20,26,59,44.1,33,43,2,41,15,81,24,1,Premier_League,2023_2024
Mohamed Salah,EGY,FW,Liverpool,31,1992,28.2,17,11,1,8,8,6,21,28.6,15,19,1,18,2,19,1,0,Premier_League,2023_2024
William Saliba,FRA,DF,Arsenal,22,2001,38.0,41,26,28,12,1,20,27,74.1,7,32,17,15,29,70,81,3,Premier_League,2023_2024
Albert Sambi Lokonga,BEL,MF,Luton Town,23,1999,14.5,29,18,14,12,3,17,24,70.8,7,23,13,10,11,40,14,0,Premier_League,2023_2024
Davinson Sánchez,COL,DF,Tottenham,27,1996,0.9,0,0,0,0,0,0,0,,0,3,2,1,1,1,2,0,Premier_League,2023_2024
Robert Sánchez,ESP,GK,Chelsea,25,1997,15.9,0,0,0,0,0,0,0,,0,0,0,0,0,0,11,3,Premier_League,2023_2024
Jadon Sancho,ENG,"FW,MF",Manchester Utd,23,2000,0.9,1,0,1,0,0,1,3,33.3,2,1,0,1,1,2,0,0,Premier_League,2023_2024
Ibrahim Sangaré,CIV,MF,Nott'ham Forest,25,1997,11.5,42,23,25,13,4,12,29,41.4,17,24,7,17,16,58,21,0,Premier_League,2023_2024
Andrey Santos,BRA,MF,Nott'ham Forest,19,2004,0.1,0,0,0,0,0,0,0,,0,1,0,1,0,0,0,0,Premier_League,2023_2024
Pablo Sarabia,ESP,"MF,FW",Wolves,31,1992,19.4,20,13,8,8,4,12,36,33.3,24,17,1,16,10,30,9,0,Premier_League,2023_2024
Dane Scarlett,ENG,FW,Tottenham,19,2004,0.2,1,1,0,0,1,0,1,0.0,1,0,0,0,0,1,0,0,Premier_League,2023_2024
Kevin Schade,GER,"FW,MF",Brentford,21,2001,3.7,3,1,1,2,0,0,5,0.0,5,2,0,2,1,4,4,0,Premier_League,2023_2024
Fabian Schär,SUI,DF,Newcastle Utd,31,1991,33.9,42,24,27,13,2,18,40,45.0,22,50,38,12,36,78,133,1,Premier_League,2023_2024
Jeffrey Schlupp,GHA,"FW,MF",Crystal Palace,30,1992,15.0,38,24,14,16,8,9,18,50.0,9,13,2,11,8,46,24,0,Premier_League,2023_2024
Alex Scott,ENG,MF,Bournemouth,19,2003,11.3,24,15,8,10,6,12,28,42.9,16,14,4,10,12,36,18,2,Premier_League,2023_2024
Matz Sels,BEL,GK,Nott'ham Forest,31,1992,16.0,0,0,0,0,0,0,0,,0,0,0,0,0,0,11,1,Premier_League,2023_2024
Nélson Semedo,POR,"DF,MF",Wolves,29,1993,34.3,79,48,52,19,8,38,64,59.4,26,44,8,36,36,115,85,1,Premier_League,2023_2024
Antoine Semenyo,GHA,FW,Bournemouth,23,2000,23.4,24,17,7,9,8,9,27,33.3,18,39,2,37,6,30,21,0,Premier_League,2023_2024
Marcos Senesi,ARG,DF,Bournemouth,26,1997,24.9,55,32,28,23,4,24,56,42.9,32,50,23,27,35,90,109,1,Premier_League,2023_2024
Luke Shaw,ENG,DF,Manchester Utd,28,1995,10.7,11,8,7,3,1,9,15,60.0,6,18,11,7,6,17,39,0,Premier_League,2023_2024
James Shea,ENG,GK,Luton Town,32,1991,0.2,0,0,0,0,0,0,0,,0,0,0,0,0,0,2,0,Premier_League,2023_2024
Bernardo Silva,POR,"MF,FW",Manchester City,28,1994,28.6,51,23,13,25,13,25,57,43.9,32,32,4,28,17,68,15,1,Premier_League,2023_2024
Fábio Silva,POR,FW,Wolves,21,2002,2.9,7,4,3,4,0,2,3,66.7,1,1,0,1,2,9,0,0,Premier_League,2023_2024
Thiago Silva,BRA,DF,Chelsea,38,1984,28.1,29,15,22,6,1,20,34,58.8,14,33,24,9,26,55,153,4,Premier_League,2023_2024
Luis Sinisterra,COL,"FW,MF",Bournemouth,24,1999,7.8,23,12,9,10,4,9,16,56.3,7,18,0,18,8,31,4,0,Premier_League,2023_2024
Oliver Skipp,ENG,"MF,DF",Tottenham,22,2000,7.9,18,12,9,6,3,11,18,61.1,7,12,1,11,3,21,9,0,Premier_League,2023_2024
Adam Smith,ENG,DF,Bournemouth,32,1991,23.9,37,23,18,11,8,19,39,48.7,20,28,11,17,21,58,62,0,Premier_League,2023_2024
Emile Smith Rowe,ENG,MF,Arsenal,23,2000,3.9,4,1,2,2,0,2,4,50.0,2,3,1,2,3,7,1,0,Premier_League,2023_2024
Cédric Soares,POR,DF,Arsenal,31,1991,0.7,0,0,0,0,0,0,0,,0,0,0,0,0,0,0,0,Premier_League,2023_2024
Dominic Solanke,ENG,FW,Bournemouth,25,1997,36.9,23,11,3,13,7,10,29,34.5,19,24,5,19,7,30,43,0,Premier_League,2023_2024
Manor Solomon,ISR,FW,Tottenham,24,1999,2.2,3,3,1,1,1,1,2,50.0,1,4,0,4,3,6,2,0,Premier_League,2023_2024
Tomáš Souček,CZE,MF,West Ham,28,1995,31.9,53,35,24,26,3,21,47,44.7,26,55,28,27,37,90,109,0,Premier_League,2023_2024
Vinicius Souza,BRA,MF,Sheffield Utd,24,1999,29.6,125,76,59,51,15,41,74,55.4,33,57,17,40,32,157,75,1,Premier_League,2023_2024
Jason Steele,ENG,GK,Brighton,32,1990,17.0,0,0,0,0,0,0,3,0.0,3,0,0,0,0,0,8,1,Premier_League,2023_2024
Raheem Sterling,ENG,"FW,MF",Chelsea,28,1994,22.0,21,10,7,8,6,12,26,46.2,14,13,0,13,13,34,9,1,Premier_League,2023_2024
John Stones,ENG,"DF,MF",Manchester City,29,1994,11.8,2,1,1,0,1,0,3,0.0,3,11,7,4,10,12,21,0,Premier_League,2023_2024
Thomas Strakosha,ALB,GK,Brentford,28,1995,1.5,0,0,0,0,0,0,0,,0,0,0,0,0,0,0,0,Premier_League,2023_2024
Dominik Szoboszlai,HUN,MF,Liverpool,22,2000,23.4,32,19,12,12,8,16,50,32.0,34,37,2,35,15,47,16,1,Premier_League,2023_2024
Matt Targett,ENG,DF,Newcastle Utd,27,1995,0.9,2,0,1,1,0,1,1,100.0,0,1,0,1,0,2,2,0,Premier_League,2023_2024
James Tarkowski,ENG,DF,Everton,30,1992,38.0,61,42,46,14,1,27,48,56.3,21,82,56,26,56,117,191,2,Premier_League,2023_2024
Jimi Tauriainen,ENG,FW,Chelsea,19,2004,0.0,0,0,0,0,0,0,0,,0,0,0,0,0,0,0,0,Premier_League,2023_2024
Nuno Tavares,POR,DF,Nott'ham Forest,23,2000,5.1,11,7,9,1,1,8,9,88.9,1,6,0,6,1,12,21,0,Premier_League,2023_2024
Marcus Tavernier,ENG,FW,Bournemouth,24,1999,23.5,53,34,25,22,6,26,48,54.2,22,31,3,28,5,58,23,0,Premier_League,2023_2024
Charlie Taylor,ENG,DF,Burnley,29,1993,25.9,35,20,19,14,2,17,35,48.6,18,27,11,16,19,54,78,0,Premier_League,2023_2024
Kenny Tete,NED,DF,Fulham,27,1995,9.6,27,17,19,6,2,11,19,57.9,8,10,3,7,16,43,35,0,Premier_League,2023_2024
Luke Thomas,ENG,DF,Sheffield Utd,22,2001,10.2,20,9,13,6,1,8,14,57.1,6,23,5,18,10,30,27,0,Premier_League,2023_2024
Youri Tielemans,BEL,"MF,FW",Aston Villa,26,1997,18.0,41,20,17,18,6,16,40,40.0,24,23,3,20,15,56,9,0,Premier_League,2023_2024
Jurriën Timber,NED,DF,Arsenal,22,2001,0.8,2,2,1,1,0,0,0,,0,1,0,1,0,2,1,0,Premier_League,2023_2024
Harry Toffolo,ENG,DF,Nott'ham Forest,27,1995,16.2,26,14,20,6,0,15,24,62.5,9,34,13,21,14,40,49,0,Premier_League,2023_2024
Takehiro Tomiyasu,JPN,DF,Arsenal,24,1998,12.8,20,9,15,4,1,11,18,61.1,7,10,4,6,18,38,33,0,Premier_League,2023_2024
James Tomkins,ENG,DF,Crystal Palace,34,1989,0.1,0,0,0,0,0,0,0,,0,0,0,0,1,1,0,0,Premier_League,2023_2024
Sandro Tonali,ITA,MF,Newcastle Utd,23,2000,4.9,7,7,4,2,1,3,9,33.3,6,3,0,3,2,9,4,0,Premier_League,2023_2024
Ivan Toney,ENG,FW,Brentford,27,1996,16.1,15,5,2,7,6,6,14,42.9,8,5,1,4,10,25,18,0,Premier_League,2023_2024
Pau Torres,ESP,DF,Aston Villa,26,1997,27.4,29,18,17,11,1,14,30,46.7,16,28,12,16,14,43,75,0,Premier_League,2023_2024
Andros Townsend,ENG,"MF,FW",Luton Town,32,1991,13.4,21,13,11,2,8,13,27,48.1,14,12,0,12,5,26,10,0,Premier_League,2023_2024
James Trafford,ENG,GK,Burnley,20,2002,28.0,2,1,2,0,0,2,2,100.0,0,0,0,0,1,3,18,1,Premier_League,2023_2024
Adama Traoré,ESP,"FW,MF",Fulham,27,1996,4.2,4,3,1,2,1,3,6,50.0,3,2,0,2,1,5,2,0,Premier_League,2023_2024
Bénie Traoré,CIV,"FW,MF",Sheffield Utd,20,2002,4.3,4,2,1,2,1,0,4,0.0,4,4,1,3,1,5,1,0,Premier_League,2023_2024
Bertrand Traoré,BFA,"DF,FW",Aston Villa,27,1995,0.1,1,1,1,0,0,0,0,,0,0,0,0,0,1,1,0,Premier_League,2023_2024
Boubacar Traoré,MLI,MF,Wolves,21,2001,9.1,35,23,16,17,2,9,21,42.9,12,12,2,10,5,40,7,0,Premier_League,2023_2024
Mark Travers,IRL,GK,Bournemouth,24,1999,4.0,0,0,0,0,0,0,0,,0,0,0,0,0,0,2,0,Premier_League,2023_2024
Mike Trésor,BEL,"FW,MF",Burnley,24,1999,4.7,10,6,9,1,0,8,18,44.4,10,5,0,5,1,11,1,0,Premier_League,2023_2024
Kieran Trippier,ENG,DF,Newcastle Utd,32,1990,24.8,57,27,30,16,11,37,77,48.1,40,41,8,33,24,81,57,3,Premier_League,2023_2024
Leandro Trossard,BEL,"FW,MF",Arsenal,28,1994,18.3,27,16,8,9,10,9,25,36.0,16,27,1,26,8,35,6,0,Premier_League,2023_2024
Auston Trusty,USA,DF,Sheffield Utd,24,1998,28.6,47,30,31,13,3,21,43,48.8,22,41,22,19,35,82,153,3,Premier_League,2023_2024
Kostas Tsimikas,GRE,DF,Liverpool,27,1996,7.5,19,13,9,6,4,9,15,60.0,6,9,1,8,6,25,10,0,Premier_League,2023_2024
Matt Turner,USA,GK,Nott'ham Forest,29,1994,17.0,0,0,0,0,0,0,0,,0,0,0,0,0,0,8,4,Premier_League,2023_2024
Destiny Udogie,ITA,DF,Tottenham,20,2002,26.6,68,33,41,16,11,27,49,55.1,22,27,8,19,37,105,80,5,Premier_League,2023_2024
Lesley Ugochukwu,FRA,MF,Chelsea,19,2004,3.3,14,10,4,8,2,4,10,40.0,6,6,2,4,1,15,5,0,Premier_League,2023_2024
Enes Ünal,TUR,"FW,MF",Bournemouth,26,1997,3.6,6,4,2,3,1,2,5,40.0,3,4,2,2,1,7,6,0,Premier_League,2023_2024
Virgil van Dijk,NED,DF,Liverpool,32,1991,35.3,40,23,24,13,3,12,14,85.7,2,47,34,13,39,79,144,0,Premier_League,2023_2024
Raphaël Varane,FRA,DF,Manchester Utd,30,1993,15.3,18,11,10,7,1,10,14,71.4,4,23,18,5,15,33,88,0,Premier_League,2023_2024
Alejo Véliz,ARG,FW,Tottenham,19,2003,0.6,1,0,1,0,0,0,0,,0,0,0,0,0,1,0,0,Premier_League,2023_2024
Joël Veltman,NED,DF,Brighton,31,1992,17.6,54,41,32,17,5,39,58,67.2,19,17,7,10,18,72,57,1,Premier_League,2023_2024
Micky van de Ven,NED,DF,Tottenham,22,2001,26.0,49,35,34,12,3,24,33,72.7,9,25,15,10,18,67,78,1,Premier_League,2023_2024
Bart Verbruggen,NED,GK,Brighton,20,2002,21.0,1,1,1,0,0,1,2,50.0,1,0,0,0,0,1,11,3,Premier_League,2023_2024
Guglielmo Vicario,ITA,GK,Tottenham,26,1996,38.0,0,0,0,0,0,0,1,0.0,1,0,0,0,1,1,31,2,Premier_League,2023_2024
Fabio Vieira,POR,"MF,FW",Arsenal,23,2000,3.3,3,2,2,0,1,3,3,100.0,0,0,0,0,2,5,2,0,Premier_League,2023_2024
Carlos Vinícius,BRA,FW,Fulham,28,1995,3.5,3,2,0,1,2,0,4,0.0,4,4,0,4,0,3,1,0,Premier_League,2023_2024
Vitinho,BRA,"DF,MF",Burnley,24,1999,25.7,64,34,36,22,6,43,86,50.0,43,44,6,38,12,76,47,4,Premier_League,2023_2024
Odisseas Vlachodimos,GRE,GK,Nott'ham Forest,29,1994,5.0,0,0,0,0,0,0,1,0.0,1,0,0,0,0,0,1,0,Premier_League,2023_2024
Kyle Walker,ENG,DF,Manchester City,33,1990,30.7,38,24,19,17,2,19,39,48.7,20,19,6,13,27,65,40,1,Premier_League,2023_2024
Aaron Wan-Bissaka,ENG,DF,Manchester Utd,25,1997,19.8,42,25,18,20,4,19,26,73.1,7,29,15,14,41,83,68,1,Premier_League,2023_2024
Joel Ward,ENG,DF,Crystal Palace,33,1989,22.0,45,28,26,18,1,30,47,63.8,17,17,10,7,14,59,94,1,Premier_League,2023_2024
James Ward-Prowse,ENG,MF,West Ham,28,1994,33.3,45,29,14,23,8,18,44,40.9,26,31,9,22,38,83,49,0,Premier_League,2023_2024
Lewis Warrington,ENG,FW,Everton,20,2002,0.0,0,0,0,0,0,0,0,,0,0,0,0,0,0,0,0,Premier_League,2023_2024
Deivid Washington,BRA,"DF,FW",Chelsea,18,2005,0.1,1,1,1,0,0,0,1,0.0,1,0,0,0,0,1,0,0,Premier_League,2023_2024
Ollie Watkins,ENG,FW,Aston Villa,27,1995,35.7,12,7,0,5,7,5,11,45.5,6,26,4,22,4,16,20,0,Premier_League,2023_2024
Adam Webster,ENG,DF,Brighton,28,1995,12.7,14,12,8,5,1,6,18,33.3,12,16,12,4,16,30,43,1,Premier_League,2023_2024
Danny Welbeck,ENG,"FW,MF",Brighton,32,1990,18.8,35,17,9,17,9,10,17,58.8,7,12,0,12,9,44,17,1,Premier_League,2023_2024
Timo Werner,GER,FW,Tottenham,27,1996,9.0,7,4,3,4,0,5,18,27.8,13,12,0,12,3,10,2,0,Premier_League,2023_2024
Adam Wharton,ENG,MF,Crystal Palace,19,2004,14.4,48,32,18,22,8,23,46,50.0,23,17,3,14,20,68,24,1,Premier_League,2023_2024
Ethan Wheatley,ENG,FW,Manchester Utd,17,2006,0.2,1,1,0,1,0,1,1,100.0,0,2,0,2,2,3,0,0,Premier_League,2023_2024
Ben White,ENG,DF,Arsenal,25,1997,33.2,48,28,20,22,6,26,58,44.8,32,48,22,26,32,80,77,1,Premier_League,2023_2024
Joe White,ENG,MF,Newcastle Utd,20,2002,0.1,1,1,1,0,0,0,0,,0,0,0,0,0,1,0,0,Premier_League,2023_2024
Neco Williams,WAL,DF,Nott'ham Forest,22,2001,18.2,69,40,42,18,9,35,56,62.5,21,44,13,31,22,91,53,0,Premier_League,2023_2024
Willian,BRA,FW,Fulham,34,1988,22.8,18,11,6,7,5,3,21,14.3,18,13,0,13,9,27,12,1,Premier_League,2023_2024
Joe Willock,ENG,MF,Newcastle Utd,23,1999,4.7,13,7,7,6,0,4,11,36.4,7,7,0,7,1,14,1,0,Premier_League,2023_2024
Callum Wilson,ENG,FW,Newcastle Utd,31,1992,11.0,5,3,0,2,3,0,4,0.0,4,6,0,6,2,7,4,0,Premier_League,2023_2024
Harry Wilson,WAL,FW,Fulham,26,1997,18.0,21,14,9,8,4,11,28,39.3,17,27,3,24,10,31,12,0,Premier_League,2023_2024
Yoane Wissa,COD,FW,Brentford,26,1996,27.7,28,16,13,10,5,5,20,25.0,15,24,3,21,9,37,15,0,Premier_League,2023_2024
Chris Wood,NZL,FW,Nott'ham Forest,31,1991,20.1,7,4,1,4,2,3,9,33.3,6,11,3,8,1,8,26,0,Premier_League,2023_2024
Cauley Woodrow,ENG,"FW,MF",Luton Town,28,1994,4.7,16,10,8,4,4,9,16,56.3,7,7,1,6,1,17,14,0,Premier_League,2023_2024
Joe Worrall,ENG,DF,Nott'ham Forest,26,1997,4.9,7,5,6,1,0,3,6,50.0,3,5,4,1,3,10,32,1,Premier_League,2023_2024
Yehor Yarmoliuk,UKR,MF,Brentford,19,2004,7.6,17,11,6,8,3,7,17,41.2,10,17,4,13,6,23,5,0,Premier_League,2023_2024
Ryan Yates,ENG,MF,Nott'ham Forest,25,1997,22.1,66,39,39,21,6,19,34,55.9,15,42,15,27,21,87,44,1,Premier_League,2023_2024
Ashley Young,ENG,"DF,MF",Everton,38,1985,25.3,53,38,28,19,6,30,54,55.6,24,24,6,18,22,75,50,3,Premier_League,2023_2024
Illia Zabarnyi,UKR,DF,Bournemouth,20,2002,37.0,59,32,29,29,1,23,50,46.0,27,53,34,19,33,92,143,4,Premier_League,2023_2024
Nicolò Zaniolo,ITA,"FW,MF",Aston Villa,24,1999,9.3,19,9,10,7,2,9,17,52.9,8,13,0,13,1,20,11,0,Premier_League,2023_2024
Anass Zaroury,MAR,"FW,MF",Burnley,22,2000,1.7,1,0,1,0,0,0,4,0.0,4,2,0,2,0,1,1,1,Premier_League,2023_2024
Oleksandr Zinchenko,UKR,DF,Arsenal,26,1996,19.1,50,30,19,24,7,35,52,67.3,17,18,3,15,20,70,26,2,Premier_League,2023_2024
Kurt Zouma,FRA,DF,West Ham,28,1994,31.5,23,17,14,9,0,10,16,62.5,6,38,28,10,29,52,160,0,Premier_League,2023_2024
Martin Ødegaard,NOR,MF,Arsenal,24,1998,34.3,49,17,18,21,10,17,58,29.3,41,23,1,22,15,64,5,0,Premier_League,2023_2024
Luis Abram,PER,DF,Granada,25,1996,6.2,6,3,3,3,0,2,4,50.0,2,6,5,1,5,11,37,1,La_Liga,2021_2022
Marcos Acuña,ARG,DF,Sevilla,29,1991,25.1,50,29,27,14,9,30,46,65.2,16,22,5,17,14,64,25,1,La_Liga,2021_2022
Martin Agirregabiria,ESP,DF,Alavés,25,1996,18.0,34,22,17,11,6,18,37,48.6,19,20,3,17,25,59,38,0,La_Liga,2021_2022
Julen Agirrezabala,ESP,GK,Athletic Club,20,2000,4.0,0,0,0,0,0,0,0,,0,0,0,0,0,0,2,0,La_Liga,2021_2022
Sergio Agüero,ARG,FW,Barcelona,33,1988,1.7,1,1,0,0,1,0,2,0.0,2,0,0,0,0,1,0,0,La_Liga,2021_2022
Álvaro Aguirre,ESP,FW,Rayo Vallecano,21,2000,0.1,0,0,0,0,0,0,0,,0,0,0,0,0,0,0,0,La_Liga,2021_2022
Joseph Aidoo,GHA,DF,Celta Vigo,25,1995,29.3,39,26,28,10,1,17,31,54.8,14,23,13,10,38,77,96,3,La_Liga,2021_2022
Carlos Akapo,EQG,DF,Cádiz,28,1993,20.5,43,31,26,15,2,21,37,56.8,16,26,7,19,51,94,61,0,La_Liga,2021_2022
Ilias Akhomach,MAR,FW,Barcelona,17,2004,1.4,2,0,0,1,1,0,0,,0,0,0,0,0,2,0,0,La_Liga,2021_2022
Paul Akouokou,CIV,MF,Betis,23,1997,5.7,14,9,5,7,2,8,12,66.7,4,6,0,6,11,25,6,0,La_Liga,2021_2022
David Alaba,AUT,DF,Real Madrid,29,1992,29.4,23,13,15,6,2,9,19,47.4,10,26,15,11,22,45,70,1,La_Liga,2021_2022
Tomás Alarcón,CHI,MF,Cádiz,22,1999,15.8,31,20,17,10,4,10,31,32.3,21,19,7,12,30,61,31,0,La_Liga,2021_2022
Jordi Alba,ESP,DF,Barcelona,32,1989,29.4,47,34,12,26,9,27,47,57.4,20,26,6,20,33,80,41,1,La_Liga,2021_2022
Raúl Albiol,ESP,DF,Villarreal,35,1985,27.4,26,15,20,5,1,14,18,77.8,4,24,15,9,21,47,126,1,La_Liga,2021_2022
Paco Alcácer,ESP,FW,Villarreal,27,1993,8.7,9,3,2,4,3,1,5,20.0,4,7,0,7,6,15,1,0,La_Liga,2021_2022
Rubén Alcaraz,ESP,MF,Cádiz,30,1991,12.3,41,20,14,24,3,22,45,48.9,23,10,2,8,13,54,14,0,La_Liga,2021_2022
Omar Alderete,PAR,DF,Valencia,24,1996,26.7,53,34,34,17,2,34,53,64.2,19,30,18,12,35,88,153,0,La_Liga,2021_2022
Iván Alejo,ESP,"MF,FW",Cádiz,26,1995,11.8,33,15,21,10,2,15,44,34.1,29,12,0,12,8,41,17,0,La_Liga,2021_2022
Carles Aleñá,ESP,MF,Getafe,23,1998,25.8,27,19,11,13,3,9,48,18.8,39,21,2,19,15,42,16,0,La_Liga,2021_2022
Hugo Álvarez,ESP,FW,Celta Vigo,18,2003,0.1,1,0,1,0,0,0,0,,0,0,0,0,0,1,1,0,La_Liga,2021_2022
Yeray Álvarez,ESP,DF,Athletic Club,26,1995,20.7,24,14,15,8,1,10,18,55.6,8,21,16,5,45,69,97,0,La_Liga,2021_2022
Dani Alves,BRA,DF,Barcelona,38,1983,12.2,30,19,13,13,4,14,26,53.8,12,10,3,7,11,41,10,2,La_Liga,2021_2022
Emmanuel Amankwaa Akurugu,GHA,DF,Getafe,19,2001,0.9,0,0,0,0,0,0,2,0.0,2,1,0,1,0,0,0,0,La_Liga,2021_2022
Amath,SEN,"FW,MF",Mallorca,25,1996,9.8,21,11,11,6,4,7,17,41.2,10,12,0,12,7,28,7,0,La_Liga,2021_2022
Florin Andone,ROU,FW,Cádiz,28,1993,2.0,1,1,1,0,0,0,1,0.0,1,2,0,2,0,1,1,0,La_Liga,2021_2022
Marcos André,BRA,"FW,MF",Valencia,24,1996,10.8,15,11,4,6,5,5,16,31.3,11,15,0,15,7,22,13,0,La_Liga,2021_2022
José Ángel,ESP,DF,Osasuna,31,1989,12.0,20,13,9,9,2,9,14,64.3,5,6,1,5,10,30,21,0,La_Liga,2021_2022
Josep Antoni Gayá,ESP,DF,Mallorca,21,2000,0.6,0,0,0,0,0,0,0,,0,1,0,1,1,1,3,1,La_Liga,2021_2022
Mauro Arambarri,URU,MF,Getafe,25,1995,29.6,62,37,19,32,11,20,68,29.4,48,35,5,30,32,94,18,0,La_Liga,2021_2022
Néstor Araujo,MEX,DF,Celta Vigo,29,1991,29.1,22,14,17,5,0,9,21,42.9,12,17,10,7,27,49,105,2,La_Liga,2021_2022
Ronald Araújo,URU,DF,Barcelona,22,1999,25.2,41,23,29,12,0,21,25,84.0,4,37,20,17,23,64,66,1,La_Liga,2021_2022
Jesús Areso,ESP,DF,Osasuna,22,1999,2.1,3,3,2,1,0,0,2,0.0,2,0,0,0,0,3,2,1,La_Liga,2021_2022
Matias Arezo,URU,"FW,MF",Granada,18,2002,1.8,5,3,2,1,2,4,9,44.4,5,1,0,1,1,6,1,0,La_Liga,2021_2022
Santiago Arias,COL,DF,Granada,29,1992,4.9,12,5,8,3,1,4,9,44.4,5,8,4,4,5,17,10,0,La_Liga,2021_2022
Santiago Arzamendia,PAR,MF,Cádiz,23,1998,5.2,14,6,6,5,3,6,13,46.2,7,6,0,6,4,18,7,0,La_Liga,2021_2022
Sergio Asenjo,ESP,GK,Villarreal,32,1989,6.0,0,0,0,0,0,0,1,0.0,1,0,0,0,1,1,6,0,La_Liga,2021_2022
Alejandro Asensio,ESP,FW,Rayo Vallecano,20,2000,0.1,0,0,0,0,0,0,0,,0,0,0,0,0,0,0,0,La_Liga,2021_2022
Marco Asensio,ESP,"FW,MF",Real Madrid,25,1996,19.2,12,8,6,4,2,4,18,22.2,14,8,1,7,12,24,6,1,La_Liga,2021_2022
Iago Aspas,ESP,FW,Celta Vigo,33,1987,34.3,14,7,1,5,8,4,24,16.7,20,23,2,21,11,25,19,0,La_Liga,2021_2022
Pierre-Emerick Aubameyang,GAB,FW,Barcelona,32,1989,12.0,2,2,0,1,1,0,5,0.0,5,9,1,8,2,4,4,0,La_Liga,2021_2022
Ludwig Augustinsson,SWE,"DF,FW",Sevilla,27,1994,8.8,18,14,11,3,4,8,13,61.5,5,10,3,7,5,23,21,0,La_Liga,2021_2022
Serge Aurier,CIV,DF,Villarreal,28,1992,11.2,14,9,11,2,1,4,7,57.1,3,14,7,7,11,25,25,0,La_Liga,2021_2022
Ezequiel Ávila,ARG,"FW,MF",Osasuna,27,1994,20.8,17,7,6,7,4,7,21,33.3,14,14,2,12,13,30,15,1,La_Liga,2021_2022
Iddrisu Baba,GHA,MF,Mallorca,25,1996,21.5,57,30,31,23,3,25,43,58.1,18,19,5,14,24,81,34,1,La_Liga,2021_2022
Carlos Bacca,COL,FW,Granada,34,1986,5.7,4,4,2,0,2,0,3,0.0,3,5,0,5,1,5,5,0,La_Liga,2021_2022
Édgar Badía,ESP,GK,Elche,29,1992,24.0,0,0,0,0,0,0,0,,0,0,0,0,0,0,16,2,La_Liga,2021_2022
Miguel Baeza,ESP,DF,Celta Vigo,21,2000,0.0,0,0,0,0,0,0,0,,0,0,0,0,0,0,0,0,La_Liga,2021_2022
Alejandro Balde,ESP,"DF,FW",Barcelona,17,2003,2.1,2,1,1,0,1,0,0,,0,2,2,0,1,3,1,0,La_Liga,2021_2022
Gareth Bale,WAL,FW,Real Madrid,32,1989,3.1,2,1,1,0,1,1,4,25.0,3,2,0,2,2,4,1,0,La_Liga,2021_2022
Mikel Balenziaga,ESP,DF,Athletic Club,33,1988,22.5,33,24,15,15,3,25,43,58.1,18,27,4,23,21,54,79,0,La_Liga,2021_2022
Iván Balliu,ALB,DF,Rayo Vallecano,29,1992,35.0,45,22,25,11,9,19,31,61.3,12,24,5,19,39,84,64,0,La_Liga,2021_2022
Barbero,ESP,"FW,MF",Osasuna,22,1998,0.2,0,0,0,0,0,0,0,,0,0,0,0,0,0,1,0,La_Liga,2021_2022
Barcia,ESP,DF,Granada,20,2000,0.8,0,0,0,0,0,0,0,,0,1,1,0,1,1,0,1,La_Liga,2021_2022
Enis Bardhi,MKD,"MF,FW",Levante,26,1995,18.9,29,12,12,14,3,12,35,34.3,23,13,2,11,10,39,7,0,La_Liga,2021_2022
Keidi Bare,ALB,MF,Espanyol,23,1997,16.5,27,17,14,12,1,11,31,35.5,20,20,10,10,15,42,26,1,La_Liga,2021_2022
Kike Barja,ESP,"MF,FW",Osasuna,24,1997,9.6,15,11,4,7,4,8,22,36.4,14,10,1,9,9,24,4,0,La_Liga,2021_2022
Antonio Barragán,ESP,DF,Elche,34,1987,11.3,21,14,13,7,1,11,17,64.7,6,5,3,2,17,38,34,0,La_Liga,2021_2022
Ander Barrenetxea,ESP,"FW,MF",Real Sociedad,19,2001,6.1,15,10,9,6,0,8,18,44.4,10,7,0,7,2,17,2,0,La_Liga,2021_2022
Marc Bartra,ESP,DF,Betis,30,1991,22.1,39,14,18,17,4,19,35,54.3,16,39,22,17,33,72,105,1,La_Liga,2021_2022
Álvaro Bastida,ESP,MF,Cádiz,17,2004,2.2,7,4,2,4,1,4,5,80.0,1,1,0,1,3,10,1,0,La_Liga,2021_2022
Rodrigo Battaglia,ARG,MF,Mallorca,30,1991,13.1,32,16,13,19,0,15,30,50.0,15,21,10,11,10,42,36,0,La_Liga,2021_2022
Jon Bautista,ESP,MF,Real Sociedad,26,1995,0.5,3,0,0,3,0,0,1,0.0,1,1,0,1,1,4,1,0,La_Liga,2021_2022
Bebé,CPV,FW,Rayo Vallecano,31,1990,9.6,6,5,1,3,2,4,16,25.0,12,18,0,18,3,9,6,0,La_Liga,2021_2022
Héctor Bellerín,ESP,DF,Betis,26,1995,22.0,52,32,29,20,3,31,44,70.5,13,11,2,9,23,75,57,1,La_Liga,2021_2022
Fran Beltrán,ESP,MF,Celta Vigo,22,1999,28.9,56,41,27,23,6,28,68,41.2,40,29,5,24,32,88,39,0,La_Liga,2021_2022
Darío Benedetto,ARG,"FW,MF",Elche,31,1990,6.6,5,1,2,2,1,3,6,50.0,3,4,0,4,1,6,1,0,La_Liga,2021_2022
Iker Benito,ESP,"FW,MF",Osasuna,18,2002,1.3,2,1,1,0,1,0,1,0.0,1,2,0,2,0,2,2,0,La_Liga,2021_2022
Pedro Benito,ESP,FW,Cádiz,21,2000,0.3,0,0,0,0,0,0,1,0.0,1,0,0,0,0,0,0,0,La_Liga,2021_2022
Karim Benzema,FRA,FW,Real Madrid,33,1987,28.8,11,9,5,3,3,2,9,22.2,7,10,0,10,4,15,13,0,La_Liga,2021_2022
Yuri Berchiche,ESP,DF,Athletic Club,31,1990,11.3,25,11,10,11,4,7,14,50.0,7,19,6,13,13,38,25,0,La_Liga,2021_2022
Álex Berenguer,ESP,MF,Athletic Club,26,1995,24.1,45,26,23,14,8,11,51,21.6,40,40,2,38,16,61,20,0,La_Liga,2021_2022
Pedro Bigas,ESP,DF,Elche,30,1990,17.2,24,10,16,8,0,9,20,45.0,11,21,16,5,18,42,77,1,La_Liga,2021_2022
Antonio Blanco,ESP,MF,Real Madrid,21,2000,0.3,2,0,1,1,0,0,0,,0,1,1,0,1,3,0,0,La_Liga,2021_2022
Yassine Bounou,MAR,GK,Sevilla,30,1991,31.0,0,0,0,0,0,0,0,,0,0,0,0,0,0,11,1,La_Liga,2021_2022
Lucas Boyé,ARG,FW,Elche,25,1996,19.0,27,13,5,15,7,9,24,37.5,15,24,1,23,2,29,23,0,La_Liga,2021_2022
Martin Braithwaite,DEN,FW,Barcelona,30,1991,2.6,1,1,0,0,1,0,0,,0,2,0,2,1,2,1,0,La_Liga,2021_2022
Darko Brašanac,SRB,MF,Osasuna,29,1992,26.7,35,22,19,14,2,14,40,35.0,26,25,8,17,25,60,15,0,La_Liga,2021_2022
Claudio Bravo,CHI,GK,Betis,38,1983,16.2,0,0,0,0,0,0,0,,0,0,0,0,0,0,6,2,La_Liga,2021_2022
Yan Brice Eteki,CMR,MF,Granada,23,1997,3.8,6,3,3,2,1,3,7,42.9,4,7,3,4,4,10,6,1,La_Liga,2021_2022
Ante Budimir,CRO,FW,Osasuna,30,1991,19.3,24,10,3,15,6,6,19,31.6,13,22,4,18,3,27,16,0,La_Liga,2021_2022
Sergio Busquets,ESP,MF,Barcelona,33,1988,35.5,93,49,31,48,14,46,83,55.4,37,44,8,36,45,138,31,0,La_Liga,2021_2022
Adrián Butzke,ESP,FW,Granada,22,1999,0.0,0,0,0,0,0,0,0,,0,0,0,0,0,0,0,0,La_Liga,2021_2022
Erick Cabaco,URU,DF,Getafe,26,1995,4.5,2,1,1,1,0,2,5,40.0,3,5,2,3,4,6,10,0,La_Liga,2021_2022
Leandro Cabrera,URU,DF,Espanyol,30,1991,37.0,37,24,27,10,0,21,34,61.8,13,32,23,9,44,81,222,2,La_Liga,2021_2022
Martín Cáceres,URU,DF,Levante,34,1987,7.4,2,2,2,0,0,1,5,20.0,4,2,2,0,11,13,16,1,La_Liga,2021_2022
Cala,ESP,DF,Cádiz,31,1989,10.5,9,4,9,0,0,8,17,47.1,9,12,6,6,12,21,56,0,La_Liga,2021_2022
Calderón,ESP,DF,Betis,21,2000,0.7,2,0,1,0,1,1,3,33.3,2,0,0,0,0,2,2,0,La_Liga,2021_2022
Fernando Calero,ESP,DF,Espanyol,25,1995,12.1,17,10,12,5,0,8,13,61.5,5,7,2,5,16,33,63,1,La_Liga,2021_2022
Víctor Camarasa,ESP,"MF,FW",Betis,27,1994,1.2,2,1,1,1,0,0,1,0.0,1,2,1,1,2,4,2,0,La_Liga,2021_2022
Eduardo Camavinga,FRA,MF,Real Madrid,18,2002,13.7,52,35,22,20,10,20,38,52.6,18,20,2,18,17,69,14,1,La_Liga,2021_2022
José Campaña,ESP,MF,Levante,28,1993,15.8,27,16,13,10,4,12,32,37.5,20,13,2,11,21,48,19,1,La_Liga,2021_2022
Sergio Canales,ESP,"FW,MF",Betis,30,1991,31.0,24,14,8,12,4,10,35,28.6,25,16,1,15,10,34,12,0,La_Liga,2021_2022
Álex Cantero,ESP,"FW,MF",Levante,21,2000,6.8,6,4,2,3,1,1,8,12.5,7,2,0,2,1,7,0,0,La_Liga,2021_2022
Ander Capa,ESP,DF,Athletic Club,29,1992,0.0,0,0,0,0,0,0,0,,0,0,0,0,0,0,0,0,La_Liga,2021_2022
Étienne Capoue,FRA,MF,Villarreal,33,1988,25.4,44,26,18,23,3,15,28,53.6,13,17,5,12,35,79,51,0,La_Liga,2021_2022
Isaac Carcelen,ESP,"DF,MF",Cádiz,28,1993,17.2,43,29,29,12,2,28,56,50.0,28,25,6,19,34,77,42,0,La_Liga,2021_2022
Cárdenas,ESP,GK,Levante,24,1997,24.0,1,1,1,0,0,0,3,0.0,3,0,0,0,1,2,19,0,La_Liga,2021_2022
Carlo,ESP,MF,Villarreal,20,2001,0.1,0,0,0,0,0,0,0,,0,0,0,0,0,0,0,0,La_Liga,2021_2022
Diego Carlos,BRA,DF,Sevilla,28,1993,32.9,35,24,20,13,2,16,24,66.7,8,48,33,15,24,59,120,5,La_Liga,2021_2022
Carmona,ESP,DF,Sevilla,19,2002,0.3,0,0,0,0,0,0,0,,0,0,0,0,1,1,0,0,La_Liga,2021_2022
Yannick Carrasco,BEL,"FW,MF",Atlético Madrid,27,1993,28.7,34,19,16,12,6,19,44,43.2,25,26,5,21,19,53,12,2,La_Liga,2021_2022
Guido Carrillo,ARG,FW,Elche,30,1991,13.0,7,4,2,4,1,3,13,23.1,10,9,2,7,1,8,27,0,La_Liga,2021_2022
Dani Carvajal,ESP,DF,Real Madrid,29,1992,17.2,43,28,21,15,7,15,26,57.7,11,22,8,14,20,63,38,2,La_Liga,2021_2022
William Carvalho,POR,MF,Betis,29,1992,20.1,49,33,20,25,4,15,40,37.5,25,18,7,11,16,65,20,0,La_Liga,2021_2022
Casemiro,BRA,MF,Real Madrid,29,1992,28.5,79,51,45,30,4,30,67,44.8,37,65,19,46,38,117,65,3,La_Liga,2021_2022
Kiko Casilla,ESP,GK,Elche,34,1986,14.0,0,0,0,0,0,0,1,0.0,1,0,0,0,1,1,2,2,La_Liga,2021_2022
Catena,ESP,DF,Rayo Vallecano,26,1994,36.0,39,23,24,15,0,25,42,59.5,17,26,19,7,30,69,168,3,La_Liga,2021_2022
Dani Ceballos,ESP,MF,Real Madrid,24,1996,3.1,7,5,4,3,0,1,5,20.0,4,8,2,6,4,11,2,0,La_Liga,2021_2022
Franco Cervi,ARG,MF,Celta Vigo,27,1994,20.0,73,41,35,22,16,33,77,42.9,44,38,2,36,21,94,19,0,La_Liga,2021_2022
Chapela,ESP,"MF,FW",Cádiz,22,1999,4.4,4,2,1,0,3,2,4,50.0,2,6,1,5,4,8,5,0,La_Liga,2021_2022
Chema,ESP,MF,Getafe,29,1992,0.5,0,0,0,0,0,0,1,0.0,1,0,0,0,0,0,0,0,La_Liga,2021_2022
Denis Cheryshev,RUS,"MF,FW",Valencia,30,1990,6.3,14,5,6,1,7,6,15,40.0,9,9,1,8,9,23,9,0,La_Liga,2021_2022
Samuel Chukwueze,NGA,"MF,FW",Villarreal,22,1999,14.8,13,9,6,5,2,3,6,50.0,3,7,0,7,5,18,4,0,La_Liga,2021_2022
Víctor Chust,ESP,DF,Cádiz,21,2000,20.3,19,10,14,4,1,11,17,64.7,6,20,8,12,16,35,87,0,La_Liga,2021_2022
Jasper Cillessen,NED,GK,Valencia,32,1989,16.2,0,0,0,0,0,0,1,0.0,1,0,0,0,1,1,6,0,La_Liga,2021_2022
Pathé Ciss,SEN,MF,Rayo Vallecano,27,1994,12.2,31,15,20,8,3,12,26,46.2,14,16,6,10,30,61,27,0,La_Liga,2021_2022
Carlos Clerc,ESP,DF,Levante,29,1992,16.8,35,17,21,10,4,7,19,36.8,12,8,3,5,26,61,32,1,La_Liga,2021_2022
Coke,ESP,DF,Levante,34,1987,1.3,3,2,1,1,1,3,4,75.0,1,1,0,1,2,5,7,0,La_Liga,2021_2022
Álex Collado,ESP,"MF,FW",Granada,22,1999,11.3,27,12,6,16,5,12,31,38.7,19,28,2,26,6,33,11,0,La_Liga,2021_2022
Eray Cömert,SUI,DF,Valencia,23,1998,4.5,5,3,4,1,0,3,6,50.0,3,3,2,1,2,7,6,0,La_Liga,2021_2022
Santi Comesaña,ESP,MF,Rayo Vallecano,24,1996,29.8,87,56,45,33,9,40,104,38.5,64,46,6,40,33,120,30,0,La_Liga,2021_2022
Diego Conde,ESP,GK,Getafe,22,1998,0.1,0,0,0,0,0,0,0,,0,0,0,0,0,0,0,0,La_Liga,2021_2022
Francis Coquelin,FRA,MF,Villarreal,30,1991,9.2,26,17,9,11,6,11,20,55.0,9,15,5,10,19,45,11,0,La_Liga,2021_2022
Jesús Corona,MEX,"FW,DF",Sevilla,28,1993,12.9,12,7,7,5,0,3,6,50.0,3,4,0,4,8,20,6,0,La_Liga,2021_2022
Ángel Correa,ARG,"FW,MF",Atlético Madrid,26,1995,20.6,16,8,5,10,1,7,29,24.1,22,25,2,23,10,26,4,0,La_Liga,2021_2022
Thierry Correia,POR,DF,Valencia,22,1999,15.7,35,23,26,6,3,14,29,48.3,15,20,5,15,19,54,27,0,La_Liga,2021_2022
Hélder Costa,ANG,"MF,FW",Valencia,27,1994,12.4,27,16,11,9,7,14,41,34.1,27,12,1,11,3,30,9,0,La_Liga,2021_2022
Jaume Costa,ESP,DF,Mallorca,33,1988,20.3,35,26,23,7,5,23,31,74.2,8,22,7,15,23,58,55,0,La_Liga,2021_2022
Thibaut Courtois,BEL,GK,Real Madrid,29,1992,36.0,1,0,1,0,0,1,2,50.0,1,0,0,0,0,1,9,1,La_Liga,2021_2022
Philippe Coutinho,BRA,"MF,FW",Barcelona,29,1992,5.6,6,3,3,3,0,3,11,27.3,8,3,0,3,4,10,3,0,La_Liga,2021_2022
Cristo,ESP,DF,Real Sociedad,21,2000,0.2,0,0,0,0,0,0,0,,0,0,0,0,0,0,0,0,La_Liga,2021_2022
Juan Cruz Armada,ESP,DF,Osasuna,29,1992,21.5,28,21,15,12,1,8,16,50.0,8,15,12,3,16,44,58,1,La_Liga,2021_2022
Marc Cucurella,ESP,"MF,DF",Getafe,23,1998,0.3,0,0,0,0,0,0,0,,0,0,0,0,0,0,0,0,La_Liga,2021_2022
Jorge Cuenca,ESP,DF,Getafe,21,1999,29.8,46,32,30,15,1,21,28,75.0,7,29,14,15,39,85,155,0,La_Liga,2021_2022
Matheus Cunha,BRA,FW,Atlético Madrid,22,1999,11.8,19,12,3,11,5,5,20,25.0,15,18,2,16,6,25,9,0,La_Liga,2021_2022
Arnaut Danjuma,NED,FW,Villarreal,24,1997,16.4,7,6,3,0,4,2,4,50.0,2,5,0,5,2,9,3,0,La_Liga,2021_2022
Sergi Darder,ESP,MF,Espanyol,27,1993,34.7,45,22,16,19,10,18,54,33.3,36,16,1,15,26,71,32,1,La_Liga,2021_2022
Rodrigo De Paul,ARG,MF,Atlético Madrid,27,1994,23.9,55,30,22,25,8,30,60,50.0,30,24,3,21,21,76,17,2,La_Liga,2021_2022
Thomas Delaney,DEN,MF,Sevilla,29,1991,17.2,41,24,17,21,3,16,30,53.3,14,19,10,9,13,54,35,0,La_Liga,2021_2022
Ousmane Dembélé,FRA,FW,Barcelona,24,1997,15.7,24,16,6,10,8,7,23,30.4,16,8,0,8,8,32,3,0,La_Liga,2021_2022
Yusuf Demir,AUT,FW,Barcelona,18,2003,2.1,3,1,1,1,1,2,5,40.0,3,1,0,1,2,5,1,0,La_Liga,2021_2022
Sergiño Dest,USA,"DF,FW",Barcelona,20,2000,16.8,32,15,21,10,1,13,18,72.2,5,22,4,18,2,34,18,0,La_Liga,2021_2022
Boulaye Dia,SEN,FW,Villarreal,24,1996,14.1,8,6,3,4,1,2,5,40.0,3,6,1,5,5,13,4,0,La_Liga,2021_2022
Mouctar Diakhaby,GUI,DF,Valencia,24,1996,21.6,35,24,18,15,2,13,23,56.5,10,29,17,12,30,65,87,3,La_Liga,2021_2022
Javier Díaz,ESP,GK,Sevilla,24,1997,1.0,0,0,0,0,0,0,0,,0,0,0,0,0,0,0,0,La_Liga,2021_2022
Víctor Díaz,ESP,DF,Granada,33,1988,16.7,23,15,14,9,0,12,25,48.0,13,19,11,8,17,40,71,1,La_Liga,2021_2022
Landry Dimata,BEL,"FW,MF",Espanyol,23,1997,6.0,2,2,1,1,0,1,4,25.0,3,0,0,0,1,3,7,0,La_Liga,2021_2022
Stole Dimitrievski,MKD,GK,Rayo Vallecano,27,1993,30.8,0,0,0,0,0,0,0,,0,0,0,0,1,1,14,3,La_Liga,2021_2022
Matías Dituro,ARG,GK,Celta Vigo,34,1987,38.0,0,0,0,0,0,0,0,,0,0,0,0,0,0,10,5,La_Liga,2021_2022
Djené,TOG,DF,Getafe,29,1991,34.6,44,26,24,16,4,23,34,67.6,11,24,5,19,59,103,109,2,La_Liga,2021_2022
Naïs Djouahra,FRA,"FW,MF",Real Sociedad,21,1999,2.4,7,3,2,2,3,4,8,50.0,4,3,0,3,2,9,2,0,La_Liga,2021_2022
Marko Dmitrović,SRB,GK,Sevilla,29,1992,6.0,0,0,0,0,0,0,0,,0,0,0,0,0,0,3,1,La_Liga,2021_2022
Jaume Doménech,ESP,GK,Valencia,30,1990,3.8,0,0,0,0,0,0,0,,0,0,0,0,0,0,3,1,La_Liga,2021_2022
Carlos Dominguez,ESP,DF,Celta Vigo,20,2001,3.8,4,1,4,0,0,4,6,66.7,2,2,1,1,4,8,21,0,La_Liga,2021_2022
Mario Dominguez,ESP,FW,Valencia,17,2004,0.3,0,0,0,0,0,0,0,,0,0,0,0,0,0,1,0,La_Liga,2021_2022
John Donald,ESP,DF,Elche,20,2000,2.0,7,4,4,2,1,5,8,62.5,3,5,3,2,3,10,3,0,La_Liga,2021_2022
Domingos Duarte,POR,DF,Granada,26,1995,18.7,18,14,9,9,0,6,11,54.5,5,27,20,7,22,40,82,0,La_Liga,2021_2022
Óscar Duarte,CRC,DF,Levante,32,1989,19.7,18,8,12,6,0,8,23,34.8,15,18,9,9,24,42,102,0,La_Liga,2021_2022
Rubén Duarte,ESP,DF,Alavés,25,1995,29.1,76,47,43,27,6,43,85,50.6,42,40,6,34,57,133,82,0,La_Liga,2021_2022
Unai Dufur,ESP,DF,Osasuna,22,1999,1.0,0,0,0,0,0,0,0,,0,1,0,1,4,4,4,0,La_Liga,2021_2022
Hugo Duro,ESP,"DF,MF",Getafe,21,1999,0.1,0,0,0,0,0,0,0,,0,0,0,0,0,0,0,0,La_Liga,2021_2022
Hugo Duro,ESP,"FW,MF",Valencia,21,1999,20.4,25,19,11,13,1,15,38,39.5,23,24,2,22,4,29,20,1,La_Liga,2021_2022
Aritz Elustondo,ESP,DF,Real Sociedad,27,1994,23.4,21,14,16,5,0,10,20,50.0,10,19,13,6,29,50,86,0,La_Liga,2021_2022
Adri Embarba,ESP,"FW,MF",Espanyol,29,1992,22.1,44,29,22,15,7,26,69,37.7,43,35,3,32,19,63,30,0,La_Liga,2021_2022
Emerson,BRA,DF,Barcelona,22,1999,1.0,3,3,2,1,0,1,2,50.0,1,1,0,1,2,5,1,0,La_Liga,2021_2022
Youssef En-Nesyri,MAR,FW,Sevilla,24,1997,14.2,10,5,5,2,3,4,11,36.4,7,9,1,8,4,14,18,0,La_Liga,2021_2022
Gonzalo Escalante,ARG,MF,Alavés,28,1993,14.4,30,14,9,20,1,13,34,38.2,21,27,2,25,21,51,28,0,La_Liga,2021_2022
Aarón Escandell,ESP,GK,Granada,25,1995,3.2,0,0,0,0,0,0,1,0.0,1,0,0,0,0,0,4,0,La_Liga,2021_2022
Sergio Escudero,ESP,"DF,MF",Granada,31,1989,15.9,46,24,25,17,4,26,54,48.1,28,18,3,15,26,72,35,0,La_Liga,2021_2022
Alfonso Espino,URU,DF,Cádiz,29,1992,37.0,107,63,58,39,10,44,112,39.3,68,45,10,35,54,161,87,1,La_Liga,2021_2022
Estanis,ESP,FW,Barcelona,17,2003,0.1,1,1,0,1,0,1,1,100.0,0,0,0,0,0,1,0,0,La_Liga,2021_2022
Pervis Estupiñán,ECU,DF,Villarreal,23,1998,17.5,36,22,20,11,5,17,24,70.8,7,13,5,8,25,61,29,2,La_Liga,2021_2022
Abde Ezzalzouli,MAR,FW,Barcelona,19,2001,6.4,17,9,9,5,3,5,8,62.5,3,3,0,3,9,26,0,0,La_Liga,2021_2022
Radamel Falcao,COL,FW,Rayo Vallecano,35,1986,9.3,2,1,0,1,1,1,4,25.0,3,4,1,3,2,4,11,0,La_Liga,2021_2022
Fali,ESP,"DF,MF",Cádiz,27,1993,20.0,32,19,24,8,0,17,32,53.1,15,26,16,10,24,56,82,0,La_Liga,2021_2022
Omar Faraj,PLE,FW,Levante,19,2002,0.0,1,0,1,0,0,1,1,100.0,0,0,0,0,0,1,0,0,La_Liga,2021_2022
Ansu Fati,ESP,FW,Barcelona,18,2002,3.7,3,2,0,2,1,1,1,100.0,0,4,0,4,1,4,0,0,La_Liga,2021_2022
Aleix Febas,ESP,MF,Mallorca,25,1996,1.3,4,1,0,4,0,2,4,50.0,2,0,0,0,0,4,0,0,La_Liga,2021_2022
Peter Federico,DOM,"MF,DF",Real Madrid,19,2002,0.3,0,0,0,0,0,0,0,,0,0,0,0,1,1,0,0,La_Liga,2021_2022
Nabil Fekir,FRA,MF,Betis,28,1993,31.0,43,29,5,25,13,7,36,19.4,29,14,0,14,7,50,7,0,La_Liga,2021_2022
Felipe,BRA,DF,Atlético Madrid,32,1989,16.7,20,15,11,8,1,8,18,44.4,10,17,11,6,28,48,77,0,La_Liga,2021_2022
João Félix,POR,"FW,MF",Atlético Madrid,21,1999,14.0,5,2,1,4,0,1,5,20.0,4,4,1,3,7,12,8,0,La_Liga,2021_2022
Aitor Fernández,ESP,GK,Levante,30,1991,13.0,2,1,2,0,0,2,2,100.0,0,0,0,0,0,2,7,0,La_Liga,2021_2022
Álex Fernández,ESP,MF,Cádiz,28,1992,22.8,47,31,22,17,8,21,61,34.4,40,30,7,23,30,77,31,0,La_Liga,2021_2022
Fernando,BRA,"MF,DF",Sevilla,34,1987,20.6,24,17,14,9,1,12,33,36.4,21,21,13,8,29,53,32,2,La_Liga,2021_2022
Fidel,ESP,MF,Elche,31,1989,25.1,44,23,18,17,9,14,57,24.6,43,9,1,8,7,51,20,0,La_Liga,2021_2022
José Fontán,ESP,DF,Celta Vigo,21,2000,3.1,5,3,3,2,0,1,5,20.0,4,3,1,2,10,15,10,0,La_Liga,2021_2022
Dimitri Foulquier,FRA,DF,Granada,28,1993,2.0,0,0,0,0,0,0,1,0.0,1,2,1,1,1,1,2,0,La_Liga,2021_2022
Dimitri Foulquier,FRA,DF,Valencia,28,1993,26.0,36,17,17,15,4,21,34,61.8,13,19,3,16,29,65,49,0,La_Liga,2021_2022
Juan Foyth,ARG,DF,Villarreal,23,1998,21.4,69,49,35,28,6,35,47,74.5,12,29,7,22,20,89,50,0,La_Liga,2021_2022
Enric Franquesa,ESP,"DF,FW",Levante,24,1997,6.9,5,3,4,0,1,0,1,0.0,1,4,0,4,7,12,11,0,La_Liga,2021_2022
Jorge de Frutos,ESP,"MF,FW",Levante,24,1997,19.6,33,15,14,11,8,10,51,19.6,41,11,1,10,12,45,13,0,La_Liga,2021_2022
Javi Galán,ESP,DF,Celta Vigo,26,1994,36.6,108,66,60,37,11,42,99,42.4,57,48,8,40,45,153,52,0,La_Liga,2021_2022
Iñigo Ruiz de Galarreta,ESP,MF,Mallorca,27,1993,15.3,40,21,14,21,5,14,30,46.7,16,16,2,14,20,60,21,0,La_Liga,2021_2022
Thiago Galhardo,BRA,"FW,MF",Celta Vigo,32,1989,12.8,12,6,3,3,6,2,12,16.7,10,15,2,13,6,18,9,0,La_Liga,2021_2022
Álvaro García,ESP,"FW,MF",Rayo Vallecano,28,1992,33.3,42,23,15,18,9,8,35,22.9,27,27,3,24,42,84,24,0,La_Liga,2021_2022
Dani García,ESP,MF,Athletic Club,31,1990,24.2,36,22,15,17,4,14,47,29.8,33,27,10,17,24,60,41,1,La_Liga,2021_2022
David García,ESP,DF,Osasuna,27,1994,34.5,28,14,15,11,2,12,22,54.5,10,27,21,6,52,80,168,0,La_Liga,2021_2022
Eric García,ESP,DF,Barcelona,20,2001,22.7,27,18,13,13,1,11,26,42.3,15,22,12,10,44,71,53,3,La_Liga,2021_2022
Fran Garcia,ESP,DF,Rayo Vallecano,21,1999,33.6,60,35,44,12,4,39,73,53.4,34,34,8,26,45,105,53,0,La_Liga,2021_2022
Joan García,ESP,GK,Espanyol,20,2001,1.2,0,0,0,0,0,0,0,,0,0,0,0,1,1,1,2,La_Liga,2021_2022
Manu García,ESP,MF,Alavés,23,1998,12.0,18,9,6,9,3,9,27,33.3,18,8,2,6,13,31,4,0,La_Liga,2021_2022
Raúl García,ESP,FW,Athletic Club,35,1986,20.0,27,17,6,11,10,8,36,22.2,28,30,4,26,9,36,21,0,La_Liga,2021_2022
Rubén García,ESP,"MF,FW",Osasuna,28,1993,26.4,43,26,12,23,8,16,49,32.7,33,31,4,27,24,67,16,0,La_Liga,2021_2022
Saúl García,ESP,MF,Alavés,26,1994,0.0,1,1,1,0,0,0,0,,0,0,0,0,0,1,0,0,La_Liga,2021_2022
Unai García,ESP,DF,Osasuna,29,1992,15.6,21,12,14,6,1,14,17,82.4,3,19,11,8,22,43,78,0,La_Liga,2021_2022
Mario Gaspar,ESP,DF,Villarreal,30,1990,6.9,10,4,2,5,3,6,10,60.0,4,6,3,3,6,16,15,0,La_Liga,2021_2022
Gavi,ESP,"MF,FW",Barcelona,16,2004,25.7,38,18,13,18,7,9,33,27.3,24,36,0,36,25,63,13,0,La_Liga,2021_2022
Bryan Gil,ESP,"MF,FW",Valencia,20,2001,8.4,13,8,6,3,4,2,13,15.4,11,13,0,13,1,14,4,0,La_Liga,2021_2022
Óscar Gil,ESP,DF,Espanyol,24,1997,18.8,52,35,27,20,5,25,46,54.3,21,33,9,24,19,71,33,2,La_Liga,2021_2022
Mario Gila,ESP,DF,Real Madrid,20,2000,0.3,1,0,1,0,0,0,1,0.0,1,0,0,0,1,2,1,0,La_Liga,2021_2022
Dani Gómez,ESP,FW,Levante,23,1998,11.8,7,4,3,2,2,4,12,33.3,8,3,0,3,3,10,5,0,La_Liga,2021_2022
Maxi Gómez,URU,FW,Valencia,24,1996,21.7,5,3,1,2,2,5,8,62.5,3,5,1,4,3,8,22,0,La_Liga,2021_2022
Moi Gómez,ESP,"MF,FW",Villarreal,27,1994,14.3,15,7,8,3,4,5,17,29.4,12,5,0,5,6,21,6,0,La_Liga,2021_2022
Papu Gómez,ARG,"FW,MF",Sevilla,33,1988,19.8,19,11,9,5,5,9,35,25.7,26,15,2,13,7,26,12,2,La_Liga,2021_2022
Sergi Gómez,ESP,DF,Espanyol,29,1992,30.2,33,24,29,3,1,18,27,66.7,9,33,23,10,40,73,125,2,La_Liga,2021_2022
Victor Gomez,ESP,DF,Espanyol,21,2000,0.0,0,0,0,0,0,0,0,,0,0,0,0,0,0,0,0,La_Liga,2021_2022
Maxime Gonalons,FRA,MF,Granada,32,1989,17.2,43,28,17,22,4,14,39,35.9,25,33,10,23,18,61,29,0,La_Liga,2021_2022
Diego González,ESP,DF,Elche,26,1995,19.9,25,16,18,7,0,9,16,56.3,7,21,13,8,19,44,87,0,La_Liga,2021_2022
Édgar González,ESP,DF,Betis,24,1997,16.3,25,19,15,8,2,17,24,70.8,7,17,11,6,23,48,82,0,La_Liga,2021_2022
Giovanni González,URU,DF,Mallorca,26,1994,4.1,9,3,4,4,1,3,5,60.0,2,7,2,5,4,13,14,0,La_Liga,2021_2022
Nicolás González,ESP,MF,Barcelona,19,2002,12.4,31,20,5,23,3,11,27,40.7,16,12,0,12,6,37,12,0,La_Liga,2021_2022
Roberto González,ESP,"FW,MF",Betis,20,2001,1.5,5,4,3,2,0,4,6,66.7,2,5,0,5,1,6,1,0,La_Liga,2021_2022
Gori,ESP,MF,Espanyol,19,2002,0.1,0,0,0,0,0,0,0,,0,2,0,2,0,0,0,0,La_Liga,2021_2022
Andoni Gorosabel,ESP,DF,Real Sociedad,24,1996,25.4,47,31,32,9,6,25,47,53.2,22,16,3,13,18,65,49,0,La_Liga,2021_2022
Jaume Grau,ESP,MF,Osasuna,24,1997,0.0,1,1,1,0,0,0,1,0.0,1,0,0,0,0,1,0,0,La_Liga,2021_2022
Dominik Greif,SVK,GK,Mallorca,24,1997,1.0,0,0,0,0,0,0,0,,0,0,0,0,0,0,0,0,La_Liga,2021_2022
Clément Grenier,FRA,MF,Mallorca,30,1991,0.7,0,0,0,0,0,0,0,,0,1,1,0,0,0,1,0,La_Liga,2021_2022
Antoine Griezmann,FRA,FW,Barcelona,30,1991,2.9,13,5,3,10,0,2,6,33.3,4,4,0,4,3,16,5,0,La_Liga,2021_2022
Antoine Griezmann,FRA,"FW,MF",Atlético Madrid,30,1991,18.8,30,14,11,15,4,12,32,37.5,20,18,1,17,7,37,18,0,La_Liga,2021_2022
Andrés Guardado,MEX,MF,Betis,34,1986,15.5,30,13,12,17,1,13,34,38.2,21,18,4,14,21,51,29,1,La_Liga,2021_2022
Sergi Guardiola,ESP,FW,Rayo Vallecano,30,1991,19.0,10,9,3,5,2,1,21,4.8,20,14,2,12,4,14,17,0,La_Liga,2021_2022
Nemanja Gudelj,SRB,"DF,MF",Sevilla,29,1991,11.6,16,7,10,4,2,5,8,62.5,3,14,9,5,22,38,37,0,La_Liga,2021_2022
Gonçalo Guedes,POR,"FW,MF",Valencia,24,1996,29.0,21,14,6,7,8,2,22,9.1,20,14,0,14,9,30,1,0,La_Liga,2021_2022
Ander Guevara,ESP,MF,Real Sociedad,24,1997,9.6,18,13,6,10,2,10,17,58.8,7,12,6,6,12,30,8,0,La_Liga,2021_2022
John Guidetti,SWE,"FW,MF",Alavés,29,1992,3.1,2,1,0,0,2,0,1,0.0,1,1,0,1,0,2,0,0,La_Liga,2021_2022
Hugo Guillamón,ESP,"MF,DF",Valencia,21,2000,26.2,43,27,20,16,7,18,44,40.9,26,26,10,16,30,73,53,1,La_Liga,2021_2022
Gerard Gumbau,ESP,MF,Elche,26,1994,21.0,46,19,22,19,5,22,51,43.1,29,18,4,14,23,69,25,0,La_Liga,2021_2022
Jon Guridi,ESP,MF,Real Sociedad,26,1995,2.3,5,3,2,3,0,1,4,25.0,3,3,1,2,3,8,4,0,La_Liga,2021_2022
Raúl Guti,ESP,MF,Elche,24,1996,18.1,25,15,7,14,4,10,30,33.3,20,9,3,6,25,50,7,0,La_Liga,2021_2022
Marcos Mauro López Gutiérrez,ARG,DF,Cádiz,30,1991,1.5,1,0,0,1,0,0,2,0.0,2,2,1,1,1,2,9,0,La_Liga,2021_2022
Miguel Gutiérrez,ESP,DF,Real Madrid,20,2001,2.9,7,5,5,0,2,3,5,60.0,2,0,0,0,2,9,2,0,La_Liga,2021_2022
Munir El Haddadi,MAR,"FW,MF",Sevilla,25,1995,5.3,8,4,1,6,1,2,8,25.0,6,7,1,6,5,13,2,0,La_Liga,2021_2022
Varazdat Haroyan,ARM,DF,Cádiz,28,1992,16.0,31,21,20,10,1,19,29,65.5,10,22,12,10,15,46,62,0,La_Liga,2021_2022
Eden Hazard,BEL,"FW,MF",Real Madrid,30,1991,8.0,6,3,3,2,1,3,7,42.9,4,3,0,3,2,8,0,0,La_Liga,2021_2022
Kike Hermoso,ESP,DF,Betis,21,1999,1.0,2,1,2,0,0,2,2,100.0,0,2,1,1,0,2,5,1,La_Liga,2021_2022
Mario Hermoso,ESP,DF,Atlético Madrid,26,1995,20.7,30,15,23,4,3,20,38,52.6,18,18,3,15,29,59,49,2,La_Liga,2021_2022
Aridane Hernández,ESP,DF,Osasuna,32,1989,12.9,12,9,10,2,0,3,13,23.1,10,11,9,2,20,32,71,0,La_Liga,2021_2022
Luis Hernández,ESP,DF,Cádiz,32,1989,15.2,9,5,9,0,0,5,8,62.5,3,5,3,2,16,25,34,0,La_Liga,2021_2022
Mario Hernández,ESP,"DF,FW",Rayo Vallecano,22,1999,4.4,10,4,7,3,0,5,9,55.6,4,1,0,1,4,14,7,0,La_Liga,2021_2022
Héctor Herrera,MEX,MF,Atlético Madrid,31,1990,9.5,16,8,11,4,1,7,20,35.0,13,13,2,11,12,28,16,0,La_Liga,2021_2022
Sergio Herrera,ESP,GK,Osasuna,28,1993,36.0,3,2,3,0,0,3,6,50.0,3,1,0,1,1,4,18,0,La_Liga,2021_2022
Yangel Herrera,VEN,MF,Espanyol,23,1998,18.3,41,31,19,19,3,18,39,46.2,21,27,5,22,19,60,33,1,La_Liga,2021_2022
Matthew Hoppe,USA,"FW,MF",Mallorca,20,2001,1.5,1,0,0,0,1,0,3,0.0,3,0,0,0,0,1,0,0,La_Liga,2021_2022
Robert Ibáñez,ESP,"MF,FW",Osasuna,28,1993,1.0,3,3,2,0,1,1,2,50.0,1,1,0,1,1,4,1,0,La_Liga,2021_2022
Vicente Iborra,ESP,MF,Villarreal,33,1988,11.5,19,10,9,7,3,12,24,50.0,12,11,5,6,11,30,27,1,La_Liga,2021_2022
Oussama Idrissi,MAR,"MF,FW",Sevilla,25,1996,1.4,1,0,0,1,0,0,1,0.0,1,1,0,1,1,2,1,0,La_Liga,2021_2022
Oussama Idrissi,MAR,MF,Cádiz,25,1996,10.0,8,4,3,4,1,4,15,26.7,11,8,0,8,3,11,5,0,La_Liga,2021_2022
Iglesias,ESP,DF,Getafe,23,1998,8.0,19,10,11,8,0,7,17,41.2,10,8,2,6,10,29,28,0,La_Liga,2021_2022
Borja Iglesias,ESP,FW,Betis,28,1993,17.5,6,4,1,2,3,0,8,0.0,8,11,1,10,4,10,7,0,La_Liga,2021_2022
Asier Illarramendi,ESP,MF,Real Sociedad,31,1990,4.2,9,5,5,3,1,1,10,10.0,9,5,1,4,4,13,12,0,La_Liga,2021_2022
Nikita Iosifov,RUS,MF,Villarreal,20,2001,0.0,0,0,0,0,0,0,0,,0,0,0,0,0,0,0,0,La_Liga,2021_2022
Alexander Isak,SWE,FW,Real Sociedad,21,1999,23.8,7,4,1,3,3,2,12,16.7,10,14,2,12,3,10,10,0,La_Liga,2021_2022
Isco,ESP,"MF,FW",Real Madrid,29,1992,3.7,9,5,4,4,1,5,12,41.7,7,1,0,1,2,11,1,0,La_Liga,2021_2022
Nicolas Jackson,SEN,"FW,MF",Villarreal,20,2001,1.8,2,0,1,0,1,0,0,,0,0,0,0,1,3,1,0,La_Liga,2021_2022
Jakub Jankto,CZE,"DF,MF",Getafe,25,1996,6.5,11,7,5,5,1,10,17,58.8,7,4,0,4,4,15,7,0,La_Liga,2021_2022
Adnan Januzaj,BEL,"FW,MF",Real Sociedad,26,1995,18.1,17,11,5,8,4,9,24,37.5,15,15,3,12,12,29,15,0,La_Liga,2021_2022
Jason,ESP,"MF,FW",Alavés,27,1994,7.5,11,7,6,4,1,7,20,35.0,13,7,0,7,7,18,5,0,La_Liga,2021_2022
Jason,ESP,"MF,DF",Valencia,27,1994,0.8,4,1,2,1,1,0,1,0.0,1,2,0,2,1,5,1,0,La_Liga,2021_2022
Luis Javier Suárez,COL,FW,Granada,23,1997,31.6,26,14,9,9,8,8,27,29.6,19,25,3,22,6,32,23,0,La_Liga,2021_2022
Álvaro Jiménez,ESP,"MF,FW",Cádiz,26,1995,2.6,6,3,3,2,1,4,7,57.1,3,3,0,3,3,9,0,0,La_Liga,2021_2022
Joaquín,ESP,"FW,MF",Betis,40,1981,5.2,6,2,4,2,0,3,8,37.5,5,5,2,3,3,9,10,0,La_Liga,2021_2022
Jofre,ESP,"MF,DF",Espanyol,20,2001,0.2,1,1,0,0,1,1,1,100.0,0,0,0,0,0,1,0,0,La_Liga,2021_2022
Frenkie de Jong,NED,MF,Barcelona,24,1997,27.5,35,19,12,18,5,12,23,52.2,11,19,5,14,20,55,16,0,La_Liga,2021_2022
Luuk de Jong,NED,FW,Barcelona,30,1990,7.3,9,7,1,5,3,1,2,50.0,1,4,0,4,0,9,12,0,La_Liga,2021_2022
Joan Jordán,ESP,MF,Sevilla,27,1994,27.9,61,30,22,31,8,28,65,43.1,37,27,6,21,30,91,18,1,La_Liga,2021_2022
Josan,ESP,"DF,MF",Elche,31,1989,13.5,36,22,23,9,4,26,44,59.1,18,11,4,7,10,46,21,0,La_Liga,2021_2022
Willian José,BRA,FW,Betis,29,1991,17.8,15,13,2,10,3,2,8,25.0,6,10,2,8,3,18,16,0,La_Liga,2021_2022
Joselu,ESP,FW,Alavés,31,1990,34.7,16,11,1,9,6,7,25,28.0,18,21,4,17,7,23,45,0,La_Liga,2021_2022
Josema,ESP,DF,Elche,25,1996,2.0,3,2,1,1,1,0,2,0.0,2,1,1,0,0,3,11,0,La_Liga,2021_2022
Luka Jović,SRB,FW,Real Madrid,23,1997,4.1,1,1,0,1,0,0,1,0.0,1,3,0,3,1,2,4,0,La_Liga,2021_2022
Miguel Juan Llambrich,ESP,DF,Espanyol,25,1996,0.8,2,2,1,1,0,0,0,,0,1,0,1,0,2,5,0,La_Liga,2021_2022
José Juan Macías,MEX,"FW,MF",Getafe,21,1999,2.2,1,0,0,0,1,0,1,0.0,1,1,0,1,1,2,0,0,La_Liga,2021_2022
Juanmi,ESP,FW,Betis,28,1993,23.7,39,25,11,19,9,19,49,38.8,30,24,1,23,9,48,10,1,La_Liga,2021_2022
Lago Junior,CIV,"FW,MF",Mallorca,30,1990,2.0,3,2,3,0,0,3,5,60.0,2,0,0,0,2,5,2,0,La_Liga,2021_2022
Vinicius Júnior,BRA,FW,Real Madrid,21,2000,29.9,46,24,23,19,4,15,50,30.0,35,25,0,25,6,52,6,0,La_Liga,2021_2022
Ferran Jutglà,ESP,FW,Barcelona,22,1999,3.3,2,1,0,1,1,0,1,0.0,1,2,0,2,1,3,1,0,La_Liga,2021_2022
Jens Jønsson,DEN,MF,Cádiz,28,1993,14.5,40,29,22,17,1,17,35,48.6,18,17,7,10,34,74,32,0,La_Liga,2021_2022
Lee Kang-in,KOR,"MF,FW",Mallorca,20,2001,15.7,13,6,2,9,2,5,29,17.2,24,11,1,10,5,18,7,0,La_Liga,2021_2022
Kiké,ESP,FW,Osasuna,31,1989,20.7,11,7,3,4,4,3,23,13.0,20,10,1,9,3,14,12,0,La_Liga,2021_2022
Koba Koindredi,FRA,MF,Valencia,19,2001,2.0,4,3,2,1,1,2,6,33.3,4,3,0,3,4,8,5,0,La_Liga,2021_2022
Koke,ESP,MF,Atlético Madrid,29,1992,27.9,55,30,19,29,7,26,63,41.3,37,21,5,16,24,79,31,1,La_Liga,2021_2022
Luca Koleosho,ITA,FW,Espanyol,16,2004,0.0,0,0,0,0,0,0,0,,0,0,0,0,0,0,0,0,La_Liga,2021_2022
Geoffrey Kondogbia,CTA,"MF,DF",Atlético Madrid,28,1993,20.9,74,44,25,40,9,21,49,42.9,28,16,5,11,44,118,24,0,La_Liga,2021_2022
Jules Koundé,FRA,DF,Sevilla,22,1998,30.4,40,17,27,10,3,18,28,64.3,10,33,18,15,21,61,101,2,La_Liga,2021_2022
Toni Kroos,GER,MF,Real Madrid,31,1990,23.4,34,26,13,17,4,14,36,38.9,22,16,3,13,12,46,13,1,La_Liga,2021_2022
Takefusa Kubo,JPN,"FW,MF",Mallorca,20,2001,17.8,31,19,12,14,5,10,24,41.7,14,24,3,21,8,39,4,0,La_Liga,2021_2022
Víctor Laguardia,ESP,DF,Alavés,31,1989,33.8,29,16,21,8,0,19,30,63.3,11,36,24,12,27,56,151,1,La_Liga,2021_2022
Diego Lainez,MEX,FW,Betis,21,2000,1.6,1,1,0,1,0,0,3,0.0,3,3,0,3,1,2,0,0,La_Liga,2021_2022
Érik Lamela,ARG,"FW,MF",Sevilla,29,1992,11.3,31,18,12,14,5,10,29,34.5,19,11,0,11,5,36,3,0,La_Liga,2021_2022
Juanmi Latasa,ESP,FW,Real Madrid,20,2001,0.1,0,0,0,0,0,0,0,,0,0,0,0,0,0,0,0,La_Liga,2021_2022
Toni Lato,ESP,DF,Valencia,23,1997,6.6,17,12,12,3,2,9,16,56.3,7,6,0,6,8,25,14,0,La_Liga,2021_2022
Robin Le Normand,ESP,DF,Real Sociedad,24,1996,37.0,49,32,36,8,5,28,36,77.8,8,34,22,12,48,97,125,0,La_Liga,2021_2022
Jeremías Ledesma,ARG,GK,Cádiz,28,1993,38.0,3,1,3,0,0,3,4,75.0,1,0,0,0,1,4,21,4,La_Liga,2021_2022
Wu Lei,CHN,"FW,MF",Espanyol,29,1991,5.3,3,2,1,2,0,3,8,37.5,5,4,0,4,4,7,3,0,La_Liga,2021_2022
Florian Lejeune,FRA,DF,Alavés,30,1991,30.0,33,24,22,10,1,12,20,60.0,8,30,19,11,31,64,158,0,La_Liga,2021_2022
Iñigo Lekue,ESP,DF,Athletic Club,28,1993,21.4,32,23,16,12,4,22,44,50.0,22,37,12,25,23,55,63,0,La_Liga,2021_2022
Thomas Lemar,FRA,MF,Atlético Madrid,25,1995,16.0,24,14,9,12,3,8,23,34.8,15,18,0,18,8,32,11,0,La_Liga,2021_2022
Ruben Lendinez,ESP,DF,Valencia,18,2003,1.5,3,3,1,2,0,3,8,37.5,5,4,0,4,2,5,6,0,La_Liga,2021_2022
Clément Lenglet,FRA,DF,Barcelona,26,1995,9.2,20,11,11,7,2,8,13,61.5,5,7,3,4,13,33,21,0,La_Liga,2021_2022
Javier Llabrés,ESP,"FW,MF",Mallorca,18,2002,1.5,2,1,0,1,1,1,2,50.0,1,1,0,1,0,2,0,0,La_Liga,2021_2022
Marcos Llorente,ESP,"MF,DF",Atlético Madrid,26,1995,27.2,51,23,25,22,4,28,43,65.1,15,33,10,23,27,78,44,0,La_Liga,2021_2022
Giovani Lo Celso,ARG,"FW,MF",Villarreal,25,1996,11.0,22,12,8,10,4,9,22,40.9,13,4,0,4,5,27,3,0,La_Liga,2021_2022
Julen Lobete,ESP,"FW,MF",Real Sociedad,20,2000,3.2,4,3,3,0,1,1,2,50.0,1,6,1,5,1,5,1,0,La_Liga,2021_2022
Renan Lodi,BRA,DF,Atlético Madrid,23,1998,13.1,31,18,14,13,4,11,27,40.7,16,22,4,18,13,44,19,1,La_Liga,2021_2022
David López,ESP,"MF,DF",Espanyol,31,1989,8.3,18,13,9,8,1,9,16,56.3,7,10,8,2,10,28,25,2,La_Liga,2021_2022
Diego López,ESP,GK,Espanyol,39,1981,35.3,0,0,0,0,0,0,2,0.0,2,0,0,0,1,1,21,1,La_Liga,2021_2022
Javi López,ESP,DF,Alavés,19,2002,5.1,8,6,6,2,0,4,6,66.7,2,7,1,6,4,12,15,0,La_Liga,2021_2022
Unai López,ESP,MF,Rayo Vallecano,25,1995,12.9,19,9,6,10,3,10,33,30.3,23,7,0,7,10,29,8,1,La_Liga,2021_2022
Mamadou Loum,SEN,MF,Alavés,24,1996,25.7,49,22,26,22,1,17,45,37.8,28,30,11,19,37,86,68,1,La_Liga,2021_2022
Anthony Lozano,HON,"FW,MF",Cádiz,28,1993,18.6,8,4,2,3,3,5,18,27.8,13,16,2,14,2,10,7,0,La_Liga,2021_2022
Florentino Luís,POR,MF,Getafe,21,1999,11.0,42,25,22,17,3,17,35,48.6,18,21,2,19,21,63,11,1,La_Liga,2021_2022
José Luis Gayà,ESP,DF,Valencia,26,1995,20.8,35,21,24,10,1,16,34,47.1,18,17,3,14,19,54,37,0,La_Liga,2021_2022
José Luis Morales,ESP,"FW,MF",Levante,34,1987,30.2,27,17,6,9,12,12,42,28.6,30,29,0,29,4,31,7,0,La_Liga,2021_2022
Luismi,ESP,"FW,MF",Sevilla,20,2001,0.1,0,0,0,0,0,0,0,,0,0,0,0,0,0,0,0,La_Liga,2021_2022
Andriy Lunin,UKR,GK,Real Madrid,22,1999,2.0,0,0,0,0,0,0,0,,0,0,0,0,0,0,2,0,La_Liga,2021_2022
Darwin Machís,VEN,"MF,FW",Granada,28,1993,15.3,23,13,11,8,4,9,23,39.1,14,10,0,10,15,38,17,0,La_Liga,2021_2022
Pablo Maffeo,ESP,DF,Mallorca,24,1997,32.7,84,47,48,28,8,38,69,55.1,31,30,13,17,46,130,74,0,La_Liga,2021_2022
Nemanja Maksimović,SRB,MF,Getafe,26,1995,32.6,56,32,24,26,6,18,49,36.7,31,42,13,29,71,127,41,0,La_Liga,2021_2022
Hugo Mallo,ESP,DF,Celta Vigo,30,1991,20.3,45,25,24,19,2,16,31,51.6,15,23,9,14,20,65,53,0,La_Liga,2021_2022
Mickael Malsa,MTQ,MF,Levante,25,1995,12.7,37,17,16,18,3,15,42,35.7,27,20,8,12,18,55,15,0,La_Liga,2021_2022
Giorgi Mamardashvili,GEO,GK,Valencia,20,2000,18.0,0,0,0,0,0,0,0,,0,0,0,0,0,0,6,1,La_Liga,2021_2022
Reinildo Mandava,MOZ,DF,Atlético Madrid,27,1994,14.4,45,25,30,14,1,22,30,73.3,8,18,9,9,21,66,38,0,La_Liga,2021_2022
Aïssa Mandi,ALG,DF,Villarreal,29,1991,15.3,11,5,2,8,1,3,6,50.0,3,17,14,3,13,24,49,3,La_Liga,2021_2022
Nikola Maraš,SRB,DF,Rayo Vallecano,25,1995,11.6,13,9,12,1,0,9,15,60.0,6,17,13,4,15,28,51,0,La_Liga,2021_2022
Marcelo,BRA,DF,Real Madrid,33,1988,5.8,8,4,2,3,3,5,10,50.0,5,7,2,5,1,9,11,0,La_Liga,2021_2022
Iván Marcone,ARG,MF,Elche,31,1990,9.0,24,14,17,6,1,12,24,50.0,12,8,3,5,12,36,13,0,La_Liga,2021_2022
Óscar de Marcos,ESP,DF,Athletic Club,32,1989,18.7,50,37,24,19,7,28,43,65.1,15,20,3,17,19,69,27,0,La_Liga,2021_2022
José Mari,ESP,MF,Cádiz,33,1987,4.3,14,7,3,10,1,7,8,87.5,1,4,1,3,7,21,2,0,La_Liga,2021_2022
José María Giménez,URU,DF,Atlético Madrid,26,1995,22.7,18,12,12,6,0,8,16,50.0,8,25,19,6,25,43,96,1,La_Liga,2021_2022
Mariano,DOM,FW,Real Madrid,27,1993,3.8,2,0,2,0,0,0,0,,0,2,0,2,1,3,3,0,La_Liga,2021_2022
Mika Màrmol,ESP,DF,Barcelona,19,2002,0.0,0,0,0,0,0,0,0,,0,0,0,0,0,0,0,0,La_Liga,2021_2022
Roger Martí,ESP,FW,Levante,30,1991,23.5,23,14,3,13,7,8,30,26.7,22,14,0,14,2,25,8,0,La_Liga,2021_2022
Anthony Martial,FRA,"FW,MF",Sevilla,25,1995,5.4,2,1,0,0,2,2,6,33.3,4,4,0,4,0,2,3,0,La_Liga,2021_2022
Martín,ESP,MF,Cádiz,22,1999,1.3,2,2,0,2,0,0,0,,0,1,0,1,1,3,3,0,La_Liga,2021_2022
Ander Martin,ESP,"FW,MF",Real Sociedad,20,2000,1.0,1,0,0,1,0,1,1,100.0,0,0,0,0,3,4,1,0,La_Liga,2021_2022
Andrés Martín,ESP,"FW,MF",Rayo Vallecano,22,1999,2.1,0,0,0,0,0,0,1,0.0,1,1,0,1,0,0,0,0,La_Liga,2021_2022
Carlos Martín,ESP,DF,Atlético Madrid,19,2002,0.1,0,0,0,0,0,0,0,,0,0,0,0,0,0,1,0,La_Liga,2021_2022
Iván Martín,ESP,"MF,FW",Alavés,22,1999,1.8,1,1,1,0,0,0,1,0.0,1,2,0,2,1,2,1,0,La_Liga,2021_2022
Iñigo Martínez,ESP,DF,Athletic Club,30,1991,26.0,28,13,18,7,3,14,23,60.9,9,22,10,12,39,67,143,0,La_Liga,2021_2022
Javi Martínez,ESP,"MF,FW",Osasuna,21,1999,9.8,21,14,8,11,2,10,29,34.5,19,6,0,6,9,30,10,0,La_Liga,2021_2022
Pablo Martínez,ESP,MF,Levante,23,1998,7.3,15,8,7,8,0,4,13,30.8,9,6,3,3,15,30,5,0,La_Liga,2021_2022
Omar Mascarell,EQG,MF,Elche,28,1993,27.7,46,26,16,23,7,24,60,40.0,36,42,14,28,48,94,52,2,La_Liga,2021_2022
Jaime Mata,ESP,FW,Getafe,32,1988,7.5,7,5,3,1,3,1,9,11.1,8,4,1,3,1,8,5,0,La_Liga,2021_2022
Luís Maximiano,POR,GK,Granada,22,1999,34.8,3,1,3,0,0,3,6,50.0,3,0,0,0,1,4,16,2,La_Liga,2021_2022
Borja Mayoral,ESP,FW,Getafe,24,1997,11.6,7,5,2,3,2,1,2,50.0,1,10,4,6,4,11,3,0,La_Liga,2021_2022
Jordi Mboula,ESP,FW,Mallorca,22,1999,4.8,8,2,3,3,2,5,9,55.6,4,7,1,6,3,11,3,0,La_Liga,2021_2022
Óscar Melendo,ESP,"MF,FW",Espanyol,23,1997,11.0,11,5,4,4,3,3,13,23.1,10,4,1,3,1,12,10,0,La_Liga,2021_2022
Gonzalo Melero,ESP,MF,Levante,27,1994,18.8,29,16,10,15,4,16,36,44.4,20,21,8,13,7,36,22,0,La_Liga,2021_2022
Memphis,NED,FW,Barcelona,27,1994,20.6,10,4,2,4,4,3,13,23.1,10,9,1,8,3,13,4,0,La_Liga,2021_2022
Tomás Mendes,ESP,MF,Alavés,16,2004,0.1,0,0,0,0,0,0,0,,0,0,0,0,0,0,1,0,La_Liga,2021_2022
Brais Méndez,ESP,MF,Celta Vigo,24,1997,33.6,68,35,24,35,9,26,87,29.9,61,52,6,46,37,105,30,0,La_Liga,2021_2022
Édgar Méndez,ESP,"FW,MF",Alavés,31,1990,17.9,25,14,11,10,4,11,34,32.4,23,16,0,16,4,29,17,0,La_Liga,2021_2022
Ferland Mendy,FRA,DF,Real Madrid,26,1995,19.3,24,14,11,10,3,8,14,57.1,6,8,2,6,18,42,27,3,La_Liga,2021_2022
Fran Mérida,ESP,MF,Espanyol,31,1990,3.0,7,3,5,2,0,4,10,40.0,6,1,0,1,6,13,1,0,La_Liga,2021_2022
Mikel Merino,ESP,MF,Real Sociedad,25,1996,32.1,71,38,21,40,10,26,67,38.8,41,50,10,40,21,92,56,2,La_Liga,2021_2022
Martín Merquelanz,ESP,"FW,MF",Rayo Vallecano,26,1995,1.9,2,1,2,0,0,2,6,33.3,4,2,0,2,0,2,1,0,La_Liga,2021_2022
Matt Miazga,USA,DF,Alavés,26,1995,9.3,7,7,3,4,0,2,7,28.6,5,14,12,2,11,18,55,1,La_Liga,2021_2022
Miguel,ESP,"FW,MF",Alavés,21,1999,9.2,7,3,1,5,1,2,15,13.3,13,6,0,6,1,8,7,0,La_Liga,2021_2022
Éder Militão,BRA,DF,Real Madrid,23,1998,33.7,50,32,30,12,8,20,39,51.3,19,42,20,22,52,102,107,3,La_Liga,2021_2022
Luis Milla,ESP,MF,Granada,26,1994,30.8,59,29,25,30,4,25,64,39.1,39,28,4,24,25,84,34,0,La_Liga,2021_2022
Pere Milla,ESP,"MF,FW",Elche,28,1992,18.3,20,15,14,5,1,8,44,18.2,36,21,1,20,5,25,21,0,La_Liga,2021_2022
Santi Mina,ESP,FW,Celta Vigo,25,1995,26.3,27,17,8,15,4,5,32,15.6,27,28,2,26,6,33,22,0,La_Liga,2021_2022
Óscar Mingueza,ESP,DF,Barcelona,22,1999,9.9,25,11,12,11,2,16,23,69.6,7,5,0,5,9,34,22,1,La_Liga,2021_2022
Rafa Mir,ESP,FW,Sevilla,24,1997,20.1,4,3,1,1,2,0,11,0.0,11,4,3,1,0,4,17,0,La_Liga,2021_2022
Jorge Miramón,ESP,DF,Levante,32,1989,22.0,36,19,16,12,8,15,44,34.1,29,15,3,12,35,71,58,0,La_Liga,2021_2022
Juan Miranda,ESP,DF,Betis,21,2000,8.7,21,11,16,4,1,12,22,54.5,10,10,4,6,15,36,22,0,La_Liga,2021_2022
Stefan Mitrović,SRB,DF,Getafe,31,1990,29.6,16,8,12,4,0,8,13,61.5,5,28,18,10,22,38,114,1,La_Liga,2021_2022
Luka Modrić,CRO,MF,Real Madrid,35,1985,22.6,18,10,8,7,3,6,27,22.2,21,10,4,6,20,38,9,0,La_Liga,2021_2022
Johan Mojica,COL,DF,Elche,28,1992,31.7,46,25,34,7,5,23,31,74.2,8,22,3,19,25,71,61,3,La_Liga,2021_2022
Jorge Molina,ESP,FW,Granada,39,1982,21.8,4,2,2,1,1,2,18,11.1,16,13,2,11,6,10,11,0,La_Liga,2021_2022
Jon Moncayola,ESP,MF,Osasuna,23,1998,32.4,40,20,18,18,4,17,44,38.6,27,26,9,17,20,60,43,0,La_Liga,2021_2022
Monchu,ESP,MF,Granada,21,1999,7.4,15,6,5,9,1,5,10,50.0,5,8,3,5,4,19,4,0,La_Liga,2021_2022
Gonzalo Montiel,ARG,DF,Sevilla,24,1997,11.8,15,4,8,5,2,12,24,50.0,12,8,2,6,10,25,22,0,La_Liga,2021_2022
Ángel Montoro,ESP,MF,Granada,33,1988,14.8,26,13,16,7,3,17,27,63.0,10,11,1,10,11,37,29,1,La_Liga,2021_2022
Martín Montoya,ESP,DF,Betis,30,1991,5.8,20,12,11,7,2,15,26,57.7,11,6,0,6,11,31,20,0,La_Liga,2021_2022
Jon Morcillo,ESP,"MF,FW",Athletic Club,22,1998,0.6,3,0,1,2,0,3,4,75.0,1,1,0,1,0,3,0,0,La_Liga,2021_2022
Alberto Moreno,ESP,"MF,DF",Villarreal,29,1992,13.6,13,7,5,7,1,5,18,27.8,13,13,1,12,27,40,15,0,La_Liga,2021_2022
Álex Moreno,ESP,DF,Betis,28,1993,26.7,76,40,53,15,8,33,60,55.0,27,28,6,22,34,110,82,1,La_Liga,2021_2022
Gerard Moreno,ESP,FW,Villarreal,29,1992,13.2,5,2,2,2,1,1,7,14.3,6,6,1,5,6,11,14,0,La_Liga,2021_2022
Tete Morente,ESP,MF,Elche,24,1996,18.1,21,14,13,7,1,7,28,25.0,21,30,1,29,12,33,12,0,La_Liga,2021_2022
Ilaix Moriba,GUI,MF,Valencia,18,2003,9.1,26,18,10,13,3,14,35,40.0,21,15,0,15,12,38,14,0,La_Liga,2021_2022
Manu Morlanes,ESP,MF,Espanyol,22,1999,12.7,36,15,16,17,3,18,43,41.9,25,24,5,19,13,49,17,0,La_Liga,2021_2022
Loren Morón,ESP,"FW,MF",Espanyol,27,1993,6.3,6,4,1,3,2,0,12,0.0,12,11,1,10,2,8,9,0,La_Liga,2021_2022
Loren Morón,ESP,FW,Betis,27,1993,0.0,1,1,1,0,0,1,1,100.0,0,0,0,0,0,1,0,0,La_Liga,2021_2022
Cristhian Mosquera,ESP,DF,Valencia,17,2004,2.4,4,2,3,0,1,3,6,50.0,3,1,0,1,3,7,1,1,La_Liga,2021_2022
Toni Moya,ESP,MF,Alavés,23,1998,15.4,23,10,7,13,3,13,43,30.2,30,18,5,13,20,43,18,0,La_Liga,2021_2022
Iker Muniain,ESP,MF,Athletic Club,28,1992,30.9,32,10,8,19,5,12,40,30.0,28,20,1,19,17,49,8,1,La_Liga,2021_2022
Aihen Muñoz,ESP,DF,Real Sociedad,23,1997,14.9,28,17,14,13,1,18,29,62.1,11,11,1,10,17,45,34,0,La_Liga,2021_2022
Jeison Murillo,COL,DF,Celta Vigo,29,1992,12.4,15,10,13,2,0,9,13,69.2,4,11,8,3,17,32,37,0,La_Liga,2021_2022
Vedat Muriqi,KVX,FW,Mallorca,27,1994,16.0,6,3,1,3,2,1,7,14.3,6,12,0,12,6,12,29,0,La_Liga,2021_2022
Yunus Musah,USA,"MF,FW",Valencia,18,2002,14.0,23,13,8,8,7,6,20,30.0,14,19,1,18,14,37,11,0,La_Liga,2021_2022
Shkodran Mustafi,GER,DF,Levante,29,1992,7.3,9,6,6,3,0,5,9,55.6,4,6,3,3,15,24,40,0,La_Liga,2021_2022
Nacho,ESP,DF,Real Madrid,31,1990,17.3,18,14,9,9,0,12,22,54.5,10,22,15,7,34,52,50,0,La_Liga,2021_2022
Roberto Navarro,ESP,"MF,FW",Real Sociedad,19,2002,2.2,5,3,1,1,3,3,5,60.0,2,2,0,2,2,7,2,0,La_Liga,2021_2022
Ximo Navarro,ESP,DF,Alavés,31,1990,15.0,28,19,21,6,1,13,27,48.1,14,11,5,6,22,50,56,2,La_Liga,2021_2022
Jesús Navas,ESP,DF,Sevilla,35,1985,19.8,18,13,11,5,2,9,17,52.9,8,15,2,13,17,35,26,1,La_Liga,2021_2022
Álvaro Negredo,ESP,FW,Cádiz,35,1985,24.0,5,3,1,4,0,3,6,50.0,3,11,5,6,2,7,23,0,La_Liga,2021_2022
Neto,BRA,GK,Barcelona,32,1989,3.0,0,0,0,0,0,0,0,,0,0,0,0,0,0,2,1,La_Liga,2021_2022
Carlos Neva,ESP,DF,Granada,25,1996,23.4,31,19,24,7,0,16,28,57.1,12,27,9,18,32,63,81,0,La_Liga,2021_2022
Saúl Ñíguez,ESP,"FW,MF",Atlético Madrid,26,1994,2.2,7,2,0,6,1,3,4,75.0,1,7,1,6,0,7,3,0,La_Liga,2021_2022
Fernando Niño,ESP,FW,Mallorca,20,2000,9.8,10,4,3,2,5,2,12,16.7,10,9,2,7,3,13,15,0,La_Liga,2021_2022
Peru Nolaskoain,ESP,DF,Athletic Club,22,1998,0.0,0,0,0,0,0,0,0,,0,0,0,0,0,0,0,0,La_Liga,2021_2022
Nolito,ESP,MF,Celta Vigo,34,1986,15.4,25,15,14,7,4,13,47,27.7,34,20,1,19,9,34,5,0,La_Liga,2021_2022
Randy Nteka,ANG,"FW,MF",Rayo Vallecano,23,1997,16.2,24,13,9,11,4,8,19,42.1,11,21,1,20,8,32,12,0,La_Liga,2021_2022
Unai Núñez,ESP,DF,Athletic Club,24,1997,6.9,4,4,2,2,0,3,6,50.0,3,9,8,1,8,12,26,2,La_Liga,2021_2022
Allan Nyom,CMR,DF,Getafe,33,1988,2.7,3,1,2,1,0,2,2,100.0,0,2,1,1,2,5,7,0,La_Liga,2021_2022
Jan Oblak,SVN,GK,Atlético Madrid,28,1993,38.0,0,0,0,0,0,0,0,,0,0,0,0,1,1,10,4,La_Liga,2021_2022
Lucas Ocampos,ARG,FW,Sevilla,27,1994,23.6,45,24,23,18,4,23,55,41.8,32,35,1,34,9,54,24,1,La_Liga,2021_2022
Lucas Olaza,URU,DF,Elche,27,1994,3.3,5,3,3,1,1,1,1,100.0,0,5,1,4,4,9,6,0,La_Liga,2021_2022
Oier Olazábal,ESP,GK,Espanyol,31,1989,1.5,0,0,0,0,0,0,0,,0,0,0,0,0,0,0,0,La_Liga,2021_2022
Brian Oliván,ESP,DF,Mallorca,27,1994,24.3,33,20,22,9,2,12,23,52.2,11,17,7,10,28,61,63,0,La_Liga,2021_2022
Mathías Olivera,URU,DF,Getafe,23,1997,31.1,79,47,39,34,6,40,69,58.0,29,45,4,41,55,134,67,1,La_Liga,2021_2022
Javier Ontiveros,ESP,"FW,MF",Osasuna,23,1997,0.4,0,0,0,0,0,0,2,0.0,2,0,0,0,1,1,0,1,La_Liga,2021_2022
Pedro Ortiz,ESP,MF,Sevilla,20,2000,0.1,0,0,0,0,0,0,0,,0,0,0,0,0,0,1,0,La_Liga,2021_2022
Milutin Osmajić,MNE,"FW,MF",Cádiz,22,1999,2.9,1,1,0,1,0,0,0,,0,0,0,0,1,2,3,0,La_Liga,2021_2022
Jesús Owono,EQG,GK,Alavés,20,2001,1.0,0,0,0,0,0,0,0,,0,0,0,0,0,0,1,0,La_Liga,2021_2022
Mikel Oyarzabal,ESP,"FW,MF",Real Sociedad,24,1997,18.6,18,10,7,7,4,7,21,33.3,14,18,2,16,10,28,16,1,La_Liga,2021_2022
Fernando Pacheco,ESP,GK,Alavés,29,1992,33.9,2,1,2,0,0,2,2,100.0,0,0,0,0,0,2,18,1,La_Liga,2021_2022
Jon Pacheco,ESP,DF,Real Sociedad,20,2001,4.2,6,4,4,2,0,3,3,100.0,0,6,4,2,6,12,18,0,La_Liga,2021_2022
Helibelton Palacios,COL,DF,Elche,28,1993,21.5,69,38,56,10,3,37,55,67.3,18,21,8,13,18,87,61,0,La_Liga,2021_2022
Isaac Palazón Camacho,ESP,"FW,MF",Rayo Vallecano,26,1994,25.4,42,28,20,19,3,18,59,30.5,41,31,3,28,13,55,22,0,La_Liga,2021_2022
Daniel Parejo,ESP,MF,Villarreal,32,1989,30.0,43,29,15,15,13,20,52,38.5,32,32,7,25,29,72,19,1,La_Liga,2021_2022
Raúl Parra,ESP,DF,Cádiz,21,1999,1.0,2,1,2,0,0,1,3,33.3,2,0,0,0,0,2,5,0,La_Liga,2021_2022
Javier Pastore,ARG,"MF,FW",Elche,32,1989,5.8,7,3,3,2,2,3,12,25.0,9,5,1,4,4,11,2,0,La_Liga,2021_2022
Gabriel Paulista,BRA,DF,Valencia,30,1990,17.7,21,12,16,5,0,14,20,70.0,6,18,12,6,39,60,88,0,La_Liga,2021_2022
Alfonso Pedraza,ESP,DF,Villarreal,25,1996,18.9,34,16,17,12,5,10,28,35.7,18,12,3,9,31,65,32,0,La_Liga,2021_2022
Pedri,ESP,MF,Barcelona,18,2002,9.8,20,12,9,8,3,7,20,35.0,13,13,0,13,5,25,7,1,La_Liga,2021_2022
Adrià Pedrosa,ESP,DF,Espanyol,23,1998,30.2,58,30,38,14,6,26,57,45.6,31,25,7,18,25,83,92,2,La_Liga,2021_2022
Facundo Pellistri,URU,"MF,FW",Alavés,19,2001,7.5,9,5,4,3,2,1,10,10.0,9,13,2,11,6,15,7,0,La_Liga,2021_2022
Rubén Peña,ESP,"MF,FW",Villarreal,30,1991,1.5,2,0,1,1,0,2,6,33.3,4,1,0,1,5,7,2,0,La_Liga,2021_2022
Alberto Perea,ESP,MF,Cádiz,30,1990,8.6,19,9,7,9,3,6,20,30.0,14,15,1,14,9,28,4,0,La_Liga,2021_2022
Iñigo Pérez,ESP,MF,Osasuna,33,1988,3.8,3,2,2,1,0,2,4,50.0,2,1,0,1,0,3,3,0,La_Liga,2021_2022
Juan Pérez,ESP,GK,Osasuna,25,1996,2.0,0,0,0,0,0,0,1,0.0,1,0,0,0,0,0,1,1,La_Liga,2021_2022
Kike Pérez,ESP,"MF,FW",Elche,24,1997,5.8,8,6,1,3,4,0,10,0.0,10,6,1,5,3,11,4,0,La_Liga,2021_2022
Lucas Pérez,ESP,FW,Elche,32,1988,14.1,4,1,2,1,1,3,10,30.0,7,2,0,2,3,7,4,0,La_Liga,2021_2022
Lucas Pérez,ESP,"FW,MF",Cádiz,32,1988,11.8,3,3,2,1,0,0,10,0.0,10,3,1,2,0,3,1,0,La_Liga,2021_2022
Njegoš Petrović,SRB,MF,Granada,22,1999,10.2,24,11,4,19,1,8,14,57.1,6,16,4,12,9,33,11,0,La_Liga,2021_2022
Alex Petxa,ESP,"DF,MF",Athletic Club,24,1997,4.6,12,9,4,7,1,4,8,50.0,4,8,2,6,4,16,6,0,La_Liga,2021_2022
Germán Pezzella,ARG,DF,Betis,30,1991,22.1,21,9,16,5,0,16,29,55.2,13,29,18,11,39,60,106,0,La_Liga,2021_2022
Pablo Piatti,ARG,"MF,FW",Elche,32,1989,3.5,9,4,5,3,1,3,8,37.5,5,5,1,4,2,11,3,0,La_Liga,2021_2022
Cristiano Piccini,ITA,DF,Valencia,28,1992,3.6,14,8,9,5,0,5,7,71.4,2,3,2,1,1,15,11,0,La_Liga,2021_2022
Tomás Pina Isla,ESP,MF,Alavés,33,1987,16.0,28,16,13,11,4,14,29,48.3,15,12,3,9,22,50,23,0,La_Liga,2021_2022
Orbelín Pineda,MEX,"MF,FW",Celta Vigo,25,1996,1.1,4,1,4,0,0,1,2,50.0,1,0,0,0,0,4,1,0,La_Liga,2021_2022
Yeremi Pino,ESP,"MF,FW",Villarreal,18,2002,18.6,32,14,14,8,10,10,24,41.7,14,33,4,29,6,38,12,1,La_Liga,2021_2022
Gerard Piqué,ESP,DF,Barcelona,34,1987,23.2,22,12,18,4,0,11,14,78.6,3,19,16,3,34,56,86,1,La_Liga,2021_2022
Ezequiel Ponce,ARG,FW,Elche,24,1997,7.4,5,4,1,3,1,3,10,30.0,7,5,0,5,1,6,7,0,La_Liga,2021_2022
Pere Pons,ESP,MF,Alavés,28,1993,15.2,26,18,4,20,2,7,21,33.3,14,10,1,9,6,32,11,0,La_Liga,2021_2022
Portu,ESP,"FW,MF",Real Sociedad,29,1992,17.7,16,7,2,6,8,3,19,15.8,16,21,3,18,7,23,8,0,La_Liga,2021_2022
Sergio Postigo,ESP,DF,Levante,32,1988,9.4,11,7,8,2,1,4,8,50.0,4,7,5,2,7,18,45,1,La_Liga,2021_2022
Darío Poveda,ESP,"FW,MF",Getafe,24,1997,4.2,2,0,1,0,1,0,5,0.0,5,7,1,6,1,3,1,0,La_Liga,2021_2022
José Pozo,ESP,"MF,DF",Rayo Vallecano,25,1996,0.8,2,2,0,2,0,2,3,66.7,1,1,0,1,0,2,1,0,La_Liga,2021_2022
Abdón Prats,ESP,FW,Mallorca,28,1992,7.1,2,2,1,0,1,1,5,20.0,4,5,0,5,1,3,6,0,La_Liga,2021_2022
Alejandro Primo,ESP,GK,Levante,17,2004,1.0,0,0,0,0,0,0,0,,0,0,0,0,0,0,0,0,La_Liga,2021_2022
Javi Puado,ESP,"MF,FW",Espanyol,23,1998,24.9,24,14,18,5,1,12,37,32.4,25,18,2,16,11,35,24,0,La_Liga,2021_2022
Marc Pubill,ESP,"DF,MF",Levante,18,2003,5.7,12,6,10,2,0,4,8,50.0,4,7,2,5,4,16,8,2,La_Liga,2021_2022
Antonio Puertas,ESP,"MF,FW",Granada,29,1992,25.1,34,20,18,12,4,17,44,38.6,27,33,3,30,11,45,36,0,La_Liga,2021_2022
Riqui Puig,ESP,MF,Barcelona,21,1999,5.4,6,3,2,4,0,2,14,14.3,12,5,0,5,3,9,0,0,La_Liga,2021_2022
Yacine Qasmi,MAR,FW,Rayo Vallecano,30,1991,0.0,0,0,0,0,0,0,0,,0,0,0,0,0,0,0,0,La_Liga,2021_2022
Quini,ESP,DF,Granada,31,1989,25.6,73,34,48,21,4,42,79,53.2,37,28,10,18,36,109,62,0,La_Liga,2021_2022
Dani Raba,ESP,"MF,FW",Villarreal,25,1995,1.0,1,0,0,1,0,1,2,50.0,1,2,0,2,0,1,2,0,La_Liga,2021_2022
Dani Raba,ESP,"MF,FW",Granada,25,1995,0.3,2,2,1,0,1,2,3,66.7,1,0,0,0,1,3,0,0,La_Liga,2021_2022
Uroš Račić,SRB,MF,Valencia,23,1998,13.4,32,18,9,19,4,12,33,36.4,21,16,6,10,16,48,21,0,La_Liga,2021_2022
Nemanja Radoja,SRB,MF,Levante,28,1993,13.5,25,8,9,13,3,8,20,40.0,12,16,9,7,22,47,16,2,La_Liga,2021_2022
Rafinha,BRA,MF,Real Sociedad,28,1993,11.7,43,27,17,20,6,16,28,57.1,12,21,2,19,12,55,4,0,La_Liga,2021_2022
Antonio Raillo,ESP,DF,Mallorca,29,1991,17.0,16,7,10,4,2,5,6,83.3,1,17,14,3,18,34,81,0,La_Liga,2021_2022
Ivan Rakitić,CRO,MF,Sevilla,33,1988,24.2,40,22,12,23,5,13,40,32.5,27,31,8,23,23,63,35,0,La_Liga,2021_2022
Jonás Ramalho,ESP,DF,Osasuna,28,1993,2.7,4,2,2,2,0,2,3,66.7,1,4,1,3,3,7,9,0,La_Liga,2021_2022
Sandro Ramírez,ESP,FW,Getafe,26,1995,16.2,7,3,1,3,3,1,12,8.3,11,14,3,11,2,9,3,0,La_Liga,2021_2022
Raúl,ESP,"FW,DF",Betis,20,2000,0.0,0,0,0,0,0,0,0,,0,0,0,0,0,0,0,0,La_Liga,2021_2022
Lluís Recasens,ESP,DF,Espanyol,19,2002,0.5,2,0,2,0,0,1,1,100.0,0,0,0,0,2,4,2,0,La_Liga,2021_2022
Manolo Reina,ESP,GK,Mallorca,36,1985,21.0,0,0,0,0,0,0,0,,0,0,0,0,1,1,6,2,La_Liga,2021_2022
Karim Rekik,NED,DF,Sevilla,26,1994,12.2,11,8,4,6,1,2,9,22.2,7,11,6,5,9,20,19,0,La_Liga,2021_2022
Álex Remiro,ESP,GK,Real Sociedad,26,1995,35.0,0,0,0,0,0,0,0,,0,0,0,0,1,1,24,2,La_Liga,2021_2022
Nico Ribaudo,ESP,"MF,FW",Espanyol,20,2001,12.4,15,6,9,5,1,11,34,32.4,23,14,2,12,7,22,3,0,La_Liga,2021_2022
Diego Rico,ESP,DF,Real Sociedad,28,1993,18.3,41,20,19,17,5,22,45,48.9,23,29,4,25,30,71,54,0,La_Liga,2021_2022
Sergio Rico,ESP,GK,Mallorca,27,1993,14.0,0,0,0,0,0,0,0,,0,0,0,0,0,0,5,2,La_Liga,2021_2022
Luis Rioja,ESP,"MF,FW",Alavés,27,1993,34.6,28,15,11,10,7,14,58,24.1,44,22,1,21,25,53,20,0,La_Liga,2021_2022
Rober,ESP,DF,Levante,26,1995,22.3,36,20,27,7,2,23,39,59.0,16,25,15,10,30,66,90,1,La_Liga,2021_2022
Sergi Roberto,ESP,"MF,DF",Barcelona,29,1992,4.4,5,1,2,3,0,3,5,60.0,2,2,0,2,4,9,6,0,La_Liga,2021_2022
Rubén Rochina,ESP,"MF,FW",Granada,30,1991,8.3,21,13,7,8,6,8,28,28.6,20,11,1,10,6,27,5,1,La_Liga,2021_2022
Enzo Roco,CHI,DF,Elche,28,1992,28.4,36,20,24,11,1,15,24,62.5,9,38,27,11,28,64,110,3,La_Liga,2021_2022
Rodri,ESP,FW,Betis,21,2000,9.8,10,7,4,5,1,5,22,22.7,17,11,0,11,3,13,4,0,La_Liga,2021_2022
Kévin Rodrigues,POR,"DF,FW",Rayo Vallecano,27,1994,4.8,15,11,8,7,0,6,10,60.0,4,10,1,9,7,22,6,0,La_Liga,2021_2022
Ángel Rodríguez,ESP,"FW,MF",Mallorca,34,1987,17.2,15,9,6,7,2,4,21,19.0,17,15,1,14,3,18,13,0,La_Liga,2021_2022
Óscar Rodríguez Arnaiz,ESP,"MF,FW",Getafe,23,1998,10.5,16,11,6,8,2,4,12,33.3,8,7,1,6,11,27,6,0,La_Liga,2021_2022
Óscar Rodríguez Arnaiz,ESP,"FW,MF",Sevilla,23,1998,4.6,4,3,1,3,0,2,3,66.7,1,2,0,2,5,9,7,1,La_Liga,2021_2022
Dani Rodríguez,ESP,"MF,FW",Mallorca,33,1988,31.5,53,31,20,24,9,15,46,32.6,31,28,3,25,20,73,27,0,La_Liga,2021_2022
Guido Rodríguez,ARG,MF,Betis,27,1994,28.1,97,53,46,45,6,54,98,55.1,44,55,12,43,31,128,56,0,La_Liga,2021_2022
Rodrygo,BRA,FW,Real Madrid,20,2001,16.9,18,14,7,4,7,3,18,16.7,15,21,0,21,11,29,3,0,La_Liga,2021_2022
Leo Román,ESP,GK,Mallorca,21,2000,2.0,0,0,0,0,0,0,0,,0,0,0,0,0,0,2,0,La_Liga,2021_2022
Iván Romero,ESP,FW,Sevilla,20,2001,2.0,2,2,0,2,0,0,0,,0,1,0,1,2,4,0,0,La_Liga,2021_2022
Unai Ropero,ESP,MF,Alavés,19,2001,0.1,0,0,0,0,0,0,0,,0,0,0,0,1,1,0,0,La_Liga,2021_2022
Rubén,ESP,DF,Espanyol,20,2001,1.7,6,1,4,2,0,4,7,57.1,3,0,0,0,2,8,4,0,La_Liga,2021_2022
Aitor Ruibal,ESP,"FW,DF",Betis,25,1996,9.5,21,15,13,3,5,10,34,29.4,24,8,0,8,8,29,6,0,La_Liga,2021_2022
Isma Ruiz,ESP,MF,Granada,20,2001,3.1,3,1,3,0,0,1,9,11.1,8,5,2,3,3,6,2,0,La_Liga,2021_2022
Víctor Ruiz,ESP,DF,Betis,32,1989,15.8,11,9,7,2,2,6,9,66.7,3,18,13,5,29,40,71,1,La_Liga,2021_2022
Gerónimo Rulli,ARG,GK,Villarreal,29,1992,32.0,0,0,0,0,0,0,4,0.0,4,0,0,0,1,1,15,5,La_Liga,2021_2022
Franco Russo,ARG,DF,Mallorca,26,1994,16.3,19,10,10,9,0,13,31,41.9,18,14,9,5,27,46,73,1,La_Liga,2021_2022
Mathew Ryan,AUS,GK,Real Sociedad,29,1992,3.0,0,0,0,0,0,0,0,,0,0,0,0,0,0,2,0,La_Liga,2021_2022
Youssouf Sabaly,SEN,DF,Betis,28,1993,8.8,12,10,11,0,1,7,13,53.8,6,11,4,7,13,25,16,1,La_Liga,2021_2022
Salvi,ESP,"MF,FW",Cádiz,30,1991,15.5,20,10,9,8,3,8,20,40.0,12,17,2,15,6,26,11,0,La_Liga,2021_2022
Fede San Emeterio,ESP,MF,Cádiz,24,1997,9.2,16,5,5,8,3,5,15,33.3,10,5,0,5,8,24,6,0,La_Liga,2021_2022
Oihan Sancet,ESP,FW,Athletic Club,21,2000,15.8,12,7,2,8,2,5,20,25.0,15,2,0,2,5,17,13,0,La_Liga,2021_2022
Antonio Sánchez,ESP,"MF,FW",Mallorca,24,1997,18.0,53,24,29,17,7,19,49,38.8,30,32,2,30,32,85,32,1,La_Liga,2021_2022
Germán Sánchez,ESP,DF,Granada,34,1986,25.5,27,19,18,9,0,11,20,55.0,9,19,16,3,28,55,137,0,La_Liga,2021_2022
Manu Sánchez,ESP,DF,Osasuna,20,2000,25.1,72,34,41,22,9,43,79,54.4,36,28,3,25,18,90,43,0,La_Liga,2021_2022
Oier Sanjurjo,ESP,MF,Osasuna,35,1986,8.4,10,6,3,7,0,2,19,10.5,17,8,3,5,1,11,9,0,La_Liga,2021_2022
Jesús Santiago,ESP,MF,Valencia,17,2004,0.9,2,2,1,1,0,0,2,0.0,2,1,0,1,0,2,1,0,La_Liga,2021_2022
Sergio Santos,ESP,DF,Real Madrid,20,2001,0.1,0,0,0,0,0,0,0,,0,0,0,0,0,0,0,0,La_Liga,2021_2022
Alvaro Sanz,ESP,MF,Barcelona,20,2001,0.3,0,0,0,0,0,0,1,0.0,1,0,0,0,0,0,0,0,La_Liga,2021_2022
Marcelo Saracchi,URU,DF,Levante,23,1998,2.1,8,5,6,1,1,2,4,50.0,2,3,0,3,4,12,7,1,La_Liga,2021_2022
Joan Sastre Vanrell,ESP,DF,Mallorca,24,1997,2.9,6,3,5,0,1,3,4,75.0,1,3,0,3,2,8,10,0,La_Liga,2021_2022
Esteban Saveljich,MNE,DF,Rayo Vallecano,30,1991,18.9,18,11,11,7,0,9,15,60.0,6,20,12,8,16,34,69,0,La_Liga,2021_2022
Stefan Savić,MNE,DF,Atlético Madrid,30,1991,27.1,46,20,25,20,1,29,43,67.4,14,19,12,7,37,83,102,1,La_Liga,2021_2022
Valentino Scotta,ESP,DF,Sevilla,19,2001,0.0,0,0,0,0,0,0,0,,0,0,0,0,0,0,0,0,La_Liga,2021_2022
Aleksandar Sedlar,SRB,"DF,MF",Mallorca,29,1991,4.5,5,3,4,1,0,3,5,60.0,2,4,4,0,5,10,19,0,La_Liga,2021_2022
Javier Serrano,ESP,MF,Atlético Madrid,18,2003,0.8,3,1,0,3,0,2,4,50.0,2,0,0,0,3,6,2,0,La_Liga,2021_2022
Nicolás Serrano,ESP,"MF,FW",Athletic Club,18,2003,3.5,9,6,3,5,1,3,10,30.0,7,5,1,4,2,11,3,0,La_Liga,2021_2022
Salva Sevilla,ESP,MF,Mallorca,37,1984,16.7,18,12,8,8,2,6,17,35.3,11,12,6,6,14,32,11,0,La_Liga,2021_2022
David Silva,ESP,MF,Real Sociedad,35,1986,19.1,28,17,10,11,7,3,20,15.0,17,13,3,10,7,35,12,0,La_Liga,2021_2022
Jonathan Silva,ARG,"DF,FW",Getafe,27,1994,2.5,10,8,4,4,2,7,12,58.3,5,4,0,4,3,13,7,0,La_Liga,2021_2022
Rui Silva,POR,GK,Betis,27,1994,21.8,1,0,1,0,0,1,2,50.0,1,0,0,0,1,2,11,1,La_Liga,2021_2022
Giuliano Simeone,ARG,MF,Atlético Madrid,18,2002,0.0,0,0,0,0,0,0,0,,0,0,0,0,0,0,0,0,La_Liga,2021_2022
Unai Simón,ESP,GK,Athletic Club,24,1997,34.0,0,0,0,0,0,0,0,,0,0,0,0,1,1,5,1,La_Liga,2021_2022
Antonio Sivera,ESP,GK,Alavés,24,1996,3.1,0,0,0,0,0,0,1,0.0,1,0,0,0,0,0,0,0,La_Liga,2021_2022
Rubén Sobrino,ESP,MF,Valencia,29,1992,0.2,1,1,1,0,0,1,1,100.0,0,1,0,1,2,3,0,0,La_Liga,2021_2022
Rubén Sobrino,ESP,"FW,MF",Cádiz,29,1992,20.7,28,17,11,10,7,5,35,14.3,30,21,1,20,21,49,18,0,La_Liga,2021_2022
Alex Sola,ESP,"DF,FW",Real Sociedad,22,1999,0.5,1,1,1,0,0,1,3,33.3,2,1,0,1,2,3,3,0,La_Liga,2021_2022
Augusto Solari,ARG,"MF,DF",Celta Vigo,29,1992,7.9,24,12,9,12,3,12,32,37.5,20,14,4,10,7,31,10,1,La_Liga,2021_2022
Roberto Soldado,ESP,FW,Levante,36,1985,7.4,3,1,0,1,2,1,3,33.3,2,4,0,4,1,4,7,0,La_Liga,2021_2022
Carlos Soler,ESP,MF,Valencia,24,1997,27.5,29,19,10,15,4,11,37,29.7,26,19,4,15,14,43,28,0,La_Liga,2021_2022
Son,ESP,DF,Levante,27,1994,21.9,28,18,16,7,5,17,34,50.0,17,11,5,6,19,47,33,1,La_Liga,2021_2022
David Soria,ESP,GK,Getafe,28,1993,37.9,1,0,1,0,0,1,2,50.0,1,0,0,0,0,1,22,2,La_Liga,2021_2022
Alberto Soro,ESP,"MF,FW",Granada,22,1999,6.4,12,10,3,6,3,1,7,14.3,6,21,2,19,3,15,4,0,La_Liga,2021_2022
Hugo Sotelo,ESP,FW,Celta Vigo,17,2003,0.0,0,0,0,0,0,0,0,,0,0,0,0,0,0,0,0,La_Liga,2021_2022
Damián Suárez,URU,DF,Getafe,33,1988,30.1,74,47,34,30,10,42,91,46.2,49,46,5,41,31,105,30,0,La_Liga,2021_2022
Denis Suárez,ESP,MF,Celta Vigo,27,1994,31.3,61,29,20,33,8,25,82,30.5,57,32,4,28,16,77,11,0,La_Liga,2021_2022
Luis Suárez,URU,FW,Atlético Madrid,34,1987,20.4,8,5,2,4,2,2,10,20.0,8,8,1,7,1,9,14,0,La_Liga,2021_2022
Mario Suárez,ESP,DF,Rayo Vallecano,34,1987,7.9,9,4,7,2,0,3,9,33.3,6,6,4,2,7,16,37,1,La_Liga,2021_2022
Suso,ESP,FW,Sevilla,27,1993,4.3,4,3,1,3,0,3,13,23.1,10,4,0,4,0,4,0,0,La_Liga,2021_2022
Mamadou Sylla,SEN,"FW,MF",Alavés,27,1994,4.4,2,2,0,1,1,0,1,0.0,1,0,0,0,1,3,5,0,La_Liga,2021_2022
Mamadou Sylla,SEN,FW,Rayo Vallecano,27,1994,2.8,1,1,1,0,0,0,1,0.0,1,2,0,2,4,5,3,0,La_Liga,2021_2022
Alexander Sørloth,NOR,FW,Real Sociedad,25,1995,19.6,20,7,4,10,6,7,17,41.2,10,14,1,13,4,24,15,0,La_Liga,2021_2022
Tachi,ESP,DF,Alavés,23,1997,2.7,6,3,3,3,0,5,7,71.4,2,4,3,1,1,7,9,0,La_Liga,2021_2022
Renato Tapia,PER,MF,Celta Vigo,26,1995,15.7,50,31,15,31,4,20,50,40.0,30,21,5,16,28,78,43,0,La_Liga,2021_2022
Cristian Tello,ESP,FW,Betis,29,1991,9.1,17,11,6,7,4,13,31,41.9,18,9,0,9,10,27,6,0,La_Liga,2021_2022
Nahuel Tenaglia,ARG,DF,Alavés,25,1996,11.9,42,27,30,9,3,24,37,64.9,13,10,2,8,26,68,42,0,La_Liga,2021_2022
Marc Tenas,ESP,"FW,MF",Alavés,20,2001,0.6,1,1,1,0,0,1,1,100.0,0,1,0,1,0,1,0,1,La_Liga,2021_2022
Marc-André ter Stegen,GER,GK,Barcelona,29,1992,35.0,0,0,0,0,0,0,1,0.0,1,0,0,0,1,1,13,5,La_Liga,2021_2022
David Timor,ESP,MF,Getafe,31,1989,3.8,1,1,1,0,0,0,3,0.0,3,3,2,1,1,2,4,1,La_Liga,2021_2022
Mircea Ţîrlea,ROU,DF,Alavés,21,2000,0.2,0,0,0,0,0,0,0,,0,0,0,0,0,0,1,0,La_Liga,2021_2022
Raúl de Tomás,ESP,FW,Espanyol,26,1994,32.4,15,11,6,7,2,6,17,35.3,11,12,3,9,6,21,42,1,La_Liga,2021_2022
Raúl Torrente,ESP,DF,Granada,19,2001,14.2,31,21,18,11,2,16,29,55.2,13,14,9,5,12,43,69,0,La_Liga,2021_2022
Ferrán Torres,ESP,FW,Barcelona,21,2000,15.7,10,5,3,4,3,3,7,42.9,4,12,3,9,6,16,7,0,La_Liga,2021_2022
Óliver Torres,ESP,"MF,FW",Sevilla,26,1994,11.2,22,12,8,7,7,8,25,32.0,17,10,1,9,6,28,4,0,La_Liga,2021_2022
Pau Torres,ESP,DF,Villarreal,24,1997,31.7,32,19,23,7,2,18,25,72.0,7,32,23,9,19,51,105,2,La_Liga,2021_2022
Roberto Torres,ESP,"MF,FW",Osasuna,32,1989,9.0,7,4,3,1,3,3,15,20.0,12,8,0,8,8,15,4,0,La_Liga,2021_2022
Lucas Torró,ESP,MF,Osasuna,27,1994,30.3,71,40,25,38,8,29,57,50.9,28,32,11,21,47,118,55,0,La_Liga,2021_2022
Adama Traoré,ESP,FW,Barcelona,25,1996,4.2,4,2,0,3,1,3,5,60.0,2,2,0,2,4,8,3,1,La_Liga,2021_2022
Óscar Trejo,ARG,MF,Rayo Vallecano,33,1988,22.3,42,24,14,18,10,15,50,30.0,35,26,1,25,13,55,11,0,La_Liga,2021_2022
Manu Trigueros,ESP,"MF,FW",Villarreal,29,1991,24.2,45,25,16,18,11,23,66,34.8,43,19,3,16,13,58,17,0,La_Liga,2021_2022
Kieran Trippier,ENG,"DF,FW",Atlético Madrid,30,1990,10.8,22,12,12,5,5,12,21,57.1,9,12,1,11,10,32,11,0,La_Liga,2021_2022
Beñat Turrientes,ESP,MF,Real Sociedad,19,2002,2.3,0,0,0,0,0,0,4,0.0,4,1,0,1,2,2,2,0,La_Liga,2021_2022
Samuel Umtiti,FRA,DF,Barcelona,27,1993,1.0,2,2,2,0,0,1,2,50.0,1,1,1,0,0,2,4,0,La_Liga,2021_2022
Enes Ünal,TUR,FW,Getafe,24,1997,31.1,37,22,2,18,17,5,42,11.9,37,25,5,20,5,42,36,0,La_Liga,2021_2022
Myrto Uzuni,ALB,"FW,MF",Granada,26,1995,9.5,7,4,6,1,0,0,2,0.0,2,13,1,12,10,17,7,0,La_Liga,2021_2022
Álvaro Vadillo,ESP,"DF,MF",Espanyol,26,1994,0.1,1,1,1,0,0,1,2,50.0,1,0,0,0,0,1,1,0,La_Liga,2021_2022
Óscar Valentín,ESP,MF,Rayo Vallecano,26,1994,28.5,102,53,46,51,5,44,105,41.9,61,56,10,46,39,141,43,0,La_Liga,2021_2022
Germán Valera,ESP,FW,Real Sociedad,19,2002,0.6,3,2,3,0,0,1,1,100.0,0,0,0,0,0,3,1,0,La_Liga,2021_2022
Martin Valjent,SVK,DF,Mallorca,25,1995,35.3,31,19,18,12,1,13,24,54.2,11,34,26,8,31,62,173,1,La_Liga,2021_2022
Jesús Vallejo,ESP,DF,Real Madrid,24,1997,3.8,7,5,7,0,0,5,6,83.3,1,9,8,1,6,13,16,0,La_Liga,2021_2022
Manu Vallejo,ESP,"MF,FW",Alavés,24,1997,4.1,8,2,1,4,3,4,13,30.8,9,7,0,7,0,8,4,0,La_Liga,2021_2022
Manu Vallejo,ESP,"FW,MF",Valencia,24,1997,1.1,2,1,1,1,0,0,1,0.0,1,0,0,0,0,2,1,0,La_Liga,2021_2022
Federico Valverde,URU,MF,Real Madrid,23,1998,20.4,36,16,11,16,9,12,31,38.7,19,23,5,18,24,60,12,0,La_Liga,2021_2022
José Luis García Vayá,ESP,MF,Levante,22,1998,22.4,46,27,10,31,5,16,41,39.0,25,24,5,19,38,84,30,0,La_Liga,2021_2022
Jesus Vazquez,ESP,DF,Valencia,18,2003,9.0,24,13,10,8,6,10,22,45.5,12,16,3,13,9,33,19,0,La_Liga,2021_2022
Kevin Vázquez,ESP,DF,Celta Vigo,28,1993,14.8,34,24,12,13,9,14,28,50.0,14,20,7,13,36,70,34,0,La_Liga,2021_2022
Lucas Vázquez,ESP,DF,Real Madrid,30,1991,20.4,43,22,24,9,10,17,35,48.6,18,25,7,18,20,63,41,1,La_Liga,2021_2022
Gabriel Veiga,ESP,MF,Celta Vigo,19,2002,1.2,5,4,0,4,1,3,12,25.0,9,2,0,2,4,9,1,0,La_Liga,2021_2022
Unai Vencedor Paris,ESP,MF,Athletic Club,20,2000,26.5,26,11,11,9,6,8,42,19.0,34,31,13,18,19,45,22,0,La_Liga,2021_2022
Gonzalo Verdú,ESP,DF,Elche,32,1988,15.5,19,9,15,4,0,8,16,50.0,8,20,14,6,13,32,59,1,La_Liga,2021_2022
Mikel Vesga,ESP,MF,Athletic Club,28,1993,15.1,27,14,7,18,2,11,31,35.5,20,16,5,11,20,47,34,2,La_Liga,2021_2022
Rúben Vezo,POR,DF,Levante,27,1994,26.9,41,29,28,12,1,26,41,63.4,15,41,25,16,36,77,105,1,La_Liga,2021_2022
Aleix Vidal,ESP,"DF,MF",Espanyol,31,1989,21.1,31,25,17,9,5,19,39,48.7,20,19,6,13,25,56,35,2,La_Liga,2021_2022
Nacho Vidal,ESP,DF,Osasuna,26,1995,32.2,83,47,49,25,9,39,77,50.6,38,32,14,18,58,141,79,0,La_Liga,2021_2022
Dídac Vilà,ESP,"DF,MF",Espanyol,32,1989,2.3,7,5,2,5,0,4,9,44.4,5,2,1,1,3,10,8,0,La_Liga,2021_2022
Tonny Vilhena,NED,"MF,FW",Espanyol,26,1995,10.3,16,6,7,8,1,7,21,33.3,14,10,2,8,8,24,17,0,La_Liga,2021_2022
Daniel Villahermosa,ESP,MF,Espanyol,20,2001,0.3,0,0,0,0,0,0,0,,0,0,0,0,0,0,1,0,La_Liga,2021_2022
Asier Villalibre,ESP,FW,Athletic Club,23,1997,6.1,4,3,2,1,1,1,2,50.0,1,3,1,2,1,5,7,0,La_Liga,2021_2022
Gonzalo Villar,ESP,MF,Getafe,23,1998,3.3,5,3,4,1,0,2,5,40.0,3,4,1,3,1,6,1,0,La_Liga,2021_2022
Vitolo,ESP,MF,Getafe,31,1989,2.5,3,2,1,1,1,2,5,40.0,3,3,0,3,1,4,1,0,La_Liga,2021_2022
Daniel Vivian,ESP,DF,Athletic Club,22,1999,22.1,32,21,24,7,1,17,24,70.8,7,20,15,5,26,58,107,1,La_Liga,2021_2022
Šime Vrsaljko,CRO,DF,Atlético Madrid,29,1992,10.2,27,17,14,12,1,12,20,60.0,8,10,1,9,12,39,30,0,La_Liga,2021_2022
Nikola Vukčević,MNE,MF,Levante,29,1991,1.3,3,2,2,1,0,0,1,0.0,1,2,0,2,2,5,1,0,La_Liga,2021_2022
Daniel Wass,DEN,"DF,FW",Atlético Madrid,32,1989,0.5,0,0,0,0,0,0,0,,0,0,0,0,0,0,3,0,La_Liga,2021_2022
Daniel Wass,DEN,MF,Valencia,32,1989,17.6,23,13,6,14,3,8,31,25.8,23,13,2,11,13,36,19,0,La_Liga,2021_2022
Iñaki Williams,GHA,FW,Athletic Club,27,1994,30.9,14,5,1,6,7,5,17,29.4,12,18,3,15,3,17,20,0,La_Liga,2021_2022
Nico Williams,ESP,MF,Athletic Club,19,2002,14.9,20,10,6,11,3,10,31,32.3,21,18,2,16,5,25,9,0,La_Liga,2021_2022
Okay Yokuşlu,TUR,"DF,MF",Getafe,27,1994,5.2,9,8,6,2,1,5,5,100.0,0,7,5,2,5,14,17,0,La_Liga,2021_2022
Okay Yokuşlu,TUR,"DF,MF",Celta Vigo,27,1994,1.6,4,1,2,1,1,2,3,66.7,1,2,1,1,2,6,6,0,La_Liga,2021_2022
Joseba Zaldúa,ESP,DF,Real Sociedad,29,1992,13.0,31,22,20,8,3,16,22,72.7,6,14,4,10,13,44,35,0,La_Liga,2021_2022
Oier Zarraga,ESP,MF,Athletic Club,22,1999,13.0,13,5,4,7,2,3,28,10.7,25,17,10,7,19,32,10,0,La_Liga,2021_2022
Luca Zidane,FRA,GK,Rayo Vallecano,23,1998,7.2,0,0,0,0,0,0,1,0.0,1,0,0,0,0,0,1,1,La_Liga,2021_2022
Igor Zubeldia,ESP,DF,Real Sociedad,24,1997,18.3,20,10,12,8,0,12,18,66.7,6,16,6,10,27,47,53,0,La_Liga,2021_2022
Martín Zubimendi,ESP,MF,Real Sociedad,22,1999,28.8,52,25,19,30,3,22,44,50.0,22,30,13,17,49,101,48,1,La_Liga,2021_2022
Abner,BRA,DF,Betis,22,2000,6.7,12,9,9,2,1,7,16,43.8,9,8,2,6,8,20,24,0,La_Liga,2022_2023
Álvaro Aceves,ESP,GK,Valladolid,19,2003,0.1,0,0,0,0,0,0,0,,0,0,0,0,0,0,0,0,La_Liga,2022_2023
Marcos Acuña,ARG,DF,Sevilla,30,1991,21.2,57,36,34,17,6,30,42,71.4,12,16,5,11,23,80,36,0,La_Liga,2022_2023
Julen Agirrezabala,ESP,GK,Athletic Club,21,2000,7.5,0,0,0,0,0,0,0,,0,0,0,0,0,0,2,0,La_Liga,2022_2023
Álvaro Aguado,ESP,MF,Valladolid,26,1996,21.0,27,15,13,11,3,15,25,60.0,10,16,4,12,13,40,15,0,La_Liga,2022_2023
Joseph Aidoo,GHA,DF,Celta Vigo,26,1995,34.7,51,36,33,17,1,16,28,57.1,12,26,14,12,31,82,150,0,La_Liga,2022_2023
Sergio Akieme,ESP,DF,Almería,24,1997,25.5,27,16,19,6,2,12,22,54.5,10,22,6,16,14,41,41,0,La_Liga,2022_2023
Babatunde Akinsola,NGA,FW,Valladolid,19,2003,0.1,1,1,0,0,1,0,0,,0,0,0,0,0,1,0,0,La_Liga,2022_2023
Paul Akouokou,CIV,"MF,DF",Betis,24,1997,5.0,16,9,13,3,0,13,20,65.0,7,2,2,0,12,28,17,1,La_Liga,2022_2023
David Alaba,AUT,DF,Real Madrid,30,1992,20.4,15,11,8,4,3,9,15,60.0,6,18,9,9,14,29,37,1,La_Liga,2022_2023
Ángel Alarcón,ESP,"FW,MF",Barcelona,18,2004,0.3,0,0,0,0,0,0,2,0.0,2,0,0,0,0,0,0,0,La_Liga,2022_2023
Tomás Alarcón,CHI,MF,Cádiz,23,1999,2.5,3,2,0,2,1,1,2,50.0,1,1,0,1,2,5,2,0,La_Liga,2022_2023
Jordi Alba,ESP,DF,Barcelona,33,1989,15.8,25,18,13,11,1,12,28,42.9,16,12,5,7,11,36,23,0,La_Liga,2022_2023
Raúl Albiol,ESP,DF,Villarreal,36,1985,23.5,25,17,17,6,2,14,18,77.8,4,17,13,4,14,39,111,0,La_Liga,2022_2023
Rubén Alcaraz,ESP,MF,Cádiz,31,1991,22.7,43,31,24,18,1,19,54,35.2,35,23,8,15,19,62,37,0,La_Liga,2022_2023
Omar Alderete,PAR,DF,Getafe,25,1996,22.7,35,20,21,14,0,28,40,70.0,12,23,16,7,26,61,85,0,La_Liga,2022_2023
Iván Alejo,ESP,"MF,FW",Cádiz,27,1995,14.6,32,21,19,9,4,17,37,45.9,20,18,3,15,5,37,12,1,La_Liga,2022_2023
Carles Aleñá,ESP,"MF,FW",Getafe,24,1998,23.5,18,10,7,5,6,5,34,14.7,29,19,1,18,4,22,18,0,La_Liga,2022_2023
Alejandro Alfaro,ESP,MF,Elche,20,2002,0.2,0,0,0,0,0,0,0,,0,0,0,0,0,0,0,0,La_Liga,2022_2023
Ángel Algobia,ESP,MF,Getafe,23,1999,12.6,27,13,14,13,0,22,48,45.8,26,15,5,10,3,30,11,0,La_Liga,2022_2023
Mohamed Ali Cho,FRA,"FW,MF",Real Sociedad,18,2004,6.5,13,10,6,5,2,4,10,40.0,6,9,0,9,2,15,2,0,La_Liga,2022_2023
Domingos André Ribeiro Almeida,POR,MF,Valencia,22,2000,28.2,66,42,23,32,11,26,57,45.6,31,26,0,26,20,86,16,1,La_Liga,2022_2023
Marcos Alonso,ESP,DF,Barcelona,31,1990,13.0,15,10,10,5,0,9,12,75.0,3,14,10,4,11,26,32,0,La_Liga,2022_2023
Carlos Álvarez,ESP,MF,Sevilla,18,2003,0.1,1,1,0,1,0,0,0,,0,0,0,0,0,1,0,0,La_Liga,2022_2023
Gastón Álvarez,URU,DF,Getafe,22,2000,16.7,38,30,24,9,5,23,42,54.8,19,15,5,10,15,53,35,0,La_Liga,2022_2023
Yeray Álvarez,ESP,DF,Athletic Club,27,1995,25.9,34,23,26,7,1,24,31,77.4,7,23,13,10,48,82,101,0,La_Liga,2022_2023
Selim Amallah,MAR,"MF,FW",Valladolid,25,1996,3.0,15,9,7,8,0,5,8,62.5,3,2,0,2,5,20,2,0,La_Liga,2022_2023
Amath,SEN,"MF,FW",Mallorca,26,1996,13.6,29,19,14,8,7,14,22,63.6,8,13,1,12,5,34,5,0,La_Liga,2022_2023
Jordan Amavi,FRA,DF,Getafe,28,1994,2.2,3,2,3,0,0,1,3,33.3,2,3,0,3,4,7,7,0,La_Liga,2022_2023
Marcos André,BRA,"FW,MF",Valencia,25,1996,5.0,4,1,1,1,2,1,2,50.0,1,4,1,3,0,4,0,0,La_Liga,2022_2023
Fabrizio Angileri,ARG,DF,Getafe,28,1994,6.5,12,9,8,3,1,10,17,58.8,7,8,3,5,7,19,10,0,La_Liga,2022_2023
Josep Antoni Gayá,ESP,"DF,MF",Mallorca,22,2000,1.1,0,0,0,0,0,0,0,,0,4,2,2,1,1,6,0,La_Liga,2022_2023
José Antonio,ESP,"MF,DF",Cádiz,18,2004,0.5,2,1,0,0,2,0,0,,0,0,0,0,0,2,0,0,La_Liga,2022_2023
Anuar,MAR,"MF,FW",Valladolid,27,1995,2.3,4,4,0,1,3,0,0,,0,5,2,3,3,7,3,0,La_Liga,2022_2023
Mauro Arambarri,URU,MF,Getafe,26,1995,11.0,14,6,9,4,1,3,17,17.6,14,17,5,12,14,28,19,0,La_Liga,2022_2023
Ronald Araújo,URU,DF,Barcelona,23,1999,20.0,26,18,12,13,1,6,9,66.7,3,15,7,8,12,38,41,1,La_Liga,2022_2023
Adu Ares,ESP,"FW,MF",Athletic Club,20,2001,0.9,4,2,2,1,1,4,4,100.0,0,1,0,1,2,6,1,0,La_Liga,2022_2023
Sergio Arribas,ESP,"MF,FW",Real Madrid,20,2001,0.2,0,0,0,0,0,0,0,,0,1,0,1,0,0,0,0,La_Liga,2022_2023
Roberto Arroyo,ESP,MF,Valladolid,18,2003,0.2,1,1,0,1,0,1,1,100.0,0,0,0,0,0,1,0,0,La_Liga,2022_2023
Ricard Artero,ESP,"MF,FW",Girona,19,2003,1.5,3,3,2,1,0,1,1,100.0,0,2,0,2,1,4,3,0,La_Liga,2022_2023
Santiago Arzamendia,PAR,"DF,MF",Cádiz,24,1998,5.4,9,8,7,1,1,6,21,28.6,15,11,1,10,2,11,15,1,La_Liga,2022_2023
Sergio Asenjo,ESP,GK,Valladolid,33,1989,10.0,0,0,0,0,0,0,0,,0,0,0,0,0,0,10,2,La_Liga,2022_2023
Marco Asensio,ESP,"FW,MF",Real Madrid,26,1996,16.0,16,10,8,6,2,8,19,42.1,11,8,3,5,5,21,4,0,La_Liga,2022_2023
Iago Aspas,ESP,FW,Celta Vigo,34,1987,31.9,8,4,0,4,4,3,22,13.6,19,10,1,9,7,15,23,0,La_Liga,2022_2023
Pierre-Emerick Aubameyang,GAB,FW,Barcelona,33,1989,0.1,0,0,0,0,0,0,0,,0,0,0,0,0,0,0,0,La_Liga,2022_2023
Ludwig Augustinsson,SWE,DF,Mallorca,28,1994,1.5,2,1,2,0,0,1,3,33.3,2,1,0,1,1,3,3,0,La_Liga,2022_2023
Ezequiel Ávila,ARG,"FW,MF",Osasuna,28,1994,19.0,8,5,2,4,2,6,23,26.1,17,12,1,11,8,16,16,0,La_Liga,2022_2023
Iddrisu Baba,GHA,"MF,DF",Mallorca,26,1996,18.9,31,17,15,16,0,15,32,46.9,17,18,8,10,11,42,39,0,La_Liga,2022_2023
Srđan Babić,SRB,DF,Almería,26,1996,33.3,28,18,20,8,0,15,32,46.9,17,34,22,12,29,57,124,1,La_Liga,2022_2023
Loïc Bade,FRA,DF,Sevilla,22,2000,16.1,27,20,23,3,1,17,30,56.7,13,21,13,8,23,50,77,0,La_Liga,2022_2023
Édgar Badía,ESP,GK,Elche,30,1992,36.0,1,0,1,0,0,1,2,50.0,1,0,0,0,0,1,19,3,La_Liga,2022_2023
Alex Baena,ESP,"MF,FW",Villarreal,21,2001,21.6,30,17,9,15,6,15,45,33.3,30,15,3,12,7,37,16,0,La_Liga,2022_2023
Alejandro Balde,ESP,DF,Barcelona,18,2003,27.5,42,30,22,16,4,24,41,58.5,17,25,3,22,12,54,17,1,La_Liga,2022_2023
Mikel Balenziaga,ESP,DF,Athletic Club,34,1988,1.3,4,4,1,2,1,4,4,100.0,0,0,0,0,1,5,2,0,La_Liga,2022_2023
Iván Balliu,ALB,DF,Rayo Vallecano,30,1992,35.9,52,29,26,20,6,18,30,60.0,12,26,3,23,25,77,72,1,La_Liga,2022_2023
Léo Baptistão,BRA,"FW,MF",Almería,29,1992,19.2,32,20,13,16,3,13,33,39.4,20,17,2,15,19,51,12,0,La_Liga,2022_2023
Keidi Bare,ALB,MF,Espanyol,24,1997,5.6,15,8,7,5,3,7,13,53.8,6,8,2,6,11,26,8,0,La_Liga,2022_2023
Kike Barja,ESP,"FW,MF",Osasuna,25,1997,14.6,15,9,6,5,4,8,24,33.3,16,7,0,7,4,19,3,0,La_Liga,2022_2023
Ander Barrenetxea,ESP,"FW,DF",Real Sociedad,20,2001,9.8,21,15,15,6,0,12,28,42.9,16,15,1,14,5,26,7,0,La_Liga,2022_2023
Pablo Barrios,ESP,MF,Atlético Madrid,19,2003,8.0,19,10,3,10,6,8,15,53.3,7,12,2,10,9,28,6,1,La_Liga,2022_2023
Rodrigo Battaglia,ARG,MF,Mallorca,31,1991,7.6,12,5,7,5,0,6,14,42.9,8,16,7,9,5,17,18,0,La_Liga,2022_2023
Bebé,CPV,FW,Rayo Vallecano,32,1990,0.7,0,0,0,0,0,0,2,0.0,2,1,0,1,0,0,0,0,La_Liga,2022_2023
Héctor Bellerín,ESP,DF,Barcelona,27,1995,1.6,2,0,0,2,0,2,3,66.7,1,2,0,2,3,5,2,0,La_Liga,2022_2023
Fran Beltrán,ESP,MF,Celta Vigo,23,1999,31.7,34,22,15,14,5,14,55,25.5,41,29,5,24,53,87,35,2,La_Liga,2022_2023
Iker Benito,ESP,"FW,MF",Osasuna,19,2002,2.0,4,3,0,3,1,2,4,50.0,2,0,0,0,2,6,4,0,La_Liga,2022_2023
Karim Benzema,FRA,FW,Real Madrid,34,1987,22.6,9,5,2,4,3,2,11,18.2,9,11,0,11,2,11,5,0,La_Liga,2022_2023
Yuri Berchiche,ESP,DF,Athletic Club,32,1990,26.7,56,32,28,20,8,35,59,59.3,24,37,12,25,40,96,59,1,La_Liga,2022_2023
Álex Berenguer,ESP,FW,Athletic Club,27,1995,25.5,58,37,17,25,16,23,60,38.3,37,37,4,33,10,68,6,0,La_Liga,2022_2023
Pedro Bigas,ESP,DF,Elche,31,1990,22.4,37,20,30,7,0,18,29,62.1,11,25,14,11,33,70,95,0,La_Liga,2022_2023
El Bilal Touré,MLI,FW,Almería,20,2001,14.0,4,3,2,1,1,0,3,0.0,3,6,1,5,1,5,23,0,La_Liga,2022_2023
Antonio Blanco,ESP,MF,Cádiz,22,2000,1.8,6,4,5,1,0,4,6,66.7,2,5,0,5,1,7,3,0,La_Liga,2022_2023
Lautaro Blanco,ARG,"DF,MF",Elche,23,1999,9.7,16,9,10,4,2,9,26,34.6,17,8,1,7,2,18,10,1,La_Liga,2022_2023
Theo Bongonda,COD,"MF,FW",Cádiz,26,1995,21.5,28,20,11,14,3,17,40,42.5,23,21,2,19,6,34,14,0,La_Liga,2022_2023
Yassine Bounou,MAR,GK,Sevilla,31,1991,23.9,2,1,2,0,0,1,4,25.0,3,0,0,0,2,4,11,1,La_Liga,2022_2023
Lucas Boyé,ARG,FW,Elche,26,1996,27.4,36,16,12,16,8,17,35,48.6,18,33,5,28,15,51,46,0,La_Liga,2022_2023
Martin Braithwaite,DEN,"FW,MF",Espanyol,31,1991,27.3,12,2,2,4,6,5,14,35.7,9,10,0,10,5,17,11,0,La_Liga,2022_2023
Darko Brašanac,SRB,MF,Osasuna,30,1992,11.6,29,20,12,10,7,12,23,52.2,11,14,2,12,12,41,9,0,La_Liga,2022_2023
Claudio Bravo,CHI,GK,Betis,39,1983,12.0,0,0,0,0,0,0,0,,0,0,0,0,2,2,1,1,La_Liga,2022_2023
Ante Budimir,CRO,FW,Osasuna,31,1991,20.0,19,9,0,12,7,2,10,20.0,8,10,0,10,5,24,19,0,La_Liga,2022_2023
Manu Bueno,ESP,MF,Sevilla,18,2004,1.7,7,4,3,3,1,5,8,62.5,3,0,0,0,0,7,2,0,La_Liga,2022_2023
Santiago Bueno,URU,DF,Girona,23,1998,33.4,63,38,43,19,1,24,36,66.7,12,34,22,12,31,94,105,2,La_Liga,2022_2023
Sergio Busquets,ESP,MF,Barcelona,34,1988,26.0,58,26,24,26,8,29,51,56.9,22,32,6,26,27,85,36,2,La_Liga,2022_2023
Leandro Cabrera,URU,DF,Espanyol,31,1991,29.7,46,24,34,12,0,28,43,65.1,15,37,23,14,43,89,114,2,La_Liga,2022_2023
Cala,ESP,DF,Cádiz,32,1989,1.5,2,1,1,1,0,1,2,50.0,1,2,1,1,1,3,12,0,La_Liga,2022_2023
Fernando Calero,ESP,"DF,MF",Espanyol,26,1995,17.9,46,29,27,15,4,21,34,61.8,13,31,13,18,13,59,52,0,La_Liga,2022_2023
Alexander Callens,PER,DF,Girona,30,1992,1.3,3,3,2,1,0,3,4,75.0,1,3,1,2,1,4,9,0,La_Liga,2022_2023
Eduardo Camavinga,FRA,"MF,DF",Real Madrid,19,2002,22.3,68,48,32,21,15,24,64,37.5,40,24,5,19,17,85,25,0,La_Liga,2022_2023
Sergio Camello,ESP,FW,Rayo Vallecano,21,2001,26.7,16,10,3,9,4,5,17,29.4,12,9,1,8,2,18,26,0,La_Liga,2022_2023
Sergio Canales,ESP,"FW,MF",Betis,31,1991,26.7,25,14,10,8,7,14,33,42.4,19,18,0,18,14,39,8,0,La_Liga,2022_2023
Ander Capa,ESP,DF,Athletic Club,30,1992,1.2,1,1,1,0,0,1,5,20.0,4,5,0,5,0,1,2,0,La_Liga,2022_2023
Étienne Capoue,FRA,MF,Villarreal,34,1988,21.7,21,12,6,13,2,10,18,55.6,8,12,5,7,19,40,20,1,La_Liga,2022_2023
Isaac Carcelen,ESP,DF,Cádiz,29,1993,24.4,69,51,41,22,6,41,63,65.1,22,35,11,24,19,88,80,1,La_Liga,2022_2023
Juan Carlos,ESP,GK,Girona,34,1988,10.0,0,0,0,0,0,0,0,,0,0,0,0,1,1,7,1,La_Liga,2022_2023
José Carlos Lazo,ESP,"MF,FW",Almería,26,1996,0.2,0,0,0,0,0,0,0,,0,0,0,0,0,0,0,0,La_Liga,2022_2023
José Carlos Lazo,ESP,"MF,FW",Espanyol,26,1996,1.8,5,3,2,2,1,3,3,100.0,0,2,0,2,3,8,5,0,La_Liga,2022_2023
Carmona,ESP,"MF,DF",Elche,20,2002,6.5,16,9,7,6,3,6,16,37.5,10,14,2,12,8,24,9,0,La_Liga,2022_2023
Carmona,ESP,DF,Sevilla,20,2002,5.9,13,11,5,3,5,9,16,56.3,7,10,6,4,7,20,17,1,La_Liga,2022_2023
Yannick Carrasco,BEL,"DF,MF",Atlético Madrid,28,1993,25.7,35,14,21,10,4,23,54,42.6,31,23,1,22,12,47,19,0,La_Liga,2022_2023
Dani Carvajal,ESP,DF,Real Madrid,30,1992,19.8,32,18,15,12,5,18,35,51.4,17,24,6,18,15,47,49,0,La_Liga,2022_2023
William Carvalho,POR,MF,Betis,30,1992,27.1,43,27,18,23,2,17,44,38.6,27,27,6,21,16,59,22,0,La_Liga,2022_2023
Casemiro,BRA,MF,Real Madrid,30,1992,0.1,0,0,0,0,0,0,0,,0,0,0,0,0,0,1,0,La_Liga,2022_2023
Valentín Castellanos,ARG,FW,Girona,23,1998,28.9,12,5,2,7,3,0,18,0.0,18,22,2,20,6,18,26,0,La_Liga,2022_2023
Samu Castillejo,ESP,"FW,MF",Valencia,27,1995,15.1,21,12,8,9,4,8,40,20.0,32,21,2,19,9,30,2,0,La_Liga,2022_2023
Catena,ESP,DF,Rayo Vallecano,27,1994,34.5,29,14,23,4,2,13,27,48.1,14,32,25,7,28,57,159,1,La_Liga,2022_2023
Edinson Cavani,URU,FW,Valencia,35,1987,16.1,7,4,3,3,1,3,15,20.0,12,10,3,7,2,9,11,0,La_Liga,2022_2023
Dani Ceballos,ESP,MF,Real Madrid,25,1996,17.4,43,29,13,15,15,25,64,39.1,39,23,2,21,25,68,6,1,La_Liga,2022_2023
Álex Centelles,ESP,DF,Almería,24,1997,12.5,22,14,16,3,3,16,22,72.7,6,13,2,11,11,33,40,0,La_Liga,2022_2023
Franco Cervi,ARG,"MF,DF",Celta Vigo,28,1994,21.0,76,46,29,36,11,33,66,50.0,33,33,1,32,36,112,16,0,La_Liga,2022_2023
Pep Chavarría,ESP,"FW,MF",Rayo Vallecano,24,1998,4.1,6,4,2,1,3,1,5,20.0,4,8,0,8,2,8,8,0,La_Liga,2022_2023
Pape Cheikh Diop,SEN,MF,Elche,24,1997,0.4,0,0,0,0,0,0,1,0.0,1,0,0,0,0,0,0,0,La_Liga,2022_2023
Andreas Christensen,DEN,DF,Barcelona,26,1996,19.6,20,15,9,11,0,10,16,62.5,6,14,12,2,21,41,47,0,La_Liga,2022_2023
Samuel Chukwueze,NGA,"FW,MF",Villarreal,23,1999,26.0,14,7,7,2,5,7,23,30.4,16,13,0,13,12,26,16,0,La_Liga,2022_2023
Chumi,ESP,DF,Almería,23,1999,16.5,29,16,18,9,2,14,23,60.9,9,20,7,13,15,44,53,0,La_Liga,2022_2023
Víctor Chust,ESP,DF,Cádiz,22,2000,10.7,9,6,7,2,0,4,7,57.1,3,8,3,5,10,19,53,0,La_Liga,2022_2023
Pathé Ciss,SEN,"MF,DF",Rayo Vallecano,28,1994,14.2,39,29,11,23,5,15,34,44.1,19,23,10,13,22,61,34,0,La_Liga,2022_2023
Carlos Clerc,ESP,"DF,MF",Elche,30,1992,29.3,75,51,55,16,4,31,50,62.0,19,29,7,22,28,103,94,1,La_Liga,2022_2023
Álex Collado,ESP,MF,Elche,23,1999,8.0,26,14,13,11,2,8,13,61.5,5,12,1,11,2,28,4,0,La_Liga,2022_2023
Diego Collado,ESP,FW,Villarreal,21,2001,0.1,0,0,0,0,0,0,0,,0,0,0,0,0,0,0,0,La_Liga,2022_2023
Eray Cömert,SUI,DF,Valencia,24,1998,18.6,35,23,24,10,1,17,33,51.5,16,23,8,15,29,64,76,1,La_Liga,2022_2023
Santi Comesaña,ESP,MF,Rayo Vallecano,25,1996,27.2,71,44,24,41,6,38,82,46.3,44,39,3,36,32,103,17,0,La_Liga,2022_2023
Copete,ESP,DF,Mallorca,22,1999,24.5,53,28,35,16,2,26,36,72.2,10,38,17,21,44,97,111,2,La_Liga,2022_2023
Francis Coquelin,FRA,MF,Villarreal,31,1991,8.3,18,13,7,9,2,7,7,100.0,0,8,2,6,9,27,7,0,La_Liga,2022_2023
Jesús Corona,MEX,FW,Sevilla,29,1993,1.2,1,0,1,0,0,0,1,0.0,1,0,0,0,1,2,1,0,La_Liga,2022_2023
Ángel Correa,ARG,"FW,MF",Atlético Madrid,27,1995,16.2,12,6,6,3,3,5,16,31.3,11,17,0,17,10,22,6,1,La_Liga,2022_2023
Thierry Correia,POR,DF,Valencia,23,1999,22.3,71,52,46,22,3,31,54,57.4,23,25,2,23,24,95,54,2,La_Liga,2022_2023
Jaume Costa,ESP,DF,Mallorca,34,1988,28.9,50,34,26,17,7,29,51,56.9,22,13,5,8,22,72,44,1,La_Liga,2022_2023
Samu Costa,POR,MF,Almería,21,2000,22.1,61,31,35,20,6,29,61,47.5,32,29,7,22,37,98,64,4,La_Liga,2022_2023
Thibaut Courtois,BEL,GK,Real Madrid,30,1992,31.0,1,0,1,0,0,1,1,100.0,0,0,0,0,3,4,7,1,La_Liga,2022_2023
Yan Couto,BRA,"DF,MF",Girona,20,2002,12.9,25,18,11,11,3,12,20,60.0,8,7,2,5,5,30,10,0,La_Liga,2022_2023
Juan Cruz Armada,ESP,DF,Osasuna,30,1992,22.9,24,14,17,4,3,13,23,56.5,10,21,8,13,13,37,58,0,La_Liga,2022_2023
Juan Cruz,ESP,FW,Betis,22,2000,2.0,1,0,0,1,0,1,3,33.3,2,1,0,1,0,1,0,0,La_Liga,2022_2023
Jorge Cuenca,ESP,DF,Villarreal,22,1999,5.6,9,7,7,2,0,4,7,57.1,3,10,8,2,6,15,44,0,La_Liga,2022_2023
Braian Cufré,ARG,DF,Mallorca,25,1996,2.4,5,2,2,1,2,2,5,40.0,3,2,1,1,2,7,1,0,La_Liga,2022_2023
Matheus Cunha,BRA,"FW,MF",Atlético Madrid,23,1999,4.2,4,1,1,3,0,0,3,0.0,3,4,1,3,2,6,3,0,La_Liga,2022_2023
Curro,ESP,MF,Almería,26,1996,0.5,2,0,1,1,0,1,2,50.0,1,0,0,0,0,2,0,0,La_Liga,2022_2023
Arnaut Danjuma,NED,FW,Villarreal,25,1997,5.3,3,3,1,0,2,1,2,50.0,1,0,0,0,0,3,1,1,La_Liga,2022_2023
Sergi Darder,ESP,MF,Espanyol,28,1993,36.9,69,38,12,43,14,29,73,39.7,44,34,2,32,24,93,23,0,La_Liga,2022_2023
Rodrigo De Paul,ARG,MF,Atlético Madrid,28,1994,21.4,35,21,11,18,6,18,35,51.4,17,20,3,17,8,43,7,0,La_Liga,2022_2023
Alberto Del Moral,ESP,MF,Villarreal,22,2000,0.1,0,0,0,0,0,0,0,,0,0,0,0,0,0,0,0,La_Liga,2022_2023
Thomas Delaney,DEN,MF,Sevilla,30,1991,3.4,4,2,0,4,0,3,5,60.0,2,3,2,1,4,8,3,0,La_Liga,2022_2023
Fran Delgado,ESP,DF,Betis,21,2001,0.1,0,0,0,0,0,0,0,,0,0,0,0,0,0,0,0,La_Liga,2022_2023
Ousmane Dembélé,FRA,FW,Barcelona,25,1997,15.7,19,12,4,8,7,4,15,26.7,11,10,1,9,0,19,2,0,La_Liga,2022_2023
Mouctar Diakhaby,GUI,DF,Valencia,25,1996,27.2,30,16,19,11,0,13,20,65.0,7,30,17,13,20,50,111,2,La_Liga,2022_2023
Mamady Diarra,MLI,"MF,DF",Cádiz,22,2000,0.7,2,1,2,0,0,1,2,50.0,1,2,0,2,0,2,0,0,La_Liga,2022_2023
Youba Diarra,MLI,MF,Cádiz,24,1998,1.1,3,0,2,1,0,1,5,20.0,4,7,1,6,2,5,3,0,La_Liga,2022_2023
Stole Dimitrievski,MKD,GK,Rayo Vallecano,28,1993,36.9,1,0,1,0,0,1,2,50.0,1,2,0,2,1,2,17,3,La_Liga,2022_2023
Djené,TOG,DF,Getafe,30,1991,31.6,41,28,23,17,1,22,38,57.9,16,25,10,15,42,83,81,1,La_Liga,2022_2023
Marko Dmitrović,SRB,GK,Sevilla,30,1992,14.1,0,0,0,0,0,0,0,,0,0,0,0,0,0,6,0,La_Liga,2022_2023
Matt Doherty,IRL,DF,Atlético Madrid,30,1992,0.2,0,0,0,0,0,0,0,,0,2,0,2,0,0,0,0,La_Liga,2022_2023
Kasper Dolberg,DEN,FW,Sevilla,24,1997,2.2,1,0,0,1,0,1,3,33.3,2,0,0,0,0,1,5,0,La_Liga,2022_2023
Carlos Dominguez,ESP,DF,Celta Vigo,21,2001,1.2,1,1,0,1,0,1,2,50.0,1,1,1,0,0,1,7,0,La_Liga,2022_2023
John Donald,ESP,"MF,DF",Elche,21,2000,12.1,20,11,9,9,2,7,14,50.0,7,14,7,7,14,34,23,1,La_Liga,2022_2023
Domingos Duarte,POR,DF,Getafe,27,1995,29.5,26,18,21,5,0,19,26,73.1,7,29,23,6,39,65,145,0,La_Liga,2022_2023
Pablo Durán,ESP,"MF,DF",Celta Vigo,21,2001,0.4,0,0,0,0,0,0,0,,0,2,1,1,1,1,2,0,La_Liga,2022_2023
Hugo Duro,ESP,FW,Valencia,22,1999,15.4,15,12,2,6,7,7,17,41.2,10,11,1,10,2,17,7,1,La_Liga,2022_2023
Íñigo Eguaras,ESP,MF,Almería,30,1992,10.7,11,8,4,6,1,5,18,27.8,13,9,3,6,6,17,15,0,La_Liga,2022_2023
Aritz Elustondo,ESP,DF,Real Sociedad,28,1994,16.1,26,17,15,10,1,14,26,53.8,12,15,6,9,20,46,43,1,La_Liga,2022_2023
Rodrigo Ely,BRA,DF,Almería,28,1993,35.1,30,21,26,4,0,18,25,72.0,7,46,33,13,31,61,203,1,La_Liga,2022_2023
Adri Embarba,ESP,"FW,MF",Almería,30,1992,16.4,50,27,21,26,3,22,46,47.8,24,23,0,23,9,59,9,0,La_Liga,2022_2023
Adri Embarba,ESP,FW,Espanyol,30,1992,0.4,1,0,0,1,0,1,1,100.0,0,1,0,1,0,1,0,0,La_Liga,2022_2023
Youssef En-Nesyri,MAR,FW,Sevilla,25,1997,18.5,16,8,3,7,6,4,14,28.6,10,6,2,4,4,20,16,0,La_Liga,2022_2023
Gonzalo Escalante,ARG,MF,Cádiz,29,1993,12.5,36,24,15,20,1,15,29,51.7,14,18,4,14,17,53,26,1,La_Liga,2022_2023
Sergio Escudero,ESP,DF,Valladolid,32,1989,16.0,33,19,21,8,4,15,35,42.9,20,26,6,20,26,59,46,0,La_Liga,2022_2023
Alfonso Espino,URU,DF,Cádiz,30,1992,34.7,87,56,55,20,12,48,96,50.0,48,52,11,41,48,135,99,3,La_Liga,2022_2023
Bernardo Espinosa,COL,DF,Girona,33,1989,13.6,6,2,2,4,0,3,9,33.3,6,17,10,7,12,18,70,2,La_Liga,2022_2023
Edu Expósito,ESP,MF,Espanyol,25,1996,12.9,34,20,16,15,3,13,23,56.5,10,7,0,7,12,46,20,0,La_Liga,2022_2023
Nicolás Ezequiel Fernández,ARG,"MF,DF",Elche,22,2000,5.7,23,12,10,7,6,9,17,52.9,8,7,0,7,5,28,2,1,La_Liga,2022_2023
Abde Ezzalzouli,MAR,"FW,MF",Osasuna,20,2001,16.7,29,19,13,12,4,13,23,56.5,10,20,0,20,4,33,6,0,La_Liga,2022_2023
Radamel Falcao,COL,"FW,MF",Rayo Vallecano,36,1986,6.8,4,4,1,3,0,1,8,12.5,7,5,1,4,2,6,10,0,La_Liga,2022_2023
Fali,ESP,"DF,MF",Cádiz,28,1993,19.0,27,19,19,8,0,18,29,62.1,11,24,15,9,13,40,70,1,La_Liga,2022_2023
Mamadou Fall,SEN,DF,Villarreal,19,2002,0.3,0,0,0,0,0,0,0,,0,1,0,1,0,0,1,0,La_Liga,2022_2023
Ansu Fati,ESP,FW,Barcelona,19,2002,15.5,16,9,8,4,4,5,18,27.8,13,19,0,19,5,21,6,0,La_Liga,2022_2023
Zouhair Feddal,MAR,DF,Valladolid,33,1989,4.2,4,2,1,3,0,3,4,75.0,1,9,9,0,5,9,27,0,La_Liga,2022_2023
Nabil Fekir,FRA,MF,Betis,29,1993,10.7,11,5,3,3,5,2,9,22.2,7,6,2,4,1,12,0,0,La_Liga,2022_2023
Felipe,BRA,DF,Atlético Madrid,33,1989,2.2,3,2,1,2,0,2,4,50.0,2,2,2,0,0,3,7,0,La_Liga,2022_2023
Luiz Felipe,ITA,DF,Betis,25,1997,19.6,34,23,23,11,0,18,34,52.9,16,43,24,19,28,62,106,0,La_Liga,2022_2023
João Félix,POR,"FW,MF",Atlético Madrid,22,1999,7.2,10,7,2,3,5,1,6,16.7,5,1,0,1,3,13,2,0,La_Liga,2022_2023
Kiko Femenía,ESP,DF,Villarreal,31,1991,12.6,18,9,14,3,1,13,18,72.2,5,15,6,9,20,38,22,0,La_Liga,2022_2023
Aitor Fernández,ESP,GK,Osasuna,31,1991,21.0,1,1,1,0,0,0,1,0.0,1,0,0,0,2,3,17,0,La_Liga,2022_2023
Álex Fernández,ESP,"MF,FW",Cádiz,29,1992,17.5,13,7,6,4,3,4,14,28.6,10,14,1,13,8,21,19,0,La_Liga,2022_2023
Álvaro Fernández,ESP,GK,Espanyol,24,1998,11.0,0,0,0,0,0,0,0,,0,0,0,0,0,0,7,2,La_Liga,2022_2023
Carlos Fernández,ESP,FW,Real Sociedad,26,1996,7.0,6,4,1,3,2,1,15,6.7,14,1,0,1,1,7,4,0,La_Liga,2022_2023
Federico Fernández,ARG,DF,Elche,33,1989,1.0,1,1,1,0,0,1,1,100.0,0,0,0,0,2,3,12,0,La_Liga,2022_2023
Joaquín Fernández,ESP,DF,Valladolid,26,1996,24.0,35,28,20,11,4,19,30,63.3,11,31,22,9,27,62,98,1,La_Liga,2022_2023
Valery Fernández,ESP,"MF,DF",Girona,22,1999,10.7,12,6,4,6,2,5,9,55.6,4,8,1,7,10,22,9,1,La_Liga,2022_2023
Fernando,ESP,GK,Almería,32,1990,36.5,0,0,0,0,0,0,2,0.0,2,2,0,2,1,1,20,3,La_Liga,2022_2023
Fernando,BRA,"MF,DF",Sevilla,35,1987,17.5,34,23,14,17,3,18,30,60.0,12,21,10,11,24,58,29,0,La_Liga,2022_2023
Fidel,ESP,"MF,FW",Elche,32,1989,19.0,15,10,8,5,2,4,38,10.5,34,9,0,9,5,20,8,0,La_Liga,2022_2023
Dimitri Foulquier,FRA,DF,Valencia,29,1993,19.3,31,19,17,8,6,20,28,71.4,8,19,3,16,14,45,40,0,La_Liga,2022_2023
Juan Foyth,ARG,DF,Villarreal,24,1998,21.8,73,48,49,22,2,41,57,71.9,16,32,11,21,20,93,68,0,La_Liga,2022_2023
Iván Fresneda,ESP,DF,Valladolid,17,2004,19.4,48,34,31,13,4,29,47,61.7,18,32,8,24,15,63,60,0,La_Liga,2022_2023
Javi Galán,ESP,DF,Celta Vigo,27,1994,35.1,104,72,60,40,4,48,98,49.0,50,54,5,49,41,145,63,1,La_Liga,2022_2023
Iñigo Ruiz de Galarreta,ESP,MF,Mallorca,28,1993,27.2,54,38,27,23,4,20,52,38.5,32,26,9,17,30,84,19,0,La_Liga,2022_2023
Aleix García,ESP,MF,Girona,25,1997,26.0,37,20,9,18,10,15,33,45.5,18,24,8,16,31,68,35,1,La_Liga,2022_2023
Álvaro García,ESP,"FW,MF",Rayo Vallecano,29,1992,31.9,49,28,21,13,15,11,33,33.3,22,41,4,37,34,83,24,1,La_Liga,2022_2023
Borja García,ESP,"MF,FW",Girona,31,1990,7.5,10,4,7,2,1,2,9,22.2,7,3,1,2,5,15,6,1,La_Liga,2022_2023
Carlos García,ESP,DF,Cádiz,22,2000,0.3,0,0,0,0,0,0,0,,0,0,0,0,0,0,2,0,La_Liga,2022_2023
Dani García,ESP,MF,Athletic Club,32,1990,16.5,46,27,17,25,4,29,47,61.7,18,21,6,15,19,65,21,1,La_Liga,2022_2023
David García,ESP,DF,Osasuna,28,1994,29.8,34,20,22,12,0,19,22,86.4,3,28,13,15,45,79,151,0,La_Liga,2022_2023
Eric García,ESP,"DF,MF",Barcelona,21,2001,15.7,24,16,16,5,3,9,20,45.0,11,23,10,13,19,43,36,1,La_Liga,2022_2023
Fran Garcia,ESP,DF,Rayo Vallecano,22,1999,37.9,84,54,53,23,8,55,96,57.3,41,49,8,41,44,128,66,0,La_Liga,2022_2023
Joan García,ESP,GK,Espanyol,21,2001,1.0,0,0,0,0,0,0,0,,0,0,0,0,0,0,0,0,La_Liga,2022_2023
Raúl García,ESP,"FW,MF",Athletic Club,36,1986,10.7,12,8,3,4,5,5,15,33.3,10,13,1,12,6,18,9,0,La_Liga,2022_2023
Rubén García,ESP,"FW,MF",Osasuna,29,1993,12.9,20,11,12,4,4,7,24,29.2,17,14,1,13,12,32,13,0,La_Liga,2022_2023
Unai García,ESP,DF,Osasuna,30,1992,19.0,23,13,13,8,2,12,17,70.6,5,23,14,9,19,42,60,2,La_Liga,2022_2023
Felix Garreta,ESP,DF,Betis,18,2004,1.0,1,0,0,1,0,0,0,,0,1,1,0,1,2,4,0,La_Liga,2022_2023
Aleix Garrido,ESP,FW,Barcelona,18,2004,0.1,2,1,1,0,1,1,1,100.0,0,1,0,1,0,2,0,0,La_Liga,2022_2023
Sékou Gassama,SEN,FW,Valladolid,27,1995,0.4,0,0,0,0,0,0,0,,0,0,0,0,0,0,0,0,La_Liga,2022_2023
Gavi,ESP,"MF,FW",Barcelona,17,2004,28.1,47,31,7,30,10,21,55,38.2,34,32,5,27,18,65,22,0,La_Liga,2022_2023
Paulo Gazzaniga,ARG,GK,Girona,30,1992,28.0,0,0,0,0,0,0,1,0.0,1,0,0,0,1,1,9,5,La_Liga,2022_2023
Bryan Gil,ESP,"FW,DF",Sevilla,21,2001,10.2,22,11,11,7,4,10,23,43.5,13,10,0,10,8,30,10,0,La_Liga,2022_2023
David Gil,ESP,GK,Cádiz,28,1994,4.0,0,0,0,0,0,0,0,,0,0,0,0,0,0,3,0,La_Liga,2022_2023
Óscar Gil,ESP,DF,Espanyol,25,1997,28.4,63,37,38,16,9,32,61,52.5,29,51,18,33,31,94,55,1,La_Liga,2022_2023
Álvaro Giménez,ESP,FW,Cádiz,31,1991,0.2,0,0,0,0,0,0,1,0.0,1,0,0,0,0,0,0,0,La_Liga,2022_2023
Dani Gómez,ESP,"MF,FW",Espanyol,24,1998,1.0,2,1,1,1,0,1,2,50.0,1,0,0,0,1,3,0,0,La_Liga,2022_2023
Maxi Gómez,URU,FW,Valencia,25,1996,1.2,0,0,0,0,0,0,0,,0,0,0,0,0,0,2,0,La_Liga,2022_2023
Moi Gómez,ESP,"MF,FW",Osasuna,28,1994,27.3,26,17,9,14,3,15,32,46.9,17,15,3,12,10,36,5,1,La_Liga,2022_2023
Papu Gómez,ARG,"FW,MF",Sevilla,34,1988,11.8,6,4,3,3,0,2,10,20.0,8,8,1,7,4,10,5,0,La_Liga,2022_2023
Sergi Gómez,ESP,DF,Espanyol,30,1992,26.0,29,16,20,9,0,18,22,81.8,4,33,19,14,27,56,125,1,La_Liga,2022_2023
Antonio Gomis,ESP,GK,Atlético Madrid,19,2003,0.1,0,0,0,0,0,0,0,,0,0,0,0,0,0,0,0,La_Liga,2022_2023
Diego González,ESP,DF,Elche,27,1995,10.6,12,7,9,3,0,7,11,63.6,4,14,12,2,7,19,50,1,La_Liga,2022_2023
Édgar González,ESP,DF,Betis,25,1997,19.7,28,19,18,7,3,14,27,51.9,13,12,9,3,21,49,120,0,La_Liga,2022_2023
Giovanni González,URU,DF,Mallorca,27,1994,10.3,16,8,11,2,3,9,22,40.9,13,8,2,6,7,23,22,0,La_Liga,2022_2023
Nicolás González,ESP,MF,Valencia,20,2002,15.6,27,15,11,13,3,9,25,36.0,16,21,7,14,19,46,16,0,La_Liga,2022_2023
Roberto González,ESP,"FW,MF",Betis,21,2001,0.6,0,0,0,0,0,0,1,0.0,1,0,0,0,1,1,0,0,La_Liga,2022_2023
Andoni Gorosabel,ESP,DF,Real Sociedad,25,1996,19.0,41,25,23,9,9,26,43,60.5,17,21,2,19,17,58,23,0,La_Liga,2022_2023
José Gragera,ESP,"MF,DF",Espanyol,21,2000,5.1,19,9,11,6,2,6,11,54.5,5,10,4,6,7,26,18,0,La_Liga,2022_2023
Ivo Grbić,CRO,GK,Atlético Madrid,26,1996,10.2,0,0,0,0,0,0,0,,0,0,0,0,0,0,9,1,La_Liga,2022_2023
Dominik Greif,SVK,GK,Mallorca,25,1997,1.0,0,0,0,0,0,0,0,,0,0,0,0,0,0,0,0,La_Liga,2022_2023
Clément Grenier,FRA,MF,Mallorca,31,1991,8.0,20,8,6,12,2,10,20,50.0,10,9,1,8,6,26,7,0,La_Liga,2022_2023
Antoine Griezmann,FRA,"FW,MF",Atlético Madrid,31,1991,31.8,49,34,15,23,11,20,66,30.3,46,34,3,31,24,73,31,0,La_Liga,2022_2023
Andrés Guardado,MEX,MF,Betis,35,1986,15.3,41,25,17,20,4,18,43,41.9,25,14,5,9,23,64,29,0,La_Liga,2022_2023
Sergi Guardiola,ESP,FW,Valladolid,31,1991,5.6,12,7,6,5,1,2,4,50.0,2,6,0,6,2,14,7,0,La_Liga,2022_2023
Sergi Guardiola,ESP,FW,Cádiz,31,1991,12.9,9,7,0,6,3,3,12,25.0,9,5,0,5,3,12,7,0,La_Liga,2022_2023
Nemanja Gudelj,SRB,"DF,MF",Sevilla,30,1991,30.9,43,33,22,18,3,20,33,60.6,13,39,29,10,34,77,102,1,La_Liga,2022_2023
Javier Guerra,ESP,MF,Valencia,19,2003,6.7,16,13,7,4,5,9,20,45.0,11,8,1,7,11,27,9,0,La_Liga,2022_2023
Ander Guevara,ESP,MF,Real Sociedad,25,1997,2.5,5,2,2,2,1,1,4,25.0,3,6,1,5,2,7,3,0,La_Liga,2022_2023
Pape Gueye,SEN,MF,Sevilla,23,1999,13.0,37,22,13,21,3,16,33,48.5,17,21,5,16,22,59,10,0,La_Liga,2022_2023
Hugo Guillamón,ESP,MF,Valencia,22,2000,18.1,20,12,10,8,2,8,24,33.3,16,14,2,12,19,39,30,2,La_Liga,2022_2023
Gerard Gumbau,ESP,MF,Elche,27,1994,30.4,44,25,17,23,4,18,51,35.3,33,32,8,24,28,72,40,0,La_Liga,2022_2023
Gorka Guruzeta,ESP,FW,Athletic Club,25,1996,15.8,24,20,6,12,6,11,24,45.8,13,23,2,21,4,28,8,0,La_Liga,2022_2023
Raúl Guti,ESP,MF,Elche,25,1996,12.4,18,12,8,9,1,8,18,44.4,10,10,3,7,8,26,6,0,La_Liga,2022_2023
Miguel Gutiérrez,ESP,DF,Girona,21,2001,26.6,41,23,23,13,5,23,37,62.2,14,23,5,18,18,59,42,1,La_Liga,2022_2023
Munir El Haddadi,MAR,"MF,FW",Getafe,26,1995,12.8,12,7,3,7,2,2,10,20.0,8,23,2,21,9,21,7,0,La_Liga,2022_2023
Dennis Hadzikadunic,BIH,DF,Mallorca,24,1998,6.8,9,6,4,5,0,4,4,100.0,0,5,4,1,3,12,27,0,La_Liga,2022_2023
Haissem Hassan,FRA,"FW,MF",Villarreal,20,2002,0.6,0,0,0,0,0,0,2,0.0,2,0,0,0,1,1,0,0,La_Liga,2022_2023
Eden Hazard,BEL,FW,Real Madrid,31,1991,2.2,0,0,0,0,0,0,2,0.0,2,1,0,1,1,1,0,0,La_Liga,2022_2023
Luiz Henrique,BRA,FW,Betis,21,2001,20.1,48,34,27,15,6,20,44,45.5,24,22,0,22,14,62,17,0,La_Liga,2022_2023
Mario Hermoso,ESP,DF,Atlético Madrid,27,1995,23.4,22,15,14,6,2,9,30,30.0,21,19,9,10,19,41,85,1,La_Liga,2022_2023
Javi Hernández ,ESP,DF,Girona,24,1998,12.4,21,12,12,7,2,13,21,61.9,8,10,5,5,7,28,38,0,La_Liga,2022_2023
Aridane Hernández,ESP,DF,Osasuna,33,1989,19.9,21,15,17,4,0,12,25,48.0,13,34,21,13,28,49,96,1,La_Liga,2022_2023
Luis Hernández,ESP,DF,Cádiz,33,1989,35.0,33,21,25,7,1,22,36,61.1,14,31,24,7,31,64,145,0,La_Liga,2022_2023
Mario Hernández,ESP,DF,Rayo Vallecano,23,1999,1.1,3,2,2,1,0,3,7,42.9,4,2,0,2,2,5,0,0,La_Liga,2022_2023
Jorge Herrando,ESP,DF,Osasuna,21,2001,0.3,0,0,0,0,0,0,0,,0,1,0,1,0,0,3,0,La_Liga,2022_2023
Ander Herrera,ESP,MF,Athletic Club,32,1989,7.7,18,10,8,7,3,6,18,33.3,12,12,3,9,11,29,12,0,La_Liga,2022_2023
Sergio Herrera,ESP,GK,Osasuna,29,1993,17.0,2,0,2,0,0,2,2,100.0,0,1,0,1,1,3,6,2,La_Liga,2022_2023
Yangel Herrera,VEN,"MF,FW",Girona,24,1998,10.7,26,9,9,14,3,6,15,40.0,9,14,1,13,4,30,12,0,La_Liga,2022_2023
Omar El Hilali,MAR,"DF,MF",Espanyol,18,2003,1.0,3,2,3,0,0,1,2,50.0,1,1,0,1,1,4,6,0,La_Liga,2022_2023
Martin Hongla,CMR,"DF,MF",Valladolid,24,1998,14.5,18,13,13,5,0,11,21,52.4,10,15,12,3,8,26,46,1,La_Liga,2022_2023
Pablo Ibáñez,ESP,MF,Osasuna,23,1998,11.8,29,13,7,17,5,12,35,34.3,23,19,2,17,8,37,24,0,La_Liga,2022_2023
Iglesias,ESP,"DF,MF",Getafe,24,1998,23.8,61,35,40,18,3,33,65,50.8,32,40,5,35,21,82,91,1,La_Liga,2022_2023
Borja Iglesias,ESP,FW,Betis,29,1993,26.3,8,4,3,3,2,2,13,15.4,11,9,1,8,1,9,17,0,La_Liga,2022_2023
Asier Illarramendi,ESP,MF,Real Sociedad,32,1990,12.0,36,18,10,22,4,16,44,36.4,28,27,8,19,18,54,20,0,La_Liga,2022_2023
Alexander Isak,SWE,FW,Real Sociedad,22,1999,1.7,1,1,0,0,1,0,0,,0,0,0,0,0,1,2,0,La_Liga,2022_2023
Isco,ESP,"MF,FW",Sevilla,30,1992,8.9,15,9,6,5,4,8,14,57.1,6,3,0,3,10,25,3,0,La_Liga,2022_2023
Diego Iturralde,ESP,DF,Sevilla,19,2003,0.5,1,0,1,0,0,0,2,0.0,2,0,0,0,0,1,1,0,La_Liga,2022_2023
Nicolas Jackson,SEN,FW,Villarreal,21,2001,17.8,14,11,2,10,2,2,8,25.0,6,18,2,16,2,16,4,0,La_Liga,2022_2023
Adnan Januzaj,BEL,FW,Sevilla,27,1995,0.5,0,0,0,0,0,0,1,0.0,1,0,0,0,1,1,0,0,La_Liga,2022_2023
Luis Javier Suárez,COL,FW,Almería,24,1997,16.6,17,11,5,6,6,6,26,23.1,20,13,3,10,3,20,10,0,La_Liga,2022_2023
Joaquín,ESP,"MF,FW",Betis,41,1981,5.5,3,3,2,1,0,1,3,33.3,2,7,2,5,4,7,5,0,La_Liga,2022_2023
Frenkie de Jong,NED,MF,Barcelona,25,1997,28.2,46,26,16,21,9,17,41,41.5,24,11,1,10,35,81,22,1,La_Liga,2022_2023
Joan Jordán,ESP,MF,Sevilla,28,1994,17.7,32,17,13,17,2,16,38,42.1,22,14,7,7,16,48,14,2,La_Liga,2022_2023
Josan,ESP,"DF,MF",Elche,32,1989,12.0,25,20,20,5,0,14,27,51.9,13,8,0,8,7,32,15,1,La_Liga,2022_2023
Willian José,BRA,FW,Betis,30,1991,8.1,9,6,6,3,0,4,9,44.4,5,4,0,4,1,10,15,0,La_Liga,2022_2023
Joselu,ESP,FW,Espanyol,32,1990,33.2,13,11,3,4,6,4,17,23.5,13,25,4,21,8,21,43,0,La_Liga,2022_2023
Juanmi,ESP,FW,Betis,29,1993,10.3,14,10,4,7,3,7,31,22.6,24,10,0,10,4,18,4,0,La_Liga,2022_2023
Juanpe,ESP,DF,Girona,31,1991,15.8,19,11,10,9,0,11,17,64.7,6,12,9,3,10,29,60,1,La_Liga,2022_2023
Lago Junior,CIV,"FW,MF",Mallorca,31,1990,0.6,1,0,0,1,0,1,1,100.0,0,0,0,0,0,1,0,0,La_Liga,2022_2023
Vinicius Júnior,BRA,FW,Real Madrid,22,2000,31.4,30,21,10,12,8,14,39,35.9,25,24,1,23,6,36,1,0,La_Liga,2022_2023
Filip Jørgensen,DEN,GK,Villarreal,20,2002,2.0,0,0,0,0,0,0,1,0.0,1,0,0,0,0,0,0,0,La_Liga,2022_2023
Tino Kadewere,ZIM,"FW,MF",Mallorca,26,1996,6.0,6,3,3,3,0,4,9,44.4,5,6,2,4,2,8,1,0,La_Liga,2022_2023
Kaiky,BRA,DF,Almería,18,2004,6.5,5,5,5,0,0,3,7,42.9,4,18,10,8,11,16,28,0,La_Liga,2022_2023
Lee Kang-in,KOR,"MF,FW",Mallorca,21,2001,31.4,42,24,10,22,10,18,61,29.5,43,25,2,23,11,53,7,0,La_Liga,2022_2023
Jon Karrikaburu,ESP,FW,Real Sociedad,19,2002,1.0,1,0,0,1,0,0,0,,0,2,0,2,0,1,0,0,La_Liga,2022_2023
Kenedy,BRA,"FW,DF",Valladolid,26,1996,3.1,6,2,3,3,0,2,4,50.0,2,2,0,2,1,7,0,0,La_Liga,2022_2023
Franck Kessié,CIV,MF,Barcelona,25,1996,11.0,15,9,6,6,3,8,18,44.4,10,10,2,8,12,27,11,2,La_Liga,2022_2023
Kiké,ESP,FW,Osasuna,32,1989,11.3,6,3,0,4,2,2,5,40.0,3,6,1,5,1,7,13,0,La_Liga,2022_2023
Justin Kluivert,NED,"FW,MF",Valencia,23,1999,16.1,17,14,7,4,6,6,12,50.0,6,4,0,4,7,24,4,0,La_Liga,2022_2023
Koke,ESP,MF,Atlético Madrid,30,1992,28.3,55,38,23,25,7,28,72,38.9,44,35,13,22,20,75,19,0,La_Liga,2022_2023
Luca Koleosho,ITA,"FW,DF",Espanyol,17,2004,0.7,2,2,0,0,2,1,2,50.0,1,1,0,1,0,2,0,0,La_Liga,2022_2023
Geoffrey Kondogbia,CTA,MF,Atlético Madrid,29,1993,11.2,40,23,19,20,1,17,25,68.0,8,9,1,8,26,66,12,1,La_Liga,2022_2023
Jules Koundé,FRA,DF,Barcelona,23,1998,27.0,37,23,18,13,6,21,31,67.7,10,24,9,15,19,56,61,3,La_Liga,2022_2023
Toni Kroos,GER,MF,Real Madrid,32,1990,23.9,51,32,16,33,2,23,69,33.3,46,23,4,19,24,75,11,0,La_Liga,2022_2023
Takefusa Kubo,JPN,"FW,MF",Real Sociedad,21,2001,27.1,44,26,18,16,10,16,38,42.1,22,29,1,28,9,53,4,0,La_Liga,2022_2023
César de la Hoz,ESP,MF,Almería,30,1992,18.6,37,20,17,18,2,19,37,51.4,18,26,6,20,13,50,37,0,La_Liga,2022_2023
Luca de la Torre,USA,MF,Celta Vigo,24,1998,16.5,28,19,11,14,3,12,32,37.5,20,22,1,21,9,37,6,0,La_Liga,2022_2023
Érik Lamela,ARG,"FW,MF",Sevilla,30,1992,20.5,46,27,14,16,16,12,34,35.3,22,26,2,24,7,53,3,0,La_Liga,2022_2023
Cyle Larin,CAN,FW,Valladolid,27,1995,16.3,9,3,2,4,3,3,7,42.9,4,6,3,3,0,9,15,0,La_Liga,2022_2023
Juanmi Latasa,ESP,FW,Getafe,21,2001,5.0,5,4,2,0,3,1,1,100.0,0,3,1,2,1,6,8,0,La_Liga,2022_2023
Toni Lato,ESP,"DF,MF",Valencia,24,1997,10.2,23,11,9,12,2,9,21,42.9,12,10,1,9,6,29,14,0,La_Liga,2022_2023
Lázaro,BRA,"FW,MF",Almería,20,2002,8.0,4,3,3,0,1,3,15,20.0,12,16,1,15,2,6,1,0,La_Liga,2022_2023
Robin Le Normand,ESP,DF,Real Sociedad,25,1996,31.1,36,23,25,9,2,14,27,51.9,13,22,14,8,33,69,93,0,La_Liga,2022_2023
Benjamin Lecomte,FRA,GK,Espanyol,31,1991,10.0,0,0,0,0,0,0,0,,0,0,0,0,0,0,3,2,La_Liga,2022_2023
Jeremías Ledesma,ARG,GK,Cádiz,29,1993,34.0,3,2,3,0,0,3,7,42.9,4,1,0,1,2,5,23,3,La_Liga,2022_2023
Florian Lejeune,FRA,DF,Rayo Vallecano,31,1991,28.5,28,17,19,8,1,17,25,68.0,8,24,16,8,15,43,123,0,La_Liga,2022_2023
Iñigo Lekue,ESP,DF,Athletic Club,29,1993,14.7,24,17,20,4,0,12,19,63.2,7,16,2,14,13,37,31,1,La_Liga,2022_2023
Thomas Lemar,FRA,MF,Atlético Madrid,26,1995,13.9,30,18,10,13,7,10,28,35.7,18,12,3,9,7,37,12,0,La_Liga,2022_2023
Sergio León,ESP,FW,Valladolid,33,1989,14.8,6,4,0,4,2,3,6,50.0,3,6,0,6,0,6,4,0,La_Liga,2022_2023
Robert Lewandowski,POL,FW,Barcelona,33,1988,31.6,17,11,2,5,10,7,14,50.0,7,20,0,20,2,19,14,0,La_Liga,2022_2023
Samuel Lino,BRA,"FW,MF",Valencia,22,1999,32.1,66,43,17,37,12,26,72,36.1,46,34,0,34,18,84,16,0,La_Liga,2022_2023
Pol Lirola,ESP,DF,Elche,24,1997,7.0,13,6,9,3,1,8,13,61.5,5,3,2,1,7,20,16,0,La_Liga,2022_2023
Javier Llabrés,ESP,FW,Mallorca,19,2002,0.2,0,0,0,0,0,0,0,,0,0,0,0,0,0,1,0,La_Liga,2022_2023
Marcos Llorente,ESP,"MF,DF",Atlético Madrid,27,1995,18.9,32,15,16,10,6,17,30,56.7,13,26,2,24,17,49,19,0,La_Liga,2022_2023
Giovani Lo Celso,ARG,"MF,FW",Villarreal,26,1996,12.5,32,28,7,15,10,12,21,57.1,9,14,2,12,6,38,5,0,La_Liga,2022_2023
David López,ESP,DF,Girona,32,1989,18.4,31,18,17,13,1,19,27,70.4,8,29,19,10,14,45,64,1,La_Liga,2022_2023
Diego López,ESP,GK,Rayo Vallecano,40,1981,1.1,0,0,0,0,0,0,0,,0,0,0,0,0,0,0,1,La_Liga,2022_2023
Diego López,ESP,"FW,MF",Valencia,20,2002,5.0,2,2,1,1,0,2,15,13.3,13,9,0,9,3,5,5,0,La_Liga,2022_2023
Unai López,ESP,MF,Rayo Vallecano,26,1995,13.9,32,20,10,17,5,13,37,35.1,24,12,1,11,15,47,6,1,La_Liga,2022_2023
Anthony Lozano,HON,FW,Cádiz,29,1993,16.0,6,4,1,4,1,1,7,14.3,6,12,1,11,3,9,17,0,La_Liga,2022_2023
Pol Lozano,ESP,MF,Espanyol,22,1999,0.2,0,0,0,0,0,0,0,,0,1,0,1,0,0,1,0,La_Liga,2022_2023
José Luis Gayà,ESP,DF,Valencia,27,1995,30.1,80,46,61,16,3,43,74,58.1,31,28,9,19,23,103,48,0,La_Liga,2022_2023
José Luis Morales,ESP,"FW,MF",Villarreal,35,1987,13.5,7,6,1,2,4,5,17,29.4,12,12,1,11,2,9,2,0,La_Liga,2022_2023
Andriy Lunin,UKR,GK,Real Madrid,23,1999,7.0,0,0,0,0,0,0,0,,0,0,0,0,0,0,1,0,La_Liga,2022_2023
Awer Mabil,AUS,"MF,FW",Cádiz,26,1995,1.8,2,0,0,1,1,1,3,33.3,2,1,1,0,0,2,1,0,La_Liga,2022_2023
Darwin Machís,VEN,FW,Valladolid,29,1993,6.7,3,2,0,2,1,1,8,12.5,7,5,0,5,3,6,4,0,La_Liga,2022_2023
Pablo Maffeo,ESP,DF,Mallorca,25,1997,33.1,75,46,54,16,5,45,78,57.7,33,38,11,27,26,101,76,0,La_Liga,2022_2023
Lisandro Magallán,ARG,DF,Elche,28,1993,10.0,19,11,11,5,3,10,12,83.3,2,14,5,9,13,32,30,1,La_Liga,2022_2023
Jon Magunacelaya,ESP,"MF,FW",Real Sociedad,22,2000,0.7,1,0,0,0,1,0,2,0.0,2,0,0,0,0,1,1,0,La_Liga,2022_2023
Nemanja Maksimović,SRB,MF,Getafe,27,1995,22.8,41,30,17,18,6,19,32,59.4,13,36,14,22,34,75,27,0,La_Liga,2022_2023
Hugo Mallo,ESP,DF,Celta Vigo,31,1991,24.0,53,29,34,14,5,28,42,66.7,14,28,7,21,24,77,73,0,La_Liga,2022_2023
Mickael Malsa,MTQ,MF,Valladolid,26,1995,0.8,2,2,1,1,0,1,4,25.0,3,1,1,0,2,4,3,0,La_Liga,2022_2023
Giorgi Mamardashvili,GEO,GK,Valencia,21,2000,38.0,0,0,0,0,0,0,0,,0,0,0,0,1,1,11,4,La_Liga,2022_2023
Reinildo Mandava,MOZ,DF,Atlético Madrid,28,1994,20.6,66,43,46,19,1,38,49,77.6,11,27,12,15,30,96,59,0,La_Liga,2022_2023
Aïssa Mandi,ALG,DF,Villarreal,30,1991,16.2,18,10,14,3,1,6,12,50.0,6,19,14,5,21,39,58,0,La_Liga,2022_2023
Marcão,BRA,DF,Sevilla,26,1996,4.2,2,2,1,1,0,1,1,100.0,0,3,3,0,6,8,14,0,La_Liga,2022_2023
Agustín Marchesín,ARG,GK,Celta Vigo,34,1988,19.0,0,0,0,0,0,0,1,0.0,1,0,0,0,0,0,7,0,La_Liga,2022_2023
Óscar de Marcos,ESP,DF,Athletic Club,33,1989,31.3,67,33,34,22,11,40,76,52.6,36,42,6,36,29,96,59,0,La_Liga,2022_2023
Alberto Marí,ESP,"FW,MF",Valencia,21,2001,1.0,0,0,0,0,0,0,2,0.0,2,0,0,0,0,0,1,0,La_Liga,2022_2023
José Mari,ESP,MF,Cádiz,34,1987,4.4,16,7,12,3,1,10,16,62.5,6,3,1,2,5,21,9,0,La_Liga,2022_2023
José María Giménez,URU,DF,Atlético Madrid,27,1995,26.9,43,25,28,14,1,24,35,68.6,11,37,17,20,24,67,138,1,La_Liga,2022_2023
Mariano,DOM,FW,Real Madrid,28,1993,1.7,1,0,0,1,0,0,0,,0,1,0,1,0,1,0,0,La_Liga,2022_2023
Pablo Marín,ESP,"MF,FW",Real Sociedad,19,2003,4.0,10,5,5,4,1,2,7,28.6,5,1,0,1,4,14,2,0,La_Liga,2022_2023
Diego Mariño,ESP,GK,Almería,32,1990,0.5,0,0,0,0,0,0,0,,0,0,0,0,0,0,0,0,La_Liga,2022_2023
Roger Martí,ESP,FW,Elche,31,1991,7.3,5,2,3,2,0,1,5,20.0,4,4,0,4,1,6,7,0,La_Liga,2022_2023
Roger Martí,ESP,FW,Cádiz,31,1991,7.1,6,4,2,3,1,1,8,12.5,7,7,0,7,2,8,7,0,La_Liga,2022_2023
Ander Martin,ESP,"MF,FW",Real Sociedad,21,2000,0.5,2,2,1,1,0,1,4,25.0,3,0,0,0,0,2,1,0,La_Liga,2022_2023
Andrés Martín,ESP,"FW,MF",Rayo Vallecano,23,1999,2.3,4,2,2,1,1,3,5,60.0,2,2,0,2,1,5,2,0,La_Liga,2022_2023
Carlos Martín,ESP,"FW,MF",Atlético Madrid,20,2002,0.3,2,2,0,2,0,2,3,66.7,1,0,0,0,1,3,0,0,La_Liga,2022_2023
Iván Martín,ESP,MF,Girona,23,1999,17.6,9,7,4,4,1,8,23,34.8,15,12,0,12,9,18,12,0,La_Liga,2022_2023
Arnau Martinez,ESP,DF,Girona,19,2003,30.4,69,45,41,19,9,38,85,44.7,47,44,10,34,25,94,54,2,La_Liga,2022_2023
Iñigo Martínez,ESP,DF,Athletic Club,31,1991,14.9,18,8,11,7,0,6,9,66.7,3,17,11,6,18,36,55,0,La_Liga,2022_2023
Roger Martínez,ESP,DF,Espanyol,18,2004,0.1,0,0,0,0,0,0,0,,0,0,0,0,0,0,0,0,La_Liga,2022_2023
Omar Mascarell,EQG,"MF,DF",Elche,29,1993,27.2,53,26,32,19,2,31,64,48.4,33,51,19,32,45,98,54,1,La_Liga,2022_2023
Jordi Masip,ESP,GK,Valladolid,33,1989,27.9,0,0,0,0,0,0,2,0.0,2,0,0,0,1,1,3,2,La_Liga,2022_2023
Jaime Mata,ESP,"FW,MF",Getafe,33,1988,4.9,13,10,4,5,4,7,22,31.8,15,7,2,5,3,16,6,0,La_Liga,2022_2023
Borja Mayoral,ESP,FW,Getafe,25,1997,30.7,9,4,7,2,0,5,31,16.1,26,18,0,18,3,12,10,0,La_Liga,2022_2023
Mamadou Mbaye,SEN,DF,Cádiz,24,1998,8.4,10,7,7,3,0,6,8,75.0,2,10,8,2,7,17,50,1,La_Liga,2022_2023
Fernando Medrano,ESP,DF,Celta Vigo,22,2000,0.1,2,1,2,0,0,1,1,100.0,0,0,0,0,1,3,1,0,La_Liga,2022_2023
Gonzalo Melero,ESP,MF,Almería,28,1994,20.6,32,16,9,18,5,11,39,28.2,28,23,2,21,7,39,19,1,La_Liga,2022_2023
Memphis,NED,FW,Atlético Madrid,28,1994,3.0,1,0,0,0,1,0,1,0.0,1,0,0,0,0,1,0,0,La_Liga,2022_2023
Memphis,NED,FW,Barcelona,28,1994,1.3,1,1,1,0,0,0,1,0.0,1,0,0,0,0,1,0,0,La_Liga,2022_2023
Houboulang Mendes,GNB,DF,Almería,24,1998,9.8,19,11,16,3,0,11,27,40.7,16,12,2,10,7,26,23,1,La_Liga,2022_2023
Brais Méndez,ESP,MF,Real Sociedad,25,1997,26.7,58,34,18,30,10,24,64,37.5,40,27,3,24,12,70,14,1,La_Liga,2022_2023
Diego Méndez,ESP,MF,Rayo Vallecano,18,2003,0.0,0,0,0,0,0,0,0,,0,0,0,0,1,1,0,0,La_Liga,2022_2023
Ferland Mendy,FRA,DF,Real Madrid,27,1995,15.0,21,12,14,6,1,12,20,60.0,8,7,2,5,14,35,16,0,La_Liga,2022_2023
Jorge Meré,ESP,DF,Cádiz,25,1997,6.7,11,7,9,2,0,5,8,62.5,3,9,6,3,6,17,32,0,La_Liga,2022_2023
Mikel Merino,ESP,MF,Real Sociedad,26,1996,27.7,77,49,28,33,16,31,62,50.0,31,38,8,30,20,97,51,1,La_Liga,2022_2023
Roque Mesa,ESP,MF,Valladolid,33,1989,18.0,27,15,16,10,1,12,38,31.6,26,16,4,12,13,40,18,0,La_Liga,2022_2023
Éder Militão,BRA,DF,Real Madrid,24,1998,30.0,46,32,25,18,3,26,33,78.8,7,67,39,28,42,88,104,2,La_Liga,2022_2023
Luis Milla,ESP,MF,Getafe,27,1994,20.6,48,30,21,18,9,19,44,43.2,25,13,1,12,32,80,25,1,La_Liga,2022_2023
Pere Milla,ESP,"FW,MF",Elche,29,1992,20.5,31,20,18,8,5,14,41,34.1,27,18,3,15,9,40,19,1,La_Liga,2022_2023
Marko Milovanović,SRB,FW,Almería,18,2003,0.2,0,0,0,0,0,0,0,,0,0,0,0,0,0,0,0,La_Liga,2022_2023
Óscar Mingueza,ESP,DF,Celta Vigo,23,1999,14.3,37,21,27,9,1,25,32,78.1,7,10,4,6,12,49,25,0,La_Liga,2022_2023
Rafa Mir,ESP,FW,Sevilla,25,1997,14.4,8,2,2,4,2,2,5,40.0,3,5,1,4,4,12,11,0,La_Liga,2022_2023
Juan Miranda,ESP,DF,Betis,22,2000,16.4,23,16,16,6,1,14,29,48.3,15,20,7,13,20,43,63,0,La_Liga,2022_2023
Stefan Mitrović,SRB,DF,Getafe,32,1990,18.7,14,6,12,2,0,7,11,63.6,4,12,10,2,17,31,90,2,La_Liga,2022_2023
Luka Modrić,CRO,MF,Real Madrid,36,1985,19.4,19,9,6,6,7,10,25,40.0,15,15,5,10,10,29,7,0,La_Liga,2022_2023
Johan Mojica,COL,DF,Villarreal,29,1992,7.1,13,9,9,3,1,5,9,55.6,4,8,3,5,4,17,14,1,La_Liga,2022_2023
Johan Mojica,COL,"DF,MF",Elche,29,1992,3.0,6,3,5,1,0,2,3,66.7,1,3,2,1,4,10,5,0,La_Liga,2022_2023
Nahuel Molina,ARG,DF,Atlético Madrid,24,1998,31.9,69,43,38,18,13,39,91,42.9,52,38,7,31,18,87,63,1,La_Liga,2022_2023
Jon Moncayola,ESP,"MF,DF",Osasuna,24,1998,27.2,55,39,24,22,9,30,76,39.5,46,37,5,32,17,72,32,2,La_Liga,2022_2023
Monchu,ESP,MF,Valladolid,22,1999,22.6,50,29,20,21,9,19,46,41.3,27,28,11,17,18,68,22,1,La_Liga,2022_2023
César Montes,MEX,DF,Espanyol,25,1997,17.7,17,9,10,7,0,10,18,55.6,8,19,12,7,14,31,101,0,La_Liga,2022_2023
Gonzalo Montiel,ARG,DF,Sevilla,25,1997,16.9,26,15,12,14,0,15,29,51.7,14,25,7,18,19,45,38,0,La_Liga,2022_2023
Martín Montoya,ESP,DF,Betis,31,1991,5.0,13,8,9,4,0,10,12,83.3,2,6,1,5,9,22,14,1,La_Liga,2022_2023
Álvaro Morata,ESP,FW,Atlético Madrid,29,1992,21.1,16,11,4,8,4,3,8,37.5,5,11,3,8,0,16,23,0,La_Liga,2022_2023
Jon Morcillo,ESP,"FW,MF",Athletic Club,23,1998,0.8,1,0,1,0,0,0,1,0.0,1,0,0,0,1,2,0,0,La_Liga,2022_2023
Alberto Moreno,ESP,DF,Villarreal,30,1992,14.4,23,12,10,10,3,11,24,45.8,13,12,1,11,23,46,26,0,La_Liga,2022_2023
Álex Moreno,ESP,DF,Betis,29,1993,15.0,29,22,19,10,0,18,36,50.0,18,17,4,13,17,46,39,0,La_Liga,2022_2023
Diego Moreno,ESP,DF,Osasuna,21,2001,7.1,4,4,2,2,0,3,8,37.5,5,7,4,3,5,9,21,0,La_Liga,2022_2023
Gerard Moreno,ESP,FW,Villarreal,30,1992,13.7,11,6,0,6,5,3,6,50.0,3,6,2,4,5,16,10,0,La_Liga,2022_2023
Tete Morente,ESP,"MF,DF",Elche,25,1996,23.0,33,21,18,13,2,15,36,41.7,21,23,3,20,25,58,28,0,La_Liga,2022_2023
Ilaix Moriba,GUI,MF,Valencia,19,2003,11.2,35,16,14,17,4,14,24,58.3,10,11,1,10,4,39,12,0,La_Liga,2022_2023
Manu Morlanes,ESP,MF,Villarreal,23,1999,1.8,3,2,2,1,0,3,3,100.0,0,3,2,1,1,4,2,0,La_Liga,2022_2023
Manu Morlanes,ESP,MF,Mallorca,23,1999,7.8,22,9,12,8,2,13,24,54.2,11,10,5,5,5,27,9,0,La_Liga,2022_2023
Loren Morón,ESP,FW,Betis,28,1993,0.2,2,2,0,1,1,0,0,,0,0,0,0,0,2,1,0,La_Liga,2022_2023
Cristhian Mosquera,ESP,DF,Valencia,18,2004,1.6,4,2,3,1,0,4,5,80.0,1,1,0,1,1,5,5,0,La_Liga,2022_2023
Abdul Mumin,GHA,DF,Rayo Vallecano,24,1998,10.2,11,9,5,6,0,3,7,42.9,4,13,5,8,9,20,36,2,La_Liga,2022_2023
Iker Muniain,ESP,"MF,FW",Athletic Club,29,1992,18.8,21,16,7,11,3,6,17,35.3,11,10,1,9,4,25,2,0,La_Liga,2022_2023
Aihen Muñoz,ESP,DF,Real Sociedad,24,1997,19.5,38,23,17,17,4,22,47,46.8,25,26,5,21,9,47,38,0,La_Liga,2022_2023
Iker Muñoz,ESP,MF,Osasuna,19,2002,2.8,1,0,0,1,0,0,3,0.0,3,2,1,1,3,4,8,0,La_Liga,2022_2023
Pablo Muñoz,ESP,MF,Rayo Vallecano,18,2003,0.1,0,0,0,0,0,0,1,0.0,1,0,0,0,0,0,0,0,La_Liga,2022_2023
Vedat Muriqi,KVX,FW,Mallorca,28,1994,32.6,12,7,4,7,1,3,13,23.1,10,19,7,12,12,24,73,0,La_Liga,2022_2023
Yunus Musah,USA,MF,Valencia,19,2002,23.4,48,35,17,23,8,20,30,66.7,10,20,1,19,11,59,16,2,La_Liga,2022_2023
Francisco Mwepu,ZAM,FW,Cádiz,22,2000,0.2,1,0,0,1,0,0,0,,0,0,0,0,0,1,0,0,La_Liga,2022_2023
Nacho,ESP,DF,Real Madrid,32,1990,18.2,24,16,17,5,2,12,29,41.4,17,11,6,5,18,42,37,0,La_Liga,2022_2023
Juanjo Narváez,COL,"MF,FW",Valladolid,27,1995,1.6,1,1,1,0,0,1,1,100.0,0,2,0,2,0,1,0,0,La_Liga,2022_2023
Matija Nastasić,SRB,DF,Mallorca,29,1993,10.1,10,8,7,1,2,3,6,50.0,3,11,4,7,18,28,43,1,La_Liga,2022_2023
Roberto Navarro,ESP,"MF,FW",Real Sociedad,20,2002,3.9,5,4,4,0,1,1,2,50.0,1,7,0,7,2,7,2,0,La_Liga,2022_2023
Jesús Navas,ESP,"DF,FW",Sevilla,36,1985,22.0,19,12,8,3,8,11,22,50.0,11,18,7,11,22,41,52,1,La_Liga,2022_2023
Álvaro Negredo,ESP,FW,Cádiz,36,1985,8.4,5,4,1,2,2,2,2,100.0,0,4,1,3,0,5,8,0,La_Liga,2022_2023
Tanguy Nianzou,FRA,DF,Sevilla,20,2002,15.2,20,15,10,9,1,8,11,72.7,3,8,5,3,16,36,44,3,La_Liga,2022_2023
Saúl Ñíguez,ESP,"MF,DF",Atlético Madrid,27,1994,12.2,42,27,18,18,6,22,37,59.5,15,27,5,22,15,57,29,0,La_Liga,2022_2023
Fernando Niño,ESP,"MF,FW",Villarreal,21,2000,0.2,0,0,0,0,0,0,0,,0,0,0,0,0,0,0,0,La_Liga,2022_2023
Randy Nteka,ANG,"FW,MF",Elche,24,1997,8.1,15,10,7,6,2,2,11,18.2,9,15,3,12,4,19,9,0,La_Liga,2022_2023
Randy Nteka,ANG,"FW,MF",Rayo Vallecano,24,1997,1.3,4,2,2,2,0,1,1,100.0,0,2,0,2,2,6,3,0,La_Liga,2022_2023
Unai Núñez,ESP,DF,Celta Vigo,25,1997,35.0,47,35,29,15,3,18,34,52.9,16,27,17,10,72,119,135,1,La_Liga,2022_2023
Jan Oblak,SVN,GK,Atlético Madrid,29,1993,27.7,0,0,0,0,0,0,0,,0,0,0,0,1,1,8,0,La_Liga,2022_2023
Brian Ocampo,URU,"MF,FW",Cádiz,23,1999,12.4,18,15,12,5,1,8,21,38.1,13,13,0,13,3,21,3,0,La_Liga,2022_2023
Lucas Ocampos,ARG,"FW,MF",Sevilla,28,1994,12.9,22,14,9,9,4,8,31,25.8,23,17,2,15,8,30,5,0,La_Liga,2022_2023
Álvaro Odriozola,ESP,DF,Real Madrid,26,1995,0.4,0,0,0,0,0,0,0,,0,0,0,0,0,0,0,0,La_Liga,2022_2023
Olasagasti,ESP,"MF,DF",Real Sociedad,21,2000,0.7,4,4,1,2,1,1,2,50.0,1,2,0,2,0,4,1,0,La_Liga,2022_2023
Lucas Olaza,URU,DF,Valladolid,28,1994,16.6,24,14,12,10,2,17,26,65.4,9,20,8,12,14,38,34,0,La_Liga,2022_2023
Brian Oliván,ESP,DF,Espanyol,28,1994,26.7,47,27,30,12,5,17,26,65.4,9,26,6,20,22,69,67,0,La_Liga,2022_2023
Lucas Oliveira Rosa,BRA,DF,Valladolid,22,2000,10.3,39,18,23,10,6,12,20,60.0,8,12,2,10,15,54,24,0,La_Liga,2022_2023
Aimar Oroz,ESP,"MF,FW",Osasuna,20,2001,22.4,26,14,8,10,8,8,30,26.7,22,24,1,23,24,50,6,0,La_Liga,2022_2023
Pedro Ortiz,ESP,MF,Sevilla,21,2000,0.0,0,0,0,0,0,0,0,,0,0,0,0,0,0,0,0,La_Liga,2022_2023
Mikel Oyarzabal,ESP,"FW,MF",Real Sociedad,25,1997,13.5,13,7,5,3,5,5,19,26.3,14,14,4,10,3,16,5,0,La_Liga,2022_2023
Cenk Özkacar,TUR,DF,Valencia,21,2000,15.2,27,20,17,10,0,14,19,73.7,5,14,2,12,12,39,47,4,La_Liga,2022_2023
Fernando Pacheco,ESP,GK,Almería,30,1992,1.0,0,0,0,0,0,0,0,,0,0,0,0,0,0,1,0,La_Liga,2022_2023
Fernando Pacheco,ESP,GK,Espanyol,30,1992,16.0,0,0,0,0,0,0,1,0.0,1,0,0,0,1,1,11,0,La_Liga,2022_2023
Jon Pacheco,ESP,DF,Real Sociedad,21,2001,13.3,16,10,10,6,0,6,10,60.0,4,9,6,3,12,28,37,1,La_Liga,2022_2023
Gonçalo Paciência,POR,"FW,MF",Celta Vigo,27,1994,7.4,8,5,0,5,3,2,7,28.6,5,9,1,8,0,8,4,0,La_Liga,2022_2023
Helibelton Palacios,COL,DF,Elche,29,1993,21.3,38,20,21,15,2,19,26,73.1,7,26,12,14,20,58,55,0,La_Liga,2022_2023
Isaac Palazón Camacho,ESP,"FW,MF",Rayo Vallecano,27,1994,32.9,45,30,11,23,11,24,66,36.4,42,42,3,39,17,62,30,0,La_Liga,2022_2023
Aitor Paredes,ESP,DF,Athletic Club,22,2000,9.5,7,6,4,2,1,6,11,54.5,5,11,7,4,14,21,26,0,La_Liga,2022_2023
Daniel Parejo,ESP,MF,Villarreal,33,1989,36.5,71,40,32,23,16,30,75,40.0,45,40,12,28,29,100,31,2,La_Liga,2022_2023
Moises Parra Gutierrez,ESP,FW,Getafe,20,2002,0.1,1,0,0,1,0,0,0,,0,0,0,0,0,1,0,0,La_Liga,2022_2023
Raúl Parra,ESP,DF,Cádiz,22,1999,3.4,4,2,4,0,0,4,9,44.4,5,5,3,2,1,5,9,0,La_Liga,2022_2023
Pascu,ESP,"DF,FW",Villarreal,19,2003,0.1,0,0,0,0,0,0,0,,0,0,0,0,0,0,0,0,La_Liga,2022_2023
Javier Pastore,ARG,MF,Elche,33,1989,0.1,0,0,0,0,0,0,0,,0,0,0,0,0,0,0,0,La_Liga,2022_2023
Gabriel Paulista,BRA,DF,Valencia,31,1990,16.7,17,9,13,4,0,13,19,68.4,6,22,14,8,32,49,79,2,La_Liga,2022_2023
Alfonso Pedraza,ESP,DF,Villarreal,26,1996,18.1,35,26,20,10,5,19,29,65.5,10,19,1,18,18,53,31,0,La_Liga,2022_2023
Pedri,ESP,MF,Barcelona,19,2002,22.0,39,22,15,17,7,13,45,28.9,32,27,0,27,13,52,8,1,La_Liga,2022_2023
Adrià Pedrosa,ESP,"DF,MF",Espanyol,24,1998,2.5,5,1,5,0,0,4,7,57.1,3,1,1,0,5,10,3,0,La_Liga,2022_2023
Iñaki Peña ,ESP,GK,Barcelona,23,1999,0.8,0,0,0,0,0,0,0,,0,0,0,0,0,0,0,1,La_Liga,2022_2023
Rubén Peña,ESP,"DF,MF",Osasuna,31,1991,14.2,32,18,10,18,4,20,41,48.8,21,23,8,15,17,49,31,0,La_Liga,2022_2023
Alberto Perea,ESP,MF,Cádiz,31,1990,0.5,2,0,2,0,0,0,0,,0,2,0,2,0,2,0,0,La_Liga,2022_2023
Ayoze Pérez,ESP,"FW,MF",Betis,29,1993,15.4,31,15,9,16,6,10,40,25.0,30,22,0,22,13,44,5,0,La_Liga,2022_2023
Carles Pérez,ESP,"MF,FW",Celta Vigo,24,1998,23.8,39,23,12,17,10,22,66,33.3,44,29,3,26,6,45,9,0,La_Liga,2022_2023
Francisco Perez,ESP,"FW,MF",Valencia,19,2002,1.6,1,1,1,0,0,0,3,0.0,3,0,0,0,0,1,1,0,La_Liga,2022_2023
Kike Pérez,ESP,MF,Valladolid,25,1997,25.6,67,33,30,32,5,25,68,36.8,43,26,7,19,20,87,28,0,La_Liga,2022_2023
Lucas Pérez,ESP,FW,Cádiz,33,1988,7.0,3,2,2,1,0,1,3,33.3,2,2,0,2,1,4,3,0,La_Liga,2022_2023
Luis Pérez,ESP,DF,Valladolid,27,1995,13.5,44,24,26,12,6,27,38,71.1,11,13,4,9,16,60,29,0,La_Liga,2022_2023
Germán Pezzella,ARG,DF,Betis,31,1991,27.9,41,28,32,9,0,26,38,68.4,12,32,15,17,50,91,129,1,La_Liga,2022_2023
Ronaël Pierre-Gabriel,FRA,DF,Espanyol,24,1998,2.6,17,9,12,4,1,5,11,45.5,6,5,2,3,9,26,11,0,La_Liga,2022_2023
Yeremi Pino,ESP,"FW,MF",Villarreal,19,2002,27.2,62,38,25,20,17,21,56,37.5,35,41,4,37,15,77,36,0,La_Liga,2022_2023
Gerard Piqué,ESP,DF,Barcelona,35,1987,4.3,5,4,1,4,0,4,4,100.0,0,2,1,1,2,7,19,0,La_Liga,2022_2023
Óscar Plano,ESP,"FW,MF",Valladolid,31,1991,22.6,40,25,9,17,14,12,37,32.4,25,26,2,24,29,69,23,0,La_Liga,2022_2023
Gonzalo Plata,ECU,FW,Valladolid,21,2000,25.6,66,35,31,24,11,23,70,32.9,47,40,0,40,12,78,10,1,La_Liga,2022_2023
Ezequiel Ponce,ARG,"FW,MF",Elche,25,1997,12.5,9,7,0,6,3,0,7,0.0,7,6,1,5,1,10,13,0,La_Liga,2022_2023
Francisco Portillo,ESP,"MF,FW",Almería,32,1990,8.0,13,6,4,5,4,3,16,18.8,13,7,1,6,7,20,8,0,La_Liga,2022_2023
Portu,ESP,"MF,DF",Getafe,30,1992,19.7,28,21,14,10,4,18,42,42.9,24,23,3,20,17,45,20,1,La_Liga,2022_2023
José Pozo,ESP,"MF,FW",Rayo Vallecano,26,1996,1.0,2,2,0,2,0,0,0,,0,0,0,0,1,3,1,0,La_Liga,2022_2023
Manuel Pozo,ESP,FW,Valladolid,20,2001,0.2,0,0,0,0,0,0,0,,0,2,0,2,2,2,0,0,La_Liga,2022_2023
Alejandro Pozo Pozo,ESP,DF,Almería,23,1999,20.9,37,19,17,17,3,27,53,50.9,26,30,5,25,26,63,45,1,La_Liga,2022_2023
Abdón Prats,ESP,"FW,MF",Mallorca,29,1992,4.6,1,0,1,0,0,0,0,,0,5,0,5,0,1,2,0,La_Liga,2022_2023
Javi Puado,ESP,"FW,MF",Espanyol,24,1998,26.0,20,11,12,5,3,12,28,42.9,16,12,2,10,10,30,14,0,La_Liga,2022_2023
Arnau Puigmal,ESP,"MF,FW",Almería,21,2001,8.5,22,14,10,7,5,12,17,70.6,5,7,0,7,11,33,6,0,La_Liga,2022_2023
Domingos Quina,POR,MF,Elche,22,1999,3.1,3,2,2,1,0,1,3,33.3,2,5,0,5,3,6,1,0,La_Liga,2022_2023
Rubén Quintanilla,ESP,DF,Mallorca,20,2002,0.0,0,0,0,0,0,0,0,,0,1,0,1,0,0,0,0,La_Liga,2022_2023
Antonio Raillo,ESP,DF,Mallorca,30,1991,30.7,34,21,23,11,0,10,15,66.7,5,38,29,9,31,65,158,1,La_Liga,2022_2023
Predrag Rajković,SRB,GK,Mallorca,26,1995,36.0,0,0,0,0,0,0,2,0.0,2,0,0,0,0,0,16,1,La_Liga,2022_2023
Ivan Rakitić,CRO,MF,Sevilla,34,1988,19.9,37,26,10,18,9,19,40,47.5,21,21,1,20,27,64,20,0,La_Liga,2022_2023
Largie Ramazani,BEL,"FW,MF",Almería,21,2001,15.6,15,9,6,3,6,8,27,29.6,19,11,0,11,15,30,10,0,La_Liga,2022_2023
Chris Ramos,ESP,FW,Cádiz,25,1997,7.9,12,9,2,7,3,4,11,36.4,7,8,3,5,1,13,19,0,La_Liga,2022_2023
Raphinha,BRA,FW,Barcelona,25,1996,23.0,29,19,10,7,12,11,31,35.5,20,33,1,32,14,43,11,1,La_Liga,2022_2023
Sergio Reguilón,ESP,DF,Atlético Madrid,25,1996,3.4,7,5,5,2,0,5,7,71.4,2,3,0,3,2,9,4,0,La_Liga,2022_2023
Pepe Reina,ESP,GK,Villarreal,39,1982,22.0,0,0,0,0,0,0,1,0.0,1,0,0,0,1,1,4,4,La_Liga,2022_2023
Reinier,BRA,"MF,FW",Girona,20,2002,7.2,12,10,7,3,2,2,8,25.0,6,6,0,6,5,17,4,0,La_Liga,2022_2023
Karim Rekik,NED,DF,Sevilla,27,1994,13.1,11,5,8,3,0,4,5,80.0,1,12,5,7,10,21,24,0,La_Liga,2022_2023
Álex Remiro,ESP,GK,Real Sociedad,27,1995,38.0,1,1,1,0,0,1,3,33.3,2,0,0,0,0,1,17,3,La_Liga,2022_2023
Alejandro Revuelta Montero,ESP,DF,Getafe,22,2000,0.0,0,0,0,0,0,0,0,,0,0,0,0,0,0,1,0,La_Liga,2022_2023
Chadi Riad,MAR,MF,Barcelona,19,2003,0.0,0,0,0,0,0,0,0,,0,0,0,0,0,0,0,0,La_Liga,2022_2023
Nico Ribaudo,ESP,"MF,FW",Espanyol,21,2001,13.9,18,13,5,9,4,11,30,36.7,19,19,1,18,5,23,1,0,La_Liga,2022_2023
Diego Rico,ESP,DF,Real Sociedad,29,1993,18.3,35,21,17,11,7,12,27,44.4,15,18,5,13,20,55,51,1,La_Liga,2022_2023
Rodrigo Riquelme,ESP,"MF,FW",Girona,22,2000,24.2,20,8,8,8,4,9,35,25.7,26,16,0,16,11,31,5,0,La_Liga,2022_2023
Sergi Roberto,ESP,"DF,MF",Barcelona,30,1992,14.5,22,15,12,6,4,7,18,38.9,11,15,7,8,11,33,16,0,La_Liga,2022_2023
Lucas Robertone,ARG,MF,Almería,25,1997,31.6,50,28,20,21,9,28,64,43.8,36,45,7,38,46,96,46,1,La_Liga,2022_2023
Joel Roca,ESP,"MF,FW",Girona,17,2005,0.9,2,2,2,0,0,2,5,40.0,3,1,1,0,0,2,1,0,La_Liga,2022_2023
Enzo Roco,CHI,DF,Elche,29,1992,18.4,33,13,23,10,0,15,24,62.5,9,22,15,7,17,50,63,1,La_Liga,2022_2023
Rodri,ESP,"FW,MF",Betis,22,2000,17.8,16,11,5,9,2,8,17,47.1,9,10,0,10,13,29,2,0,La_Liga,2022_2023
Álvaro Rodríguez,URU,FW,Real Madrid,18,2004,0.9,2,1,1,0,1,1,1,100.0,0,0,0,0,0,2,1,0,La_Liga,2022_2023
Ángel Rodríguez,ESP,"FW,MF",Mallorca,35,1987,4.4,1,1,0,1,0,0,2,0.0,2,3,0,3,1,2,1,0,La_Liga,2022_2023
Óscar Rodríguez Arnaiz,ESP,MF,Celta Vigo,24,1998,19.7,32,25,12,15,5,13,28,46.4,15,16,2,14,24,56,15,0,La_Liga,2022_2023
Dani Rodríguez,ESP,MF,Mallorca,34,1988,23.3,42,23,18,22,2,21,46,45.7,25,31,8,23,21,63,14,0,La_Liga,2022_2023
Guido Rodríguez,ARG,MF,Betis,28,1994,31.9,115,75,59,50,6,54,101,53.5,47,58,14,44,42,157,76,1,La_Liga,2022_2023
Miguel Rodríguez,ESP,"MF,FW",Celta Vigo,19,2003,2.8,7,5,4,3,0,4,11,36.4,7,6,0,6,1,8,3,0,La_Liga,2022_2023
Rodrygo,BRA,"FW,MF",Real Madrid,21,2001,26.4,17,10,3,7,7,4,23,17.4,19,23,0,23,8,25,5,0,La_Liga,2022_2023
Leo Román,ESP,GK,Mallorca,22,2000,1.0,0,0,0,0,0,0,0,,0,0,0,0,0,0,0,0,La_Liga,2022_2023
Iván Romero,ESP,MF,Sevilla,21,2001,0.1,0,0,0,0,0,0,0,,0,0,0,0,0,0,0,0,La_Liga,2022_2023
Oriol Romeu,ESP,MF,Girona,30,1991,32.8,70,38,36,26,8,26,51,51.0,25,48,10,38,37,107,54,0,La_Liga,2022_2023
Rubén,ESP,"DF,MF",Espanyol,21,2001,9.9,30,15,18,9,3,20,29,69.0,9,14,4,10,18,48,18,0,La_Liga,2022_2023
Antonio Rüdiger,GER,DF,Real Madrid,29,1993,26.8,18,16,12,5,1,14,23,60.9,9,23,13,10,19,37,74,0,La_Liga,2022_2023
Aitor Ruibal,ESP,"DF,FW",Betis,26,1996,16.2,47,29,35,9,3,31,58,53.4,27,17,2,15,24,71,41,0,La_Liga,2022_2023
Víctor Ruiz,ESP,DF,Betis,33,1989,6.2,5,3,3,2,0,3,3,100.0,0,10,7,3,6,11,34,0,La_Liga,2022_2023
Gerónimo Rulli,ARG,GK,Villarreal,30,1992,14.0,0,0,0,0,0,0,0,,0,1,0,1,1,1,6,2,La_Liga,2022_2023
Franco Russo,ARG,DF,Mallorca,27,1994,1.6,2,1,2,0,0,0,1,0.0,1,5,0,5,3,5,5,0,La_Liga,2022_2023
Youssouf Sabaly,SEN,DF,Betis,29,1993,18.7,45,23,29,14,2,22,33,66.7,11,35,8,27,19,64,52,1,La_Liga,2022_2023
Umar Sadiq,NGA,FW,Almería,25,1997,2.7,0,0,0,0,0,0,1,0.0,1,2,0,2,0,0,3,0,La_Liga,2022_2023
Umar Sadiq,NGA,FW,Real Sociedad,25,1997,0.9,1,1,0,0,1,0,1,0.0,1,2,0,2,0,1,0,0,La_Liga,2022_2023
Samuel Sáiz,ESP,MF,Girona,31,1991,2.7,2,2,0,2,0,1,2,50.0,1,3,0,3,0,2,1,1,La_Liga,2022_2023
Kike Salas,ESP,DF,Sevilla,20,2002,4.1,1,1,1,0,0,0,0,,0,4,3,1,5,6,23,0,La_Liga,2022_2023
Salvi,ESP,"FW,MF",Rayo Vallecano,31,1991,5.4,13,8,5,5,3,2,8,25.0,6,0,0,0,2,15,2,0,La_Liga,2022_2023
Fede San Emeterio,ESP,MF,Cádiz,25,1997,20.5,41,22,23,16,2,22,46,47.8,24,34,14,20,17,58,28,0,La_Liga,2022_2023
Oihan Sancet,ESP,MF,Athletic Club,22,2000,28.1,27,16,2,19,6,11,37,29.7,26,10,0,10,4,31,9,1,La_Liga,2022_2023
Antonio Sánchez,ESP,"MF,DF",Mallorca,25,1997,12.0,19,8,13,4,2,10,34,29.4,24,18,0,18,22,41,14,1,La_Liga,2022_2023
Iván Sánchez,ESP,"MF,FW",Valladolid,29,1992,12.8,20,14,8,8,4,10,27,37.0,17,14,1,13,8,28,4,0,La_Liga,2022_2023
Javi Sánchez,ESP,DF,Valladolid,25,1997,26.6,43,26,27,15,1,17,26,65.4,9,32,22,10,46,89,116,0,La_Liga,2022_2023
Manu Sánchez,ESP,DF,Osasuna,21,2000,23.6,51,35,35,9,7,33,63,52.4,30,33,5,28,14,65,51,0,La_Liga,2022_2023
Esteban Saveljich,MNE,FW,Rayo Vallecano,31,1991,0.0,0,0,0,0,0,0,0,,0,0,0,0,0,0,0,0,La_Liga,2022_2023
Stefan Savić,MNE,DF,Atlético Madrid,31,1991,21.6,39,26,29,7,3,26,39,66.7,13,17,8,9,33,72,67,2,La_Liga,2022_2023
Haris Seferović,SUI,FW,Celta Vigo,30,1992,9.9,6,3,1,4,1,3,8,37.5,5,7,1,6,1,7,6,1,La_Liga,2022_2023
Jaime Seoane,ESP,"MF,FW",Getafe,25,1997,3.6,10,4,3,4,3,2,8,25.0,6,7,3,4,1,11,2,0,La_Liga,2022_2023
David Silva,ESP,MF,Real Sociedad,36,1986,21.5,36,21,11,18,7,11,19,57.9,8,17,2,15,15,51,16,0,La_Liga,2022_2023
Rui Silva,POR,GK,Betis,28,1994,26.0,4,1,4,0,0,4,4,100.0,0,0,0,0,0,4,12,1,La_Liga,2022_2023
Simo,ESP,DF,Espanyol,17,2005,1.6,3,1,3,0,0,2,3,66.7,1,5,4,1,0,3,3,0,La_Liga,2022_2023
Unai Simón,ESP,GK,Athletic Club,25,1997,30.5,2,0,2,0,0,1,1,100.0,0,1,0,1,0,2,9,3,La_Liga,2022_2023
Rubén Sobrino,ESP,"MF,FW",Cádiz,30,1992,27.4,55,37,29,17,9,23,56,41.1,33,33,3,30,24,79,20,1,La_Liga,2022_2023
Alex Sola,ESP,DF,Real Sociedad,23,1999,3.9,18,9,14,3,1,7,10,70.0,3,7,2,5,7,25,10,0,La_Liga,2022_2023
Augusto Solari,ARG,MF,Celta Vigo,30,1992,2.9,10,6,6,3,1,3,11,27.3,8,5,0,5,4,14,3,0,La_Liga,2022_2023
Carlos Soler,ESP,MF,Valencia,25,1997,2.7,2,0,0,1,1,2,3,66.7,1,1,0,1,0,2,2,0,La_Liga,2022_2023
David Soria,ESP,GK,Getafe,29,1993,38.0,0,0,0,0,0,0,1,0.0,1,0,0,0,1,1,20,4,La_Liga,2022_2023
Hugo Sotelo,ESP,MF,Celta Vigo,18,2003,0.2,0,0,0,0,0,0,0,,0,0,0,0,0,0,0,0,La_Liga,2022_2023
Dyego Sousa,POR,FW,Almería,32,1989,5.9,10,6,5,4,1,4,5,80.0,1,4,2,2,1,11,14,0,La_Liga,2022_2023
Vinicius Souza,BRA,MF,Espanyol,23,1999,27.0,99,66,41,45,13,33,59,55.9,26,31,14,17,48,147,50,1,La_Liga,2022_2023
Jørgen Strand Larsen,NOR,FW,Celta Vigo,22,2000,18.9,15,7,3,5,7,7,30,23.3,23,14,5,9,3,18,24,0,La_Liga,2022_2023
Cristhian Stuani,URU,FW,Girona,35,1986,12.1,13,6,2,7,4,5,14,35.7,9,10,0,10,2,15,5,0,La_Liga,2022_2023
Damián Suárez,URU,"DF,MF",Getafe,34,1988,21.6,49,33,23,19,7,26,48,54.2,22,40,0,40,15,64,36,0,La_Liga,2022_2023
Denis Suárez,ESP,"MF,FW",Espanyol,28,1994,10.5,26,20,12,12,2,13,45,28.9,32,11,1,10,5,31,4,0,La_Liga,2022_2023
Mario Suárez,ESP,"MF,DF",Rayo Vallecano,35,1987,0.1,0,0,0,0,0,0,0,,0,1,0,1,0,0,0,0,La_Liga,2022_2023
Suso,ESP,"MF,FW",Sevilla,28,1993,11.8,16,10,5,7,4,10,22,45.5,12,7,1,6,2,18,3,0,La_Liga,2022_2023
Williot Swedberg,SWE,MF,Celta Vigo,18,2004,0.6,3,1,1,0,2,0,0,,0,2,0,2,0,3,1,0,La_Liga,2022_2023
Alexander Sørloth,NOR,FW,Real Sociedad,26,1995,26.5,18,9,3,6,9,7,14,50.0,7,15,1,14,2,20,26,1,La_Liga,2022_2023
Renato Tapia,PER,"MF,DF",Celta Vigo,27,1995,16.1,47,25,21,21,5,18,37,48.6,19,29,11,18,19,66,37,0,La_Liga,2022_2023
Aurélien Tchouaméni,FRA,MF,Real Madrid,22,2000,23.5,64,40,23,36,5,23,38,60.5,15,20,6,14,49,113,50,0,La_Liga,2022_2023
Alex Telles,BRA,DF,Sevilla,29,1992,15.9,21,13,15,6,0,13,25,52.0,12,17,5,12,20,41,38,0,La_Liga,2022_2023
Marc-André ter Stegen,GER,GK,Barcelona,30,1992,37.2,0,0,0,0,0,0,0,,0,0,0,0,1,1,7,3,La_Liga,2022_2023
Ramón Terrats,ESP,MF,Villarreal,21,2000,9.1,15,10,3,8,4,9,17,52.9,8,11,4,7,8,23,6,2,La_Liga,2022_2023
Ramón Terrats,ESP,MF,Girona,21,2000,2.4,4,2,1,3,0,2,6,33.3,4,6,2,4,3,7,3,1,La_Liga,2022_2023
Raúl de Tomás,ESP,FW,Rayo Vallecano,27,1994,8.9,3,2,0,1,2,2,6,33.3,4,4,0,4,0,3,6,0,La_Liga,2022_2023
Pablo Torre,ESP,"FW,MF",Barcelona,19,2003,1.6,2,1,0,1,1,2,4,50.0,2,1,0,1,2,4,1,0,La_Liga,2022_2023
David Torres,ESP,DF,Valladolid,19,2003,4.3,1,1,0,1,0,1,1,100.0,0,4,2,2,3,4,8,0,La_Liga,2022_2023
Ferrán Torres,ESP,"FW,MF",Barcelona,22,2000,15.5,13,7,4,5,4,5,20,25.0,15,11,2,9,3,16,5,0,La_Liga,2022_2023
Óliver Torres,ESP,"MF,FW",Sevilla,27,1994,23.7,39,23,12,13,14,18,59,30.5,41,26,5,21,10,49,10,0,La_Liga,2022_2023
Pau Torres,ESP,DF,Villarreal,25,1997,33.9,43,25,25,13,5,23,36,63.9,13,36,27,9,13,56,146,3,La_Liga,2022_2023
Roberto Torres,ESP,"FW,MF",Osasuna,33,1989,0.1,0,0,0,0,0,0,0,,0,0,0,0,0,0,0,0,La_Liga,2022_2023
Lucas Torró,ESP,MF,Osasuna,28,1994,27.5,48,32,28,15,5,18,42,42.9,24,24,3,21,42,90,64,1,La_Liga,2022_2023
Nabil Touaizi,MAR,MF,Espanyol,21,2001,0.0,0,0,0,0,0,0,0,,0,0,0,0,0,0,0,0,La_Liga,2022_2023
Óscar Trejo,ARG,"MF,FW",Rayo Vallecano,34,1988,23.8,48,32,12,23,13,9,44,20.5,35,31,3,28,8,56,8,1,La_Liga,2022_2023
Manu Trigueros,ESP,MF,Villarreal,30,1991,9.2,20,14,9,5,6,9,22,40.9,13,9,2,7,5,25,4,0,La_Liga,2022_2023
Viktor Tsyhankov,UKR,MF,Girona,24,1997,16.5,8,8,5,1,2,1,14,7.1,13,13,2,11,7,15,12,0,La_Liga,2022_2023
Beñat Turrientes,ESP,"MF,FW",Real Sociedad,20,2002,1.2,3,3,3,0,0,1,5,20.0,4,2,0,2,0,3,3,0,La_Liga,2022_2023
Enes Ünal,TUR,FW,Getafe,25,1997,33.0,26,14,5,19,2,7,25,28.0,18,19,2,17,6,32,35,0,La_Liga,2022_2023
Oscar Ureña,DOM,MF,Girona,19,2003,1.1,4,2,2,2,0,2,3,66.7,1,2,0,2,1,5,0,0,La_Liga,2022_2023
Óscar Valentín,ESP,MF,Rayo Vallecano,27,1994,28.4,92,51,29,50,13,46,121,38.0,75,60,9,51,44,136,30,0,La_Liga,2022_2023
Martin Valjent,SVK,DF,Mallorca,26,1995,29.5,35,27,22,12,1,19,28,67.9,9,39,21,18,29,64,137,0,La_Liga,2022_2023
Jesús Vallejo,ESP,DF,Real Madrid,25,1997,0.2,0,0,0,0,0,0,0,,0,0,0,0,0,0,0,0,La_Liga,2022_2023
Manu Vallejo,ESP,"FW,MF",Girona,25,1997,2.3,4,1,1,2,1,1,6,16.7,5,2,0,2,1,5,3,0,La_Liga,2022_2023
Federico Valverde,URU,"MF,FW",Real Madrid,24,1998,27.8,31,20,14,11,6,13,26,50.0,13,31,4,27,17,48,15,0,La_Liga,2022_2023
Jesus Vazquez,ESP,"DF,MF",Valencia,19,2003,3.4,13,8,9,1,3,6,11,54.5,5,4,0,4,1,14,8,0,La_Liga,2022_2023
Kevin Vázquez,ESP,"DF,MF",Celta Vigo,29,1993,4.9,13,8,5,7,1,8,12,66.7,4,4,1,3,2,15,8,0,La_Liga,2022_2023
Lucas Vázquez,ESP,DF,Real Madrid,31,1991,12.7,34,23,22,10,2,20,28,71.4,8,10,0,10,7,41,13,0,La_Liga,2022_2023
Gabriel Veiga,ESP,MF,Celta Vigo,20,2002,25.5,43,19,14,25,4,16,52,30.8,36,30,3,27,21,64,6,0,La_Liga,2022_2023
Unai Vencedor Paris,ESP,MF,Athletic Club,21,2000,2.1,3,1,0,3,0,1,6,16.7,5,5,0,5,1,4,1,0,La_Liga,2022_2023
Gonzalo Verdú,ESP,DF,Elche,33,1988,7.8,10,5,8,2,0,4,8,50.0,4,8,6,2,10,20,33,0,La_Liga,2022_2023
Mikel Vesga,ESP,MF,Athletic Club,29,1993,28.6,57,35,21,31,5,25,68,36.8,43,39,8,31,36,93,39,3,La_Liga,2022_2023
Aleix Vidal,ESP,"MF,FW",Espanyol,32,1989,11.4,11,5,6,3,2,4,22,18.2,18,21,2,19,15,26,14,0,La_Liga,2022_2023
Nacho Vidal,ESP,DF,Osasuna,27,1995,13.9,27,14,16,6,5,17,32,53.1,15,17,4,13,19,46,33,1,La_Liga,2022_2023
Toni Villa,ESP,MF,Valladolid,27,1995,1.0,6,3,2,3,1,4,9,44.4,5,0,0,0,0,6,0,0,La_Liga,2022_2023
Toni Villa,ESP,"MF,FW",Girona,27,1995,9.9,25,18,9,11,5,10,23,43.5,13,8,0,8,8,33,3,0,La_Liga,2022_2023
Asier Villalibre,ESP,FW,Athletic Club,24,1997,1.1,0,0,0,0,0,0,0,,0,0,0,0,0,0,1,0,La_Liga,2022_2023
Gonzalo Villar,ESP,MF,Getafe,24,1998,5.1,10,5,1,6,3,6,14,42.9,8,9,2,7,6,16,5,0,La_Liga,2022_2023
Iván Villar,ESP,GK,Celta Vigo,25,1997,19.0,0,0,0,0,0,0,1,0.0,1,0,0,0,0,0,7,0,La_Liga,2022_2023
Daniel Vivian,ESP,DF,Athletic Club,23,1999,26.4,57,32,36,16,5,36,45,80.0,9,27,14,13,24,81,90,3,La_Liga,2022_2023
Shon Weissman,ISR,FW,Valladolid,26,1996,8.3,2,1,1,1,0,0,4,0.0,4,8,0,8,1,3,7,0,La_Liga,2022_2023
Axel Werner,ARG,GK,Elche,26,1996,2.0,0,0,0,0,0,0,1,0.0,1,0,0,0,0,0,0,0,La_Liga,2022_2023
Iñaki Williams,GHA,FW,Athletic Club,28,1994,31.5,22,16,5,14,3,9,24,37.5,15,18,3,15,7,29,34,0,La_Liga,2022_2023
Nico Williams,ESP,FW,Athletic Club,20,2002,29.5,31,16,10,15,6,19,41,46.3,22,40,2,38,8,39,14,1,La_Liga,2022_2023
Axel Witsel,BEL,"DF,MF",Atlético Madrid,33,1989,25.1,36,22,22,11,3,17,31,54.8,14,20,11,9,23,59,76,0,La_Liga,2022_2023
Lamine Yamal,ESP,FW,Barcelona,15,2007,0.1,0,0,0,0,0,0,0,,0,0,0,0,0,0,0,0,La_Liga,2022_2023
Jawad El Yamiq,MAR,DF,Valladolid,30,1992,17.9,17,11,10,7,0,6,11,54.5,5,27,19,8,37,54,101,0,La_Liga,2022_2023
Joseba Zaldúa,ESP,DF,Cádiz,30,1992,7.1,15,8,10,4,1,7,10,70.0,3,4,2,2,11,26,22,0,La_Liga,2022_2023
Oier Zarraga,ESP,MF,Athletic Club,23,1999,9.5,14,9,5,7,2,8,20,40.0,12,7,0,7,10,24,5,0,La_Liga,2022_2023
Igor Zubeldia,ESP,DF,Real Sociedad,25,1997,28.2,35,18,28,7,0,25,35,71.4,10,23,17,6,21,56,93,0,La_Liga,2022_2023
Martín Zubimendi,ESP,MF,Real Sociedad,23,1999,34.5,59,33,23,30,6,24,45,53.3,21,44,17,27,37,96,55,4,La_Liga,2022_2023
Rodrigo Abascal,URU,DF,Boavista,28,1994,25.5,46,28,28,18,0,30,52,57.7,22,29,10,19,36,82,98,1,Primeira_Liga,2022_2023
Giorgi Aburjania,GEO,MF,Gil Vicente FC,27,1995,17.9,38,17,12,19,7,18,43,41.9,25,19,7,12,12,50,9,0,Primeira_Liga,2022_2023
Elias Achouri,TUN,MF,Estoril,23,1999,0.1,0,0,0,0,0,0,0,,0,1,0,1,0,0,0,0,Primeira_Liga,2022_2023
Antonio Adán,ESP,GK,Sporting CP,35,1987,31.0,1,0,1,0,0,1,3,33.3,2,0,0,0,0,1,11,0,Primeira_Liga,2022_2023
Adriano,BRA,"MF,DF",Santa Clara,22,1999,24.5,50,31,19,30,1,31,50,62.0,19,34,13,21,26,76,52,0,Primeira_Liga,2022_2023
João Afonso Crispim,BRA,MF,Marítimo,27,1995,16.3,43,24,16,24,3,20,47,42.6,27,16,10,6,36,79,37,3,Primeira_Liga,2022_2023
Lucas Áfrico,BRA,DF,Estoril,27,1995,3.9,2,1,2,0,0,1,1,100.0,0,3,2,1,3,5,9,0,Primeira_Liga,2022_2023
Martin Agirregabiria,ESP,"DF,FW",Famalicão,26,1996,4.5,4,4,2,2,0,3,4,75.0,1,3,1,2,10,14,9,0,Primeira_Liga,2022_2023
Salvador Agra,POR,"FW,MF",Boavista,30,1991,18.3,27,20,10,13,4,12,23,52.2,11,5,1,4,6,33,6,0,Primeira_Liga,2022_2023
Mohamed Aidara,CIV,"DF,FW",Vizela,25,1996,2.7,3,1,3,0,0,3,3,100.0,0,2,2,0,2,5,8,0,Primeira_Liga,2022_2023
Alemão,BRA,DF,Portimonense,19,2002,4.0,11,9,7,4,0,5,10,50.0,5,6,4,2,6,17,24,0,Primeira_Liga,2022_2023
Sotiris Alexandropoulos,GRE,MF,Sporting CP,20,2001,1.2,6,5,2,3,1,3,6,50.0,3,1,0,1,2,8,1,0,Primeira_Liga,2022_2023
Ali Alipour,IRN,"FW,MF",Gil Vicente FC,26,1995,5.9,6,3,1,4,1,5,9,55.6,4,7,0,7,1,7,2,1,Primeira_Liga,2022_2023
Allano,BRA,"FW,MF",Santa Clara,27,1995,12.6,16,13,11,5,0,8,29,27.6,21,22,4,18,7,23,12,0,Primeira_Liga,2022_2023
Domingos André Ribeiro Almeida,POR,MF,Vitória,22,2000,2.6,4,2,3,0,1,2,3,66.7,1,6,0,6,4,8,4,0,Primeira_Liga,2022_2023
Jordi Almeida,BRA,GK,Paços,28,1993,6.0,1,0,1,0,0,1,1,100.0,0,0,0,0,0,1,4,2,Primeira_Liga,2022_2023
Alejandro Alvarado Jr.,USA,"FW,MF",Vizela,19,2003,0.8,2,0,1,1,0,0,2,0.0,2,3,1,2,0,2,1,0,Primeira_Liga,2022_2023
Pedro Álvaro,POR,DF,Estoril,22,2000,28.6,23,12,15,7,1,14,19,73.7,5,31,23,8,34,57,119,1,Primeira_Liga,2022_2023
Pedro Amaral,POR,DF,Rio Ave,24,1997,11.0,17,9,12,5,0,12,21,57.1,9,10,3,7,10,27,18,0,Primeira_Liga,2022_2023
André Amaro,POR,DF,Vitória,19,2002,26.2,47,30,36,10,1,30,46,65.2,16,32,13,19,48,95,103,0,Primeira_Liga,2022_2023
Anderson,BRA,FW,Vitória,24,1997,15.0,5,2,1,2,2,1,2,50.0,1,10,1,9,2,7,16,0,Primeira_Liga,2022_2023
Anderson,BRA,"FW,MF",Portimonense,24,1998,4.2,2,0,0,1,1,1,6,16.7,5,5,0,5,0,2,1,0,Primeira_Liga,2022_2023
Anderson,BRA,"MF,FW",Casa Pia,23,1998,0.3,1,1,0,1,0,0,1,0.0,1,1,0,1,1,2,0,0,Primeira_Liga,2022_2023
Léo Andrade,BRA,DF,Marítimo,24,1998,11.8,14,8,12,1,1,11,14,78.6,3,20,8,12,26,40,36,1,Primeira_Liga,2022_2023
André André,POR,MF,Vitória,32,1989,15.0,28,16,12,15,1,10,29,34.5,19,13,4,9,10,38,12,0,Primeira_Liga,2022_2023
Andrew,BRA,GK,Gil Vicente FC,21,2001,23.7,1,1,1,0,0,1,4,25.0,3,0,0,0,0,1,14,3,Primeira_Liga,2022_2023
Andrezinho,POR,"FW,MF",Santa Clara,25,1996,6.0,8,3,4,3,1,5,13,38.5,8,10,0,10,3,11,3,0,Primeira_Liga,2022_2023
Paulo Vítor Fagundes dos Anjos,BRA,GK,Chaves,33,1988,30.0,1,1,1,0,0,1,2,50.0,1,1,0,1,0,1,33,4,Primeira_Liga,2022_2023
Carnejy Antoine,HAI,"FW,MF",Casa Pia,31,1991,1.4,2,1,0,2,0,1,2,50.0,1,1,0,1,1,3,4,0,Primeira_Liga,2022_2023
Antony,BRA,"FW,MF",Arouca,20,2001,26.4,51,35,25,21,5,18,46,39.1,28,26,0,26,25,76,18,0,Primeira_Liga,2022_2023
Vitorino Antunes,POR,DF,Paços,35,1987,29.6,48,34,26,18,4,28,44,63.6,16,32,11,21,67,115,60,1,Primeira_Liga,2022_2023
Bilel Aouacheria,FRA,"FW,MF",Gil Vicente FC,28,1994,8.3,15,10,3,6,6,8,12,66.7,4,11,0,11,6,21,1,0,Primeira_Liga,2022_2023
Wilinton Aponzá,COL,MF,Portimonense,22,2000,0.0,0,0,0,0,0,0,0,,0,0,0,0,0,0,0,0,Primeira_Liga,2022_2023
Mizuki Arai,JPN,"FW,MF",Gil Vicente FC,25,1997,3.3,6,5,4,2,0,2,6,33.3,4,9,1,8,1,7,2,0,Primeira_Liga,2022_2023
Henrique Araújo,POR,"MF,FW",Benfica,20,2002,0.8,0,0,0,0,0,0,0,,0,0,0,0,0,0,1,0,Primeira_Liga,2022_2023
Tiago Araújo,POR,"DF,FW",Estoril,21,2001,9.8,13,8,9,2,2,8,22,36.4,14,12,1,11,13,26,20,0,Primeira_Liga,2022_2023
Tomás Araújo,POR,DF,Gil Vicente FC,20,2002,20.8,43,26,31,9,3,26,41,63.4,15,24,12,12,29,72,86,0,Primeira_Liga,2022_2023
Arthur,BRA,"FW,MF",Estoril,24,1998,3.1,5,3,3,2,0,2,6,33.3,4,1,0,1,1,6,1,0,Primeira_Liga,2022_2023
Arthur,BRA,"MF,DF",Sporting CP,24,1998,8.9,17,10,5,7,5,14,19,73.7,5,21,0,21,2,19,9,0,Primeira_Liga,2022_2023
Gustavo Assuncao,POR,MF,Famalicão,22,2000,10.6,22,15,13,7,2,12,27,44.4,15,21,4,17,13,35,17,0,Primeira_Liga,2022_2023
Otavio Ataide,BRA,DF,Famalicão,20,2002,7.9,17,13,10,7,0,11,21,52.4,10,11,7,4,6,23,29,0,Primeira_Liga,2022_2023
Leo Augusto Pereira,BRA,"MF,FW",Marítimo,22,2000,5.9,11,9,3,6,2,3,6,50.0,3,4,0,4,5,16,1,0,Primeira_Liga,2022_2023
Fredrik Aursnes,NOR,"FW,MF",Benfica,26,1995,23.9,41,29,14,20,7,27,52,51.9,25,18,1,17,32,73,14,0,Primeira_Liga,2022_2023
Matheus Babi,BRA,FW,Santa Clara,25,1997,15.1,17,11,1,11,5,9,26,34.6,17,18,3,15,2,19,20,0,Primeira_Liga,2022_2023
Miguel Baeza,ESP,"MF,FW",Rio Ave,22,2000,12.0,10,7,2,6,2,3,10,30.0,7,11,2,9,7,17,11,0,Primeira_Liga,2022_2023
Alexander Bah,DEN,DF,Benfica,24,1997,20.9,59,34,25,28,6,28,47,59.6,19,33,5,28,36,95,29,1,Primeira_Liga,2022_2023
Jason Bahamboula,CGO,MF,Vitória,21,2001,0.1,0,0,0,0,0,0,0,,0,0,0,0,0,0,1,0,Primeira_Liga,2022_2023
Ibrahima Bamba,CIV,"DF,MF",Vitória,20,2002,25.8,63,38,41,21,1,36,46,78.3,10,45,23,22,36,99,126,0,Primeira_Liga,2022_2023
Daniel Bandeira,POR,MF,Vitória,22,2000,18.3,44,27,21,17,6,20,39,51.3,19,18,4,14,24,68,25,0,Primeira_Liga,2022_2023
Simon Banza,COD,FW,Braga,25,1996,16.1,17,10,4,6,7,6,15,40.0,9,7,0,7,2,19,14,0,Primeira_Liga,2022_2023
Romário Baró,POR,"MF,FW",Casa Pia,22,2000,10.4,20,10,8,10,2,11,20,55.0,9,11,1,10,10,30,5,0,Primeira_Liga,2022_2023
Luís Bastos,POR,DF,Paços,20,2001,4.1,10,2,8,2,0,8,16,50.0,8,4,0,4,3,13,11,0,Primeira_Liga,2022_2023
Gabriel Batista,BRA,GK,Santa Clara,24,1998,26.0,0,0,0,0,0,0,2,0.0,2,0,0,0,0,0,13,0,Primeira_Liga,2022_2023
Ricardo Batista,POR,GK,Casa Pia,35,1986,31.0,0,0,0,0,0,0,1,0.0,1,0,0,0,1,1,18,1,Primeira_Liga,2022_2023
Dylan Batubinsika,COD,DF,Famalicão,26,1996,2.0,6,2,5,1,0,2,2,100.0,0,3,3,0,4,10,8,0,Primeira_Liga,2022_2023
Batxi,ANG,"FW,MF",Chaves,24,1998,3.6,5,3,1,3,1,3,4,75.0,1,1,1,0,1,6,1,0,Primeira_Liga,2022_2023
Clésio Baúque,MOZ,"MF,DF",Marítimo,27,1994,0.7,0,0,0,0,0,0,0,,0,1,0,1,0,0,0,0,Primeira_Liga,2022_2023
Héctor Bellerín,ESP,"DF,MF",Sporting CP,27,1995,4.9,9,6,5,3,1,5,9,55.6,4,4,0,4,3,12,7,0,Primeira_Liga,2022_2023
Stefano Beltrame,ITA,MF,Marítimo,29,1993,11.7,11,6,4,7,0,5,13,38.5,8,14,3,11,7,18,4,1,Primeira_Liga,2022_2023
Gilson Benchimol,CPV,FW,Estoril,20,2001,3.4,6,3,2,2,2,2,3,66.7,1,1,0,1,0,6,6,0,Primeira_Liga,2022_2023
Beni,ANG,MF,Casa Pia,20,2002,10.4,31,19,12,17,2,17,35,48.6,18,7,2,5,15,46,8,0,Primeira_Liga,2022_2023
Benny,POR,"FW,MF",Chaves,22,2000,13.6,14,8,6,5,3,6,16,37.5,10,16,0,16,4,18,11,0,Primeira_Liga,2022_2023
Berna,ANG,MF,Boavista,18,2003,0.1,0,0,0,0,0,0,0,,0,0,0,0,0,0,0,0,Primeira_Liga,2022_2023
Paulo Bernardo,POR,MF,Paços,20,2002,8.4,28,12,9,14,5,14,26,53.8,12,7,0,7,6,34,7,1,Primeira_Liga,2022_2023
Celton Biai,POR,GK,Vitória,21,2000,5.0,0,0,0,0,0,0,0,,0,0,0,0,0,0,4,0,Primeira_Liga,2022_2023
Pedro Bicalho,BRA,"MF,FW",Santa Clara,21,2001,2.1,4,3,1,3,0,3,6,50.0,3,2,0,2,5,9,1,0,Primeira_Liga,2022_2023
Emmanuel Boateng,GHA,"FW,MF",Rio Ave,26,1996,20.7,12,6,5,4,3,4,9,44.4,5,10,1,9,4,16,11,0,Primeira_Liga,2022_2023
Kennedy Boateng,TOG,DF,Santa Clara,25,1996,25.7,41,30,27,11,3,16,29,55.2,13,25,16,9,34,75,136,1,Primeira_Liga,2022_2023
Victor Bobsin,BRA,MF,Santa Clara,22,2000,17.9,27,19,12,14,1,16,39,41.0,23,18,7,11,24,51,27,0,Primeira_Liga,2022_2023
Bolgado,BRA,DF,Casa Pia,23,1998,5.4,12,6,6,5,1,6,8,75.0,2,9,5,4,9,21,36,0,Primeira_Liga,2022_2023
Kiko Bondoso,POR,"FW,MF",Vizela,26,1995,31.6,35,21,11,15,9,19,44,43.2,25,20,1,19,12,47,7,1,Primeira_Liga,2022_2023
Gonçalo Borges,POR,"FW,MF",Porto,21,2001,1.3,3,3,2,1,0,2,2,100.0,0,1,0,1,0,3,1,0,Primeira_Liga,2022_2023
Cristian Borja,COL,DF,Braga,29,1993,7.6,20,14,13,4,3,10,15,66.7,5,10,4,6,11,31,25,0,Primeira_Liga,2022_2023
Róbert Boženík,SVK,FW,Boavista,22,1999,10.8,9,3,1,6,2,3,10,30.0,7,3,0,3,0,9,2,0,Primeira_Liga,2022_2023
Rafael Bracalli,BRA,GK,Boavista,41,1981,28.0,2,1,2,0,0,1,2,50.0,1,0,0,0,2,4,10,0,Primeira_Liga,2022_2023
Pedro Brazão,POR,"MF,FW",Famalicão,19,2002,3.4,5,2,1,4,0,2,5,40.0,3,9,0,9,1,6,3,0,Primeira_Liga,2022_2023
Yan Brice Eteki,CMR,MF,Casa Pia,24,1997,6.6,22,11,10,11,1,11,23,47.8,12,8,1,7,6,28,9,0,Primeira_Liga,2022_2023
Rafael Brito,POR,"MF,DF",Marítimo,20,2002,7.1,22,11,7,13,2,13,23,56.5,10,12,3,9,10,32,8,0,Primeira_Liga,2022_2023
John Brooks,USA,"MF,DF",Benfica,29,1993,0.0,0,0,0,0,0,0,0,,0,0,0,0,0,0,0,0,Primeira_Liga,2022_2023
Bruma,POR,"MF,FW",Braga,27,1994,11.3,23,15,9,8,6,11,21,52.4,10,10,0,10,8,31,6,0,Primeira_Liga,2022_2023
Bruninho,BRA,FW,Arouca,23,1999,2.5,6,2,1,5,0,3,7,42.9,4,6,0,6,4,10,1,0,Primeira_Liga,2022_2023
Matheus Bueno,BRA,MF,Gil Vicente FC,24,1998,6.2,9,5,5,4,0,7,13,53.8,6,5,3,2,6,15,2,0,Primeira_Liga,2022_2023
André Bukia,COD,"FW,MF",Arouca,27,1995,11.4,11,6,4,6,1,6,16,37.5,10,8,0,8,4,15,1,0,Primeira_Liga,2022_2023
Fabijan Buntić,CRO,GK,Vizela,25,1997,33.0,0,0,0,0,0,0,0,,0,1,0,1,0,0,19,2,Primeira_Liga,2022_2023
Oriol Busquets,ESP,MF,Arouca,23,1999,12.9,21,14,12,9,0,8,27,29.6,19,17,4,13,16,37,28,1,Primeira_Liga,2022_2023
Adrián Butzke,ESP,FW,Paços,23,1999,14.8,9,6,2,2,5,1,7,14.3,6,7,2,5,3,12,14,0,Primeira_Liga,2022_2023
Jovane Cabral,CPV,MF,Sporting CP,24,1998,0.6,4,1,3,1,0,0,0,,0,1,0,1,0,4,0,0,Primeira_Liga,2022_2023
Paulo Henrique Rodrigues Cabral,POR,DF,Santa Clara,25,1996,15.9,28,18,18,7,3,18,26,69.2,8,17,4,13,18,46,38,0,Primeira_Liga,2022_2023
Jhonder Cádiz,VEN,FW,Famalicão,27,1995,14.7,6,5,2,2,2,2,9,22.2,7,4,2,2,3,9,22,0,Primeira_Liga,2022_2023
Diogo Calila,POR,"DF,MF",Santa Clara,23,1998,7.2,15,10,6,8,1,8,11,72.7,3,4,0,4,9,24,11,1,Primeira_Liga,2022_2023
Ibrahima Camará,GUI,MF,Boavista,23,1999,11.5,20,13,9,9,2,10,20,50.0,10,8,3,5,8,28,14,0,Primeira_Liga,2022_2023
Francis Cann,GHA,FW,Vizela,24,1998,0.4,0,0,0,0,0,0,1,0.0,1,2,0,2,1,1,0,0,Primeira_Liga,2022_2023
Reggie Cannon,USA,DF,Boavista,24,1998,25.7,46,29,36,9,1,25,40,62.5,15,27,14,13,59,105,93,0,Primeira_Liga,2022_2023
Fábio Cardoso,POR,DF,Porto,28,1994,13.7,7,3,4,2,1,3,7,42.9,4,8,5,3,12,19,47,0,Primeira_Liga,2022_2023
Felippe Cardoso,BRA,FW,Casa Pia,23,1998,5.6,2,1,0,1,1,2,6,33.3,4,1,0,1,2,4,7,0,Primeira_Liga,2022_2023
Yago Cariello,BRA,FW,Portimonense,23,1999,15.2,11,6,2,4,5,5,14,35.7,9,14,1,13,2,13,18,0,Primeira_Liga,2022_2023
Carlinhos,BRA,MF,Portimonense,28,1994,7.6,11,9,3,5,3,7,11,63.6,4,8,2,6,1,12,5,0,Primeira_Liga,2022_2023
João Carlos,BRA,FW,Estoril,27,1995,7.9,2,2,0,1,1,1,5,20.0,4,8,1,7,2,4,9,0,Primeira_Liga,2022_2023
Luíz Carlos,BRA,MF,Paços,37,1985,12.6,26,15,14,10,2,15,24,62.5,9,21,3,18,7,33,13,1,Primeira_Liga,2022_2023
José Carlos Marafona,POR,GK,Paços,35,1987,15.8,0,0,0,0,0,0,1,0.0,1,0,0,0,1,1,4,2,Primeira_Liga,2022_2023
Zé Carlos,POR,"MF,DF",Vitória,20,2001,9.5,27,12,19,5,3,15,29,51.7,14,17,1,16,20,47,15,0,Primeira_Liga,2022_2023
Zé Carlos,POR,DF,Gil Vicente FC,24,1998,4.4,5,5,2,3,0,5,14,35.7,9,1,0,1,10,15,10,0,Primeira_Liga,2022_2023
David Carmo,ANG,DF,Porto,23,1999,7.1,5,3,2,3,0,3,4,75.0,1,8,4,4,10,15,25,0,Primeira_Liga,2022_2023
Marcelo Carné,BRA,GK,Marítimo,32,1990,14.0,0,0,0,0,0,0,1,0.0,1,0,0,0,0,0,6,0,Primeira_Liga,2022_2023
Carraça,POR,DF,Gil Vicente FC,29,1993,20.6,32,22,21,9,2,23,38,60.5,15,15,7,8,17,49,39,0,Primeira_Liga,2022_2023
Anderson Carvalho,BRA,MF,Santa Clara,32,1990,5.5,19,8,5,12,2,8,19,42.1,11,3,0,3,6,25,13,0,Primeira_Liga,2022_2023
João Carvalho,POR,MF,Estoril,25,1997,25.6,53,33,24,26,3,25,53,47.2,28,34,10,24,16,69,12,2,Primeira_Liga,2022_2023
Vitor Carvalho,BRA,MF,Gil Vicente FC,25,1997,30.0,83,45,40,38,5,40,64,62.5,24,26,8,18,43,126,48,0,Primeira_Liga,2022_2023
Cassiano,BRA,FW,Estoril,33,1989,10.0,16,10,4,6,6,6,13,46.2,7,9,1,8,1,17,6,0,Primeira_Liga,2022_2023
Moises Castillo,COL,DF,Marítimo,21,2001,17.5,49,36,41,8,0,29,34,85.3,5,16,4,12,47,96,72,1,Primeira_Liga,2022_2023
André Castro,POR,MF,Braga,34,1988,6.9,18,12,8,8,2,6,15,40.0,9,6,2,4,7,25,6,0,Primeira_Liga,2022_2023
Geny Catamo,MOZ,"FW,MF",Marítimo,21,2001,3.8,6,2,0,3,3,2,4,50.0,2,4,0,4,2,8,1,0,Primeira_Liga,2022_2023
César,BRA,GK,Boavista,30,1992,5.0,0,0,0,0,0,0,0,,0,0,0,0,0,0,3,0,Primeira_Liga,2022_2023
Kayky Chagas,BRA,"MF,FW",Paços,19,2003,3.0,6,3,2,2,2,3,5,60.0,2,4,0,4,3,9,3,0,Primeira_Liga,2022_2023
Youssef Chermiti,POR,FW,Sporting CP,18,2004,9.4,3,2,0,2,1,1,9,11.1,8,7,2,5,1,4,3,0,Primeira_Liga,2022_2023
Fábio China,POR,"DF,MF",Marítimo,30,1992,4.4,16,12,8,7,1,7,8,87.5,1,6,3,3,7,23,6,0,Primeira_Liga,2022_2023
Chiquinho,POR,MF,Benfica,27,1995,15.2,46,26,13,28,5,22,35,62.9,13,15,1,14,16,62,5,0,Primeira_Liga,2022_2023
Clayton,BRA,FW,Casa Pia,23,1999,13.2,11,5,1,8,2,5,15,33.3,10,3,0,3,4,15,10,0,Primeira_Liga,2022_2023
Sebastián Coates,URU,DF,Sporting CP,31,1990,28.4,25,14,17,6,2,18,30,60.0,12,23,17,6,21,46,66,0,Primeira_Liga,2022_2023
Dylan Collard,MRI,DF,Marítimo,22,2000,0.0,0,0,0,0,0,0,0,,0,0,0,0,0,0,1,0,Primeira_Liga,2022_2023
Santiago Colombatto,ARG,MF,Famalicão,25,1997,29.0,59,42,22,31,6,31,68,45.6,37,29,4,25,32,91,32,0,Primeira_Liga,2022_2023
Fábio Conceição,POR,"DF,MF",Rio Ave,21,2001,22.0,32,19,17,11,4,20,43,46.5,23,18,6,12,22,54,14,0,Primeira_Liga,2022_2023
Rodrigo Conceição,POR,DF,Porto,22,2000,6.1,15,12,11,4,0,11,18,61.1,7,10,0,10,8,23,12,0,Primeira_Liga,2022_2023
Sérgio Conceição,POR,"DF,FW",Portimonense,25,1996,1.3,2,2,2,0,0,1,3,33.3,2,3,1,2,0,2,2,0,Primeira_Liga,2022_2023
Félix Correia,POR,FW,Marítimo,21,2001,8.4,15,9,2,8,5,8,15,53.3,7,4,0,4,3,18,1,0,Primeira_Liga,2022_2023
João Pedro Araújo Correia,CPV,"DF,FW",Chaves,25,1996,19.9,24,13,18,5,1,10,22,45.5,12,23,10,13,19,43,53,0,Primeira_Liga,2022_2023
Antonio Cortés,ESP,FW,Vitória,22,2000,0.6,0,0,0,0,0,0,0,,0,0,0,0,0,0,0,0,Primeira_Liga,2022_2023
Bruno Xavier Almeida Costa,POR,MF,Porto,25,1997,2.9,7,4,0,7,0,6,11,54.5,5,0,0,0,2,9,1,0,Primeira_Liga,2022_2023
Diogo Costa,POR,GK,Porto,22,1999,33.0,0,0,0,0,0,0,1,0.0,1,1,0,1,0,0,17,4,Primeira_Liga,2022_2023
Edgar Costa,POR,"FW,MF",Marítimo,35,1987,5.3,10,8,7,2,1,6,11,54.5,5,7,0,7,2,12,3,0,Primeira_Liga,2022_2023
Gonçalo Costa,POR,"DF,FW",Portimonense,22,2000,2.6,7,4,4,2,1,2,7,28.6,5,3,0,3,7,14,3,0,Primeira_Liga,2022_2023
Matheus Costa,BRA,DF,Marítimo,27,1995,12.0,22,16,15,5,2,10,15,66.7,5,11,7,4,15,37,50,1,Primeira_Liga,2022_2023
Murilo Costa,BRA,FW,Gil Vicente FC,27,1994,24.2,18,7,7,8,3,6,26,23.1,20,22,0,22,16,34,16,1,Primeira_Liga,2022_2023
Rui Costa,POR,MF,Santa Clara,26,1996,0.5,0,0,0,0,0,0,1,0.0,1,0,0,0,0,0,0,0,Primeira_Liga,2022_2023
Tomás Costa Silva,POR,DF,Vizela,22,1999,13.1,45,28,32,10,3,29,44,65.9,15,19,5,14,22,67,46,0,Primeira_Liga,2022_2023
Vitor Costa,BRA,"DF,MF",Marítimo,28,1994,26.7,58,29,29,23,6,30,61,49.2,31,31,4,27,30,88,62,2,Primeira_Liga,2022_2023
Costinha,POR,"DF,MF",Rio Ave,22,2000,31.1,106,63,49,49,8,60,102,58.8,42,76,16,60,40,146,81,0,Primeira_Liga,2022_2023
Costinha,POR,"MF,FW",Santa Clara,29,1992,7.5,8,6,1,5,2,3,9,33.3,6,7,1,6,4,12,1,0,Primeira_Liga,2022_2023
Sandro Cruz,ANG,"DF,FW",Chaves,21,2001,5.9,16,15,8,5,3,10,14,71.4,4,9,3,6,7,23,16,0,Primeira_Liga,2022_2023
Cuca,CPV,MF,Casa Pia,31,1991,4.3,9,8,3,4,2,6,12,50.0,6,6,0,6,7,16,7,0,Primeira_Liga,2022_2023
Lucas Cunha,BRA,DF,Gil Vicente FC,25,1997,15.0,9,7,7,2,0,6,9,66.7,3,19,14,5,17,26,70,0,Primeira_Liga,2022_2023
Oday Dabbagh,PLE,FW,Arouca,23,1998,10.2,3,1,0,2,1,1,3,33.3,2,5,0,5,6,9,8,0,Primeira_Liga,2022_2023
Augusto Dabo,POR,"DF,FW",Boavista,18,2004,0.1,0,0,0,0,0,0,0,,0,0,0,0,0,0,0,0,Primeira_Liga,2022_2023
Ignacio De Arruabarrena,URU,GK,Arouca,25,1997,30.0,3,1,3,0,0,2,2,100.0,0,2,0,2,0,3,15,2,Primeira_Liga,2022_2023
Hernán De La Fuente,ARG,DF,Famalicão,25,1997,6.0,22,13,14,7,1,10,16,62.5,6,10,6,4,9,31,16,0,Primeira_Liga,2022_2023
Dele,NGA,"FW,MF",Estoril,21,2001,0.9,1,0,1,0,0,0,2,0.0,2,1,0,1,0,1,0,0,Primeira_Liga,2022_2023
Juan Delgado,CHI,DF,Paços,29,1993,29.9,58,35,27,21,10,37,73,50.7,36,23,4,19,24,82,54,2,Primeira_Liga,2022_2023
Shaquil Delos,FRA,DF,Estoril,23,1999,4.6,11,8,7,2,2,6,8,75.0,2,6,2,4,4,15,6,0,Primeira_Liga,2022_2023
Denílson,BRA,FW,Famalicão,27,1995,4.0,4,2,4,0,0,1,2,50.0,1,2,2,0,1,5,14,0,Primeira_Liga,2022_2023
Depú,ANG,"FW,MF",Gil Vicente FC,22,2000,0.9,2,0,0,1,1,0,1,0.0,1,0,0,0,1,3,3,0,Primeira_Liga,2022_2023
Derick,BRA,"MF,DF",Casa Pia,28,1993,16.0,28,18,17,10,1,20,42,47.6,22,26,6,20,16,44,44,0,Primeira_Liga,2022_2023
Lamine Diaby,FRA,MF,Portimonense,25,1996,15.7,33,17,16,14,3,11,23,47.8,12,16,6,10,21,54,46,2,Primeira_Liga,2022_2023
Ousmane Diomande,CIV,DF,Sporting CP,18,2003,9.8,22,13,12,10,0,10,19,52.6,9,6,4,2,11,33,24,3,Primeira_Liga,2022_2023
Álvaro djaló,ESP,"FW,MF",Braga,22,1999,7.1,15,7,7,4,4,5,26,19.2,21,11,0,11,5,20,10,0,Primeira_Liga,2022_2023
Matchoi Djaló,POR,"MF,FW",Paços,19,2003,14.5,19,13,8,8,3,8,17,47.1,9,19,3,16,7,26,7,1,Primeira_Liga,2022_2023
Mihai Dobre,ROU,"FW,DF",Famalicão,23,1998,10.4,23,16,17,4,2,15,30,50.0,15,10,1,9,3,26,9,0,Primeira_Liga,2022_2023
Julian Draxler,GER,"MF,FW",Benfica,28,1993,4.5,5,2,0,3,2,2,4,50.0,2,5,1,4,1,6,1,0,Primeira_Liga,2022_2023
Edu,POR,MF,Chaves,20,2002,0.4,0,0,0,0,0,0,0,,0,0,0,0,2,2,1,1,Primeira_Liga,2022_2023
Carlos Eduardo,BRA,"FW,MF",Estoril,25,1996,8.0,18,7,10,6,2,12,35,34.3,23,7,3,4,8,26,9,0,Primeira_Liga,2022_2023
Paulo Eduardo,BRA,DF,Santa Clara,20,2002,5.3,7,5,5,2,0,5,8,62.5,3,4,3,1,6,13,28,0,Primeira_Liga,2022_2023
Marcus Edwards,ENG,"FW,MF",Sporting CP,23,1998,25.0,14,10,5,5,4,5,29,17.2,24,7,0,7,5,19,2,0,Primeira_Liga,2022_2023
Erison,BRA,FW,Estoril,23,1999,7.6,3,0,1,1,1,1,3,33.3,2,4,0,4,0,3,6,0,Primeira_Liga,2022_2023
Ricardo Esgaio,POR,"DF,MF",Sporting CP,29,1993,14.6,40,32,10,25,5,25,43,58.1,18,10,0,10,9,49,27,0,Primeira_Liga,2022_2023
Tiago Esgaio,POR,DF,Arouca,26,1995,25.4,45,24,28,14,3,39,63,61.9,24,26,6,20,22,67,93,0,Primeira_Liga,2022_2023
Dario Essugo,POR,MF,Sporting CP,17,2005,2.2,10,5,3,6,1,6,9,66.7,3,2,1,1,4,14,0,0,Primeira_Liga,2022_2023
Gonçalo Esteves,POR,DF,Estoril,18,2004,2.0,4,1,3,1,0,3,3,100.0,0,3,0,3,2,6,3,0,Primeira_Liga,2022_2023
Paulo Estrela Moreira,POR,MF,Portimonense,23,1999,16.8,39,19,10,28,1,15,39,38.5,24,25,5,20,35,74,28,0,Primeira_Liga,2022_2023
Friday Etim,NGA,FW,Vizela,20,2002,4.9,6,3,1,3,2,4,4,100.0,0,3,0,3,4,10,2,0,Primeira_Liga,2022_2023
Euller,BRA,"FW,MF",Chaves,27,1995,11.8,21,13,8,10,3,13,31,41.9,18,12,2,10,10,31,8,0,Primeira_Liga,2022_2023
Stephen Eustáquio,CAN,MF,Porto,25,1996,18.6,57,29,21,27,9,32,61,52.5,29,25,6,19,19,76,22,0,Primeira_Liga,2022_2023
Evanilson,BRA,FW,Porto,22,1999,15.0,15,12,2,6,7,6,13,46.2,7,14,1,13,5,20,5,0,Primeira_Liga,2022_2023
Ewerton,BRA,MF,Portimonense,29,1992,6.5,18,12,5,8,5,8,16,50.0,8,6,1,5,3,21,4,0,Primeira_Liga,2022_2023
Fabiano,BRA,DF,Braga,22,2000,10.7,37,32,13,17,7,15,21,71.4,6,16,3,13,17,54,17,0,Primeira_Liga,2022_2023
Fábio,BRA,"FW,MF",Paços,25,1997,3.0,0,0,0,0,0,0,2,0.0,2,1,1,0,0,0,7,0,Primeira_Liga,2022_2023
Abdul Fatawu Issahaku,GHA,"DF,MF",Sporting CP,18,2004,1.3,1,0,0,1,0,0,4,0.0,4,1,0,1,2,3,1,0,Primeira_Liga,2022_2023
Luiz Felipe,BRA,GK,Vizela,25,1997,1.0,0,0,0,0,0,0,0,,0,0,0,0,0,0,3,0,Primeira_Liga,2022_2023
Volnei Feltes,BRA,DF,Estoril,22,2000,0.1,0,0,0,0,0,0,0,,0,0,0,0,2,2,1,0,Primeira_Liga,2022_2023
Eduardo Fereira,VEN,"FW,MF",Casa Pia,21,2000,0.6,1,0,1,0,0,1,1,100.0,0,0,0,0,2,3,0,0,Primeira_Liga,2022_2023
Erick Ferigra,ECU,DF,Paços,23,1999,12.9,9,4,9,0,0,3,9,33.3,6,16,9,7,13,22,50,0,Primeira_Liga,2022_2023
Ivanildo Fernandes,CPV,DF,Vizela,26,1996,16.5,14,6,10,4,0,6,13,46.2,7,19,12,7,16,30,96,0,Primeira_Liga,2022_2023
Jorge Filipe Oliveira Fernandes,POR,DF,Vitória,25,1997,2.3,2,1,2,0,0,0,0,,0,2,1,1,1,3,13,0,Primeira_Liga,2022_2023
Mateus Fernandes,POR,MF,Sporting CP,18,2004,1.0,3,0,0,3,0,0,1,0.0,1,1,0,1,0,3,0,0,Primeira_Liga,2022_2023
Patrick Fernandes,CPV,"FW,MF",Chaves,28,1993,0.6,0,0,0,0,0,0,0,,0,0,0,0,0,0,0,0,Primeira_Liga,2022_2023
Rafael Fernandes,POR,"DF,FW",Arouca,20,2002,1.5,2,2,1,1,0,1,1,100.0,0,2,2,0,3,5,6,0,Primeira_Liga,2022_2023
Rúben Fernandes,POR,DF,Gil Vicente FC,36,1986,24.2,15,8,9,5,1,9,26,34.6,17,35,19,16,37,52,89,0,Primeira_Liga,2022_2023
Vasco Fernandes,POR,DF,Casa Pia,35,1986,27.5,23,12,16,7,0,10,19,52.6,9,49,35,14,33,56,114,2,Primeira_Liga,2022_2023
Enzo Fernández,ARG,MF,Benfica,21,2001,15.4,40,17,15,19,6,23,44,52.3,21,16,3,13,15,55,3,2,Primeira_Liga,2022_2023
Diogo Ferreira,POR,MF,Vitória,20,2001,0.0,0,0,0,0,0,0,0,,0,0,0,0,0,0,1,0,Primeira_Liga,2022_2023
Filipe Ferreira,POR,"DF,MF",Boavista,31,1990,3.4,6,3,2,3,1,4,5,80.0,1,2,2,0,2,8,14,0,Primeira_Liga,2022_2023
Fernando Ferreira Fonseca,POR,"DF,FW",Paços,25,1997,1.8,2,2,1,1,0,0,2,0.0,2,2,0,2,3,5,4,0,Primeira_Liga,2022_2023
João Ferreira,POR,"DF,MF",Rio Ave,21,2001,1.8,6,6,2,3,1,1,3,33.3,2,3,1,2,1,7,2,1,Primeira_Liga,2022_2023
Vitó Ferreira,POR,"MF,FW",Casa Pia,24,1997,0.8,1,1,0,0,1,0,1,0.0,1,0,0,0,0,1,2,0,Primeira_Liga,2022_2023
Daniel Figueira,POR,GK,Estoril,24,1998,31.7,0,0,0,0,0,0,1,0.0,1,0,0,0,0,0,14,1,Primeira_Liga,2022_2023
Bernardo Folha,POR,"MF,FW",Porto,20,2002,0.6,3,1,2,1,0,3,5,60.0,2,1,0,1,0,3,0,0,Primeira_Liga,2022_2023
Tiago Fonseca Morais,POR,FW,Boavista,18,2003,0.3,3,2,1,1,1,3,3,100.0,0,0,0,0,1,4,0,0,Primeira_Liga,2022_2023
Théo Fonseca,FRA,"MF,FW",Famalicão,22,2000,1.2,0,0,0,0,0,0,1,0.0,1,3,1,2,2,2,3,0,Primeira_Liga,2022_2023
Rui Fonte,POR,"FW,MF",Famalicão,32,1990,5.1,6,4,1,4,1,2,2,100.0,0,6,0,6,1,7,3,0,Primeira_Liga,2022_2023
Hernâni Fortes,POR,"FW,MF",Rio Ave,30,1991,7.5,4,2,3,1,0,1,5,20.0,4,5,1,4,1,5,4,0,Primeira_Liga,2022_2023
André Franco,POR,"MF,FW",Porto,24,1998,7.7,11,7,2,6,3,4,14,28.6,10,3,1,2,5,16,4,0,Primeira_Liga,2022_2023
Afonso freitas,POR,"DF,MF",Vitória,22,2000,21.4,28,19,15,11,2,17,28,60.7,11,16,8,8,18,46,49,0,Primeira_Liga,2022_2023
Kanya Fujimoto,JPN,MF,Gil Vicente FC,23,1999,29.1,38,25,7,21,10,13,24,54.2,11,18,2,16,19,57,1,0,Primeira_Liga,2022_2023
Nicolás Gaitán,ARG,"FW,MF",Paços,34,1988,19.9,20,12,9,6,5,9,36,25.0,27,17,2,15,12,32,21,0,Primeira_Liga,2022_2023
Galeno,BRA,"MF,FW",Porto,24,1997,22.2,28,16,9,7,12,14,28,50.0,14,21,3,18,21,49,25,0,Primeira_Liga,2022_2023
Nino Galović,CRO,DF,Arouca,30,1992,14.5,13,10,11,2,0,7,8,87.5,1,14,13,1,16,29,66,0,Primeira_Liga,2022_2023
João Gamboa,POR,MF,Estoril,25,1996,11.6,16,9,5,9,2,7,21,33.3,14,19,10,9,14,30,21,1,Primeira_Liga,2022_2023
Pedro Ganchas,POR,DF,Paços,22,2000,3.0,4,3,2,2,0,3,7,42.9,4,5,4,1,1,5,9,0,Primeira_Liga,2022_2023
Bruno Gaspar,ANG,"DF,MF",Vitória,29,1993,2.4,9,6,6,2,1,2,3,66.7,1,1,1,0,4,13,5,0,Primeira_Liga,2022_2023
Francisco Geraldes,POR,MF,Estoril,27,1995,20.3,29,19,10,16,3,11,29,37.9,18,13,2,11,21,50,7,1,Primeira_Liga,2022_2023
Gilberto,BRA,DF,Benfica,29,1993,8.9,23,14,10,10,3,15,26,57.7,11,12,2,10,11,34,13,0,Primeira_Liga,2022_2023
Saviour Godwin,NGA,"FW,MF",Casa Pia,25,1996,26.7,29,15,10,13,6,13,36,36.1,23,19,1,18,13,42,7,0,Primeira_Liga,2022_2023
Eulânio Ângelo Chipela Gomes,GNB,DF,Santa Clara,28,1994,6.4,11,8,5,1,5,5,6,83.3,1,8,1,7,4,15,9,0,Primeira_Liga,2022_2023
Henrique Gomes,POR,DF,Gil Vicente FC,26,1995,5.3,9,4,8,0,1,4,9,44.4,5,8,2,6,4,13,18,0,Primeira_Liga,2022_2023
Nito Gomes,GNB,MF,Marítimo,20,2002,0.8,1,1,0,1,0,1,1,100.0,0,0,0,0,1,2,4,0,Primeira_Liga,2022_2023
Rodrigo Gomes,POR,"FW,MF",Braga,19,2003,3.8,10,9,4,3,3,3,9,33.3,6,3,0,3,3,13,3,0,Primeira_Liga,2022_2023
Rui Gomes,POR,"MF,FW",Portimonense,24,1997,11.9,17,9,6,8,3,10,24,41.7,14,14,1,13,10,27,9,0,Primeira_Liga,2022_2023
Vítor Gomes,POR,MF,Rio Ave,34,1987,8.4,11,6,4,6,1,3,6,50.0,3,4,0,4,6,17,17,1,Primeira_Liga,2022_2023
Victor Gomez,ESP,DF,Braga,22,2000,22.9,32,16,18,11,3,21,40,52.5,19,21,5,16,16,48,39,0,Primeira_Liga,2022_2023
Nuno Gonçalo Moreira,POR,"FW,MF",Vizela,23,1999,20.4,24,16,12,7,5,13,32,40.6,19,20,4,16,24,48,28,0,Primeira_Liga,2022_2023
Diogo Gonçalves,POR,FW,Benfica,25,1997,3.4,6,6,1,3,2,2,4,50.0,2,4,0,4,1,7,1,0,Primeira_Liga,2022_2023
João Gonçalves,POR,GK,Boavista,21,2000,1.0,0,0,0,0,0,0,0,,0,0,0,0,0,0,1,1,Primeira_Liga,2022_2023
Pedro Gonçalves,POR,"MF,FW",Sporting CP,24,1998,31.2,59,36,13,38,8,23,53,43.4,30,22,4,18,21,80,6,0,Primeira_Liga,2022_2023
Cristian González,URU,DF,Santa Clara,26,1996,11.7,22,16,15,5,2,8,10,80.0,2,19,11,8,20,42,57,1,Primeira_Liga,2022_2023
Walter González,PAR,FW,Santa Clara,27,1995,4.4,0,0,0,0,0,0,1,0.0,1,1,0,1,1,1,7,0,Primeira_Liga,2022_2023
Yony González,COL,"FW,MF",Portimonense,28,1994,10.8,12,10,6,5,1,3,9,33.3,6,9,2,7,4,16,12,0,Primeira_Liga,2022_2023
Jean Gorby,FRA,MF,Braga,20,2002,1.3,3,2,1,0,2,3,8,37.5,5,3,0,3,2,5,1,0,Primeira_Liga,2022_2023
Kenji Gorré,CUW,"FW,MF",Boavista,27,1994,16.4,15,6,7,6,2,6,16,37.5,10,18,0,18,11,26,4,0,Primeira_Liga,2022_2023
Tiago Gouveia,POR,"FW,MF",Estoril,21,2001,26.5,45,25,17,17,11,25,49,51.0,24,18,1,17,15,60,20,0,Primeira_Liga,2022_2023
João Graça,POR,"MF,FW",Rio Ave,27,1995,12.8,22,17,7,10,5,9,32,28.1,23,19,4,15,8,30,5,1,Primeira_Liga,2022_2023
Álex Grimaldo,ESP,DF,Benfica,26,1995,32.7,74,46,26,31,17,50,89,56.2,39,27,1,26,40,114,26,0,Primeira_Liga,2022_2023
Marko Grujić,SRB,MF,Porto,26,1996,12.5,42,21,16,23,3,22,32,68.8,10,17,4,13,23,65,28,0,Primeira_Liga,2022_2023
Alexandre Guedes,POR,FW,Paços,28,1994,8.8,7,5,3,2,2,2,7,28.6,5,2,2,0,2,9,6,0,Primeira_Liga,2022_2023
Gonçalo Guedes,POR,"FW,MF",Benfica,25,1996,4.5,7,2,1,5,1,2,2,100.0,0,7,0,7,1,8,1,0,Primeira_Liga,2022_2023
Ricardo Guimarães,MOZ,MF,Chaves,26,1995,21.8,49,29,21,25,3,27,79,34.2,52,40,10,30,31,80,34,1,Primeira_Liga,2022_2023
Rafik Guitane,FRA,"MF,FW",Estoril,23,1999,8.7,7,6,2,4,1,4,12,33.3,8,10,1,9,3,10,2,0,Primeira_Liga,2022_2023
Raphael Guzzo,POR,MF,Vizela,27,1995,26.2,63,32,22,34,7,32,59,54.2,27,33,10,23,34,97,26,0,Primeira_Liga,2022_2023
Emmanuel Hackman,TOG,DF,Gil Vicente FC,27,1995,1.5,1,1,0,1,0,0,2,0.0,2,3,2,1,1,2,3,0,Primeira_Liga,2022_2023
Yanis Hamache,ALG,MF,Boavista,23,1999,2.0,2,1,1,1,0,0,2,0.0,2,2,0,2,1,3,8,0,Primeira_Liga,2022_2023
Tomás Händel,POR,MF,Vitória,21,2000,4.8,12,9,9,3,0,7,15,46.7,8,3,0,3,6,18,3,0,Primeira_Liga,2022_2023
Boubacar Hanne,POR,"FW,DF",Gil Vicente FC,23,1999,0.4,0,0,0,0,0,0,0,,0,0,0,0,0,0,0,0,Primeira_Liga,2022_2023
Héctor,ESP,FW,Chaves,26,1995,16.4,4,2,0,4,0,0,12,0.0,12,9,4,5,2,6,17,0,Primeira_Liga,2022_2023
Jordan Holsgrove,SCO,MF,Paços,22,1999,19.8,37,20,14,20,3,19,51,37.3,32,24,3,21,25,62,13,0,Primeira_Liga,2022_2023
Lukáš Horníček,CZE,GK,Braga,20,2002,0.2,0,0,0,0,0,0,0,,0,0,0,0,0,0,0,0,Primeira_Liga,2022_2023
André Horta,POR,MF,Braga,25,1996,23.1,37,23,14,17,6,22,54,40.7,32,24,7,17,13,50,12,1,Primeira_Liga,2022_2023
Ricardo Horta,POR,"MF,FW",Braga,27,1994,29.0,35,16,7,17,11,19,49,38.8,30,25,2,23,12,47,14,0,Primeira_Liga,2022_2023
Abbas Ibrahim,NGA,"MF,DF",Paços,24,1998,3.6,6,4,3,3,0,4,7,57.1,3,7,2,5,4,10,3,2,Primeira_Liga,2022_2023
Tiago Ilori,POR,DF,Paços,29,1993,2.3,0,0,0,0,0,0,1,0.0,1,1,0,1,1,1,9,0,Primeira_Liga,2022_2023
Gonçalo Inácio,POR,DF,Sporting CP,20,2001,26.3,39,23,24,15,0,23,41,56.1,18,25,11,14,45,84,66,3,Primeira_Liga,2022_2023
Índio,BRA,MF,Vitória,22,1999,0.8,1,0,1,0,0,1,2,50.0,1,0,0,0,1,2,3,0,Primeira_Liga,2022_2023
Hernani Infande,POR,"MF,FW",Braga,21,2001,0.9,2,2,2,0,0,1,2,50.0,1,1,0,1,0,2,2,0,Primeira_Liga,2022_2023
Hernani Infande,POR,"FW,MF",Paços,21,2001,3.9,7,5,5,1,1,2,6,33.3,4,3,0,3,1,8,1,0,Primeira_Liga,2022_2023
Carlos Isaac,ESP,DF,Vizela,24,1998,3.9,12,7,3,7,2,11,11,100.0,0,3,2,1,5,17,14,0,Primeira_Liga,2022_2023
Franco Israel,URU,GK,Sporting CP,22,2000,3.0,0,0,0,0,0,0,0,,0,0,0,0,0,0,0,0,Primeira_Liga,2022_2023
Abass Issah,GHA,"FW,MF",Chaves,23,1998,15.2,16,7,7,5,4,8,24,33.3,16,9,0,9,8,24,7,0,Primeira_Liga,2022_2023
Ítalo,BRA,DF,Santa Clara,20,2002,11.9,15,7,10,5,0,11,13,84.6,2,17,9,8,10,25,66,0,Primeira_Liga,2022_2023
Ivan Jaime Pajuelo,ESP,"FW,MF",Famalicão,21,2000,20.8,20,8,8,9,3,9,26,34.6,17,16,0,16,11,31,6,0,Primeira_Liga,2022_2023
Nicolas Janvier,FRA,MF,Vitória,23,1998,7.0,16,11,8,8,0,6,13,46.2,7,9,1,8,6,22,2,0,Primeira_Liga,2022_2023
Anderson Jesus,BRA,DF,Vizela,27,1995,29.6,31,20,22,9,0,9,17,52.9,8,28,20,8,37,68,168,1,Primeira_Liga,2022_2023
Jhonatan,BRA,GK,Rio Ave,31,1991,32.0,1,0,1,0,0,1,3,33.3,2,0,0,0,0,1,9,6,Primeira_Liga,2022_2023
Park Ji-soo,KOR,DF,Portimonense,28,1994,13.3,26,20,14,11,1,14,19,73.7,5,15,10,5,6,32,54,1,Primeira_Liga,2022_2023
Jo,BRA,"FW,MF",Chaves,27,1995,3.3,4,3,1,2,1,3,6,50.0,3,5,1,4,2,6,9,0,Primeira_Liga,2022_2023
João,BRA,GK,Casa Pia,24,1998,1.0,0,0,0,0,0,0,0,,0,0,0,0,0,0,1,0,Primeira_Liga,2022_2023
Joãozinho,POR,DF,Estoril,33,1989,28.6,36,27,16,16,4,19,31,61.3,12,29,14,15,16,52,63,0,Primeira_Liga,2022_2023
Joca,POR,"MF,FW",Rio Ave,26,1996,4.6,3,1,2,1,0,2,4,50.0,2,3,0,3,3,6,0,0,Primeira_Liga,2022_2023
Henrique Jocú,POR,"MF,FW",Portimonense,20,2001,5.1,13,5,5,8,0,4,15,26.7,11,6,3,3,7,20,5,0,Primeira_Liga,2022_2023
Diederrick Joel,CMR,FW,Marítimo,28,1993,10.5,6,1,2,4,0,1,3,33.3,2,7,0,7,2,8,4,0,Primeira_Liga,2022_2023
Michael Johnston,IRL,"FW,MF",Vitória,23,1999,15.2,11,8,2,4,5,3,19,15.8,16,11,2,9,5,16,5,0,Primeira_Liga,2022_2023
Bruno Jordão,POR,MF,Santa Clara,23,1998,9.4,13,11,6,6,1,6,22,27.3,16,10,1,9,12,25,7,0,Primeira_Liga,2022_2023
Igor Julião,BRA,DF,Vizela,27,1994,17.9,29,21,20,6,3,17,23,73.9,6,7,2,5,22,51,40,0,Primeira_Liga,2022_2023
Juninho,BRA,FW,Chaves,25,1996,20.1,20,15,4,14,2,9,23,39.1,14,12,3,9,12,32,12,0,Primeira_Liga,2022_2023
Luiz Lúcio Reis Júnior,BRA,GK,Famalicão,21,2001,33.0,0,0,0,0,0,0,4,0.0,4,0,0,0,0,0,20,2,Primeira_Liga,2022_2023
Welinton Júnior,BRA,FW,Portimonense,29,1993,22.9,18,7,2,11,5,5,27,18.5,22,10,0,10,6,24,7,1,Primeira_Liga,2022_2023
Zainadine Júnior,MOZ,DF,Marítimo,34,1988,23.1,23,13,13,8,2,13,18,72.2,5,22,18,4,33,56,73,1,Primeira_Liga,2022_2023
Junior Kadile,FRA,"FW,MF",Famalicão,19,2002,7.4,18,10,9,7,2,4,15,26.7,11,5,0,5,3,21,5,0,Primeira_Liga,2022_2023
Stanley Kanu,NGA,"FW,DF",Marítimo,23,1999,0.8,1,1,0,1,0,0,1,0.0,1,1,0,1,0,1,0,0,Primeira_Liga,2022_2023
Jorge Karse,POR,"MF,DF",Rio Ave,17,2005,0.2,0,0,0,0,0,0,1,0.0,1,0,0,0,0,0,0,0,Primeira_Liga,2022_2023
Francisco Kiki,POR,MF,Casa Pia,24,1998,0.1,0,0,0,0,0,0,0,,0,2,0,2,0,0,0,0,Primeira_Liga,2022_2023
Gustavo Klismahn,BRA,MF,Portimonense,22,1999,7.8,15,8,3,9,3,2,8,25.0,6,11,1,10,3,18,8,1,Primeira_Liga,2022_2023
Philippe Koffi,CIV,FW,Paços,20,2002,7.4,9,3,6,1,2,7,9,77.8,2,0,0,0,2,11,3,0,Primeira_Liga,2022_2023
Stanislav Kritsyuk,RUS,GK,Gil Vicente FC,31,1990,10.3,1,1,1,0,0,1,1,100.0,0,0,0,0,0,1,6,0,Primeira_Liga,2022_2023
Takahiro Kunimoto,JPN,"FW,MF",Casa Pia,24,1997,14.1,14,8,5,8,1,9,31,29.0,22,22,0,22,9,23,7,0,Primeira_Liga,2022_2023
Matías Lacava,VEN,"FW,MF",Vizela,19,2002,3.9,7,4,2,4,1,1,7,14.3,6,5,0,5,1,8,1,0,Primeira_Liga,2022_2023
Diego Lainez,MEX,MF,Braga,22,2000,1.7,3,2,0,3,0,1,2,50.0,1,0,0,0,1,4,0,0,Primeira_Liga,2022_2023
Chico Lamba,POR,DF,Sporting CP,19,2003,0.5,0,0,0,0,0,0,0,,0,0,0,0,0,0,0,0,Primeira_Liga,2022_2023
Rúben Lameiras,POR,"FW,MF",Vitória,27,1994,12.6,15,9,6,5,4,7,17,41.2,10,5,0,5,3,18,4,0,Primeira_Liga,2022_2023
Bruno Langa,MOZ,DF,Chaves,24,1997,27.5,35,25,22,6,7,16,29,55.2,13,35,10,25,31,66,74,0,Primeira_Liga,2022_2023
Yusuf Lawal,NGA,"MF,FW",Arouca,24,1998,0.9,5,4,2,2,1,1,3,33.3,2,1,1,0,0,5,2,0,Primeira_Liga,2022_2023
James Lea Siliki,CMR,"MF,FW",Estoril,26,1996,8.9,15,12,7,7,1,7,11,63.6,4,9,2,7,9,24,4,0,Primeira_Liga,2022_2023
Leonardo Lelo,POR,"MF,DF",Casa Pia,22,2000,25.4,40,17,23,16,1,24,53,45.3,29,29,3,26,37,77,46,0,Primeira_Liga,2022_2023
Nuno Lima,POR,DF,Paços,21,2001,27.2,26,17,20,5,1,12,23,52.2,11,38,24,14,40,66,112,0,Primeira_Liga,2022_2023
Rúben Lima,POR,DF,Famalicão,32,1989,13.2,17,10,11,6,0,4,9,44.4,5,21,8,13,32,49,48,0,Primeira_Liga,2022_2023
Percy Liza,PER,"FW,MF",Marítimo,22,2000,4.7,5,4,1,3,1,2,3,66.7,1,2,1,1,0,5,4,0,Primeira_Liga,2022_2023
Danny Loader,ENG,"FW,MF",Porto,21,2000,5.0,8,6,4,2,2,2,6,33.3,4,4,0,4,2,10,4,0,Primeira_Liga,2022_2023
Julien Lomboto,nan,MF,Rio Ave,20,2002,0.1,2,0,2,0,0,0,0,,0,0,0,0,0,2,0,0,Primeira_Liga,2022_2023
Né lopes,POR,DF,Gil Vicente FC,22,2000,5.0,2,2,1,1,0,1,2,50.0,1,13,12,1,6,8,11,0,Primeira_Liga,2022_2023
Bruno Lourenço,POR,"MF,FW",Boavista,24,1998,20.9,33,19,15,13,5,16,41,39.0,25,21,1,20,14,47,8,0,Primeira_Liga,2022_2023
Lucão,BRA,DF,Portimonense,30,1992,5.9,6,4,5,0,1,4,5,80.0,1,4,4,0,3,9,22,0,Primeira_Liga,2022_2023
Florentino Luís,POR,MF,Benfica,22,1999,23.6,82,45,29,37,16,46,66,69.7,20,26,1,25,63,145,27,0,Primeira_Liga,2022_2023
José Luis Rodríguez,PAN,"FW,MF",Famalicão,24,1998,5.6,4,1,2,0,2,2,4,50.0,2,3,1,2,1,5,2,0,Primeira_Liga,2022_2023
Luquinha,BRA,"MF,FW",Portimonense,21,2000,13.0,17,12,9,2,6,8,18,44.4,10,21,2,19,1,18,3,0,Primeira_Liga,2022_2023
Tiago Machado,POR,"MF,FW",Boavista,18,2004,0.1,0,0,0,0,0,0,0,,0,1,0,1,0,0,0,0,Primeira_Liga,2022_2023
Miguel Maga,POR,"DF,MF",Vitória,19,2002,2.2,65,38,45,11,9,45,72,62.5,27,36,8,28,40,105,52,0,Primeira_Liga,2022_2023
Magrão,BRA,GK,Rio Ave,22,2000,2.0,0,0,0,0,0,0,0,,0,0,0,0,0,0,3,0,Primeira_Liga,2022_2023
Giorgi Makaridze,GEO,GK,Marítimo,32,1990,6.0,1,0,1,0,0,1,1,100.0,0,0,0,0,0,1,3,0,Primeira_Liga,2022_2023
Gaius Makouta,CGO,MF,Boavista,25,1997,30.4,37,19,13,22,2,15,36,41.7,21,19,5,14,40,77,45,0,Primeira_Liga,2022_2023
Pedro Malheiro,POR,"DF,MF",Boavista,21,2001,31.0,94,55,60,30,4,47,78,60.3,31,42,4,38,37,131,66,0,Primeira_Liga,2022_2023
Wilson Manafá,POR,DF,Porto,28,1994,3.4,3,3,2,1,0,2,3,66.7,1,7,1,6,3,6,6,0,Primeira_Liga,2022_2023
Ricardo Mangas,POR,"MF,FW",Boavista,24,1998,20.6,15,6,8,5,2,7,19,36.8,12,5,1,4,14,29,25,0,Primeira_Liga,2022_2023
Manuel Manu,POR,DF,Vitória,21,2001,0.8,2,1,2,0,0,0,0,,0,0,0,0,0,2,0,0,Primeira_Liga,2022_2023
Juan Manuel Boselli,URU,FW,Gil Vicente FC,22,1999,13.8,27,19,12,11,4,14,39,35.9,25,27,0,27,9,36,14,0,Primeira_Liga,2022_2023
José Manuel Velázquez,VEN,"DF,MF",Arouca,31,1990,0.1,0,0,0,0,0,0,0,,0,0,0,0,0,0,4,0,Primeira_Liga,2022_2023
Zé Manuel,POR,FW,Rio Ave,31,1990,0.3,2,1,2,0,0,0,0,,0,0,0,0,0,2,0,0,Primeira_Liga,2022_2023
Maracás,BRA,DF,Paços,28,1994,15.8,20,13,17,3,0,10,18,55.6,8,19,12,7,21,41,69,0,Primeira_Liga,2022_2023
Iván Marcano,ESP,DF,Porto,35,1987,24.4,18,11,14,4,0,8,18,44.4,10,24,16,8,27,45,66,1,Primeira_Liga,2022_2023
Joao Marcos,BRA,"FW,MF",Santa Clara,22,2000,1.8,2,1,0,1,1,0,1,0.0,1,0,0,0,0,2,0,0,Primeira_Liga,2022_2023
Abraham Marcus,NGA,FW,Porto,22,2000,0.0,0,0,0,0,0,0,0,,0,0,0,0,0,0,0,0,Primeira_Liga,2022_2023
Adrián Marín,ESP,DF,Gil Vicente FC,25,1997,28.6,63,38,37,20,6,35,54,64.8,19,30,5,25,31,94,78,0,Primeira_Liga,2022_2023
João Mário,POR,FW,Benfica,29,1993,29.4,45,28,9,26,10,17,49,34.7,32,40,1,39,11,56,12,0,Primeira_Liga,2022_2023
João Mário Lopes,POR,DF,Porto,22,2000,13.2,26,11,13,6,7,15,33,45.5,18,8,0,8,10,36,14,0,Primeira_Liga,2022_2023
Marlon,BRA,FW,Gil Vicente FC,24,1997,4.2,7,4,5,0,2,6,13,46.2,7,11,0,11,2,9,1,0,Primeira_Liga,2022_2023
Alejandro Marqués,VEN,FW,Estoril,21,2000,7.3,5,4,0,4,1,1,5,20.0,4,6,3,3,3,8,6,0,Primeira_Liga,2022_2023
João Marques,POR,MF,Estoril,20,2002,4.3,7,2,5,2,0,2,6,33.3,4,6,0,6,0,7,2,0,Primeira_Liga,2022_2023
Rúben Marques,POR,FW,Marítimo,19,2002,0.7,0,0,0,0,0,0,1,0.0,1,0,0,0,0,0,0,0,Primeira_Liga,2022_2023
José Marsà,ESP,DF,Sporting CP,20,2002,1.3,0,0,0,0,0,0,0,,0,2,1,1,3,3,1,0,Primeira_Liga,2022_2023
Toni Martínez,ESP,FW,Porto,25,1997,12.8,21,12,3,5,13,8,12,66.7,4,10,0,10,2,23,3,0,Primeira_Liga,2022_2023
Rafael Martins,BRA,FW,Casa Pia,33,1989,15.9,8,4,1,5,2,0,4,0.0,4,13,0,13,0,8,15,0,Primeira_Liga,2022_2023
Rodrigo Martins,POR,"FW,MF",Estoril,23,1998,15.4,16,8,5,8,3,8,22,36.4,14,8,1,7,4,20,10,0,Primeira_Liga,2022_2023
Matheus,BRA,GK,Braga,30,1992,31.9,2,0,2,0,0,2,4,50.0,2,0,0,0,1,3,19,1,Primeira_Liga,2022_2023
Ricardo Matos,POR,"FW,MF",Portimonense,22,2000,3.3,2,2,1,0,1,1,2,50.0,1,0,0,0,0,2,1,0,Primeira_Liga,2022_2023
Maurício,BRA,MF,Portimonense,33,1988,11.0,22,16,6,14,2,10,27,37.0,17,16,4,12,15,37,11,0,Primeira_Liga,2022_2023
Iuri Medeiros,POR,"MF,FW",Braga,28,1994,22.9,24,11,7,14,3,12,32,37.5,20,21,1,20,6,30,8,0,Primeira_Liga,2022_2023
Kevin Medina,ESP,"FW,MF",Gil Vicente FC,21,2001,8.2,26,17,9,10,7,15,30,50.0,15,9,2,7,4,30,5,1,Primeira_Liga,2022_2023
Mauro Meireles Couto,POR,"MF,FW",Paços,16,2005,1.4,1,1,1,0,0,0,1,0.0,1,2,0,2,0,1,2,0,Primeira_Liga,2022_2023
Diogo Mendes,CPV,MF,Marítimo,24,1998,13.7,33,16,12,19,2,20,32,62.5,12,19,1,18,8,41,14,0,Primeira_Liga,2022_2023
João Mendes,POR,MF,Chaves,27,1994,25.9,34,18,10,16,8,18,47,38.3,29,24,0,24,17,51,6,0,Primeira_Liga,2022_2023
Joe Mendes,SWE,"DF,MF",Braga,19,2002,2.1,1,0,0,1,0,0,1,0.0,1,3,0,3,6,7,4,0,Primeira_Liga,2022_2023
Alex Mendez,USA,"MF,FW",Vizela,21,2000,15.8,40,18,14,19,7,14,29,48.3,15,13,1,12,16,56,15,0,Primeira_Liga,2022_2023
Bruno Messi,POR,"MF,FW",Santa Clara,25,1996,14.0,18,6,8,9,1,6,27,22.2,21,27,3,24,8,26,10,1,Primeira_Liga,2022_2023
Mexer,MOZ,DF,Estoril,33,1988,10.8,11,5,9,2,0,7,9,77.8,2,9,7,2,12,23,32,0,Primeira_Liga,2022_2023
Benji Michel,USA,FW,Arouca,24,1997,3.1,1,1,0,1,0,0,1,0.0,1,2,0,2,1,2,10,0,Primeira_Liga,2022_2023
Enea Mihaj,ALB,DF,Famalicão,24,1998,24.7,23,11,18,4,1,12,25,48.0,13,29,22,7,32,55,91,0,Primeira_Liga,2022_2023
Álex Millán,ESP,FW,Famalicão,22,1999,8.6,6,2,1,1,4,4,9,44.4,5,6,1,5,0,6,6,0,Primeira_Liga,2022_2023
Bogdan Milovanov,UKR,DF,Arouca,24,1998,11.0,38,22,22,11,5,22,35,62.9,13,12,2,10,18,56,54,0,Primeira_Liga,2022_2023
Kento Misao,JPN,MF,Santa Clara,26,1996,11.7,30,17,12,16,2,12,27,44.4,15,19,9,10,16,46,13,0,Primeira_Liga,2022_2023
Zié Mohamed Ouattara,CIV,"FW,MF",Portimonense,22,2000,12.9,28,16,15,12,1,11,18,61.1,7,18,3,15,14,42,22,0,Primeira_Liga,2022_2023
Jonathan Monroy,ESP,"FW,MF",Chaves,20,2001,7.4,16,10,9,6,1,11,23,47.8,12,8,2,6,7,23,5,0,Primeira_Liga,2022_2023
Nélson Monte,POR,DF,Chaves,27,1995,28.7,34,23,25,8,1,23,43,53.5,20,41,24,17,55,89,150,0,Primeira_Liga,2022_2023
Miguel Monteiro,POR,FW,Gil Vicente FC,19,2003,0.1,0,0,0,0,0,0,0,,0,0,0,0,0,0,0,0,Primeira_Liga,2022_2023
Morato,BRA,DF,Benfica,21,2001,7.2,9,7,6,2,1,3,5,60.0,2,5,3,2,7,16,19,0,Primeira_Liga,2022_2023
Pablo Moreno,ESP,"FW,MF",Marítimo,20,2002,9.9,16,9,6,5,5,7,18,38.9,11,7,0,7,2,18,1,0,Primeira_Liga,2022_2023
Hélder Morim,POR,"MF,FW",Chaves,21,2001,1.0,4,2,3,1,0,3,5,60.0,2,5,0,5,1,5,1,0,Primeira_Liga,2022_2023
Hidemasa Morita,JPN,MF,Sporting CP,27,1995,21.8,50,33,13,29,8,21,32,65.6,11,27,5,22,26,76,18,0,Primeira_Liga,2022_2023
Mosquito,BRA,GK,Arouca,26,1996,1.0,0,0,0,0,0,0,0,,0,0,0,0,0,0,1,0,Primeira_Liga,2022_2023
Fahd Moufi,MAR,DF,Portimonense,26,1996,29.3,29,19,16,11,2,17,28,60.7,11,46,17,29,45,74,69,0,Primeira_Liga,2022_2023
Moura,POR,DF,Famalicão,22,1999,23.6,31,16,11,16,4,15,28,53.6,13,35,9,26,27,58,71,0,Primeira_Liga,2022_2023
Rodrigo Moura,BRA,GK,Chaves,26,1996,4.0,0,0,0,0,0,0,0,,0,1,0,1,0,0,2,0,Primeira_Liga,2022_2023
MT,BRA,"DF,MF",Santa Clara,21,2001,12.6,29,15,15,10,4,21,37,56.8,16,13,3,10,13,42,37,1,Primeira_Liga,2022_2023
Rafa Mújica,ESP,FW,Arouca,23,1998,18.1,23,19,3,12,8,2,10,20.0,8,19,1,18,2,25,28,0,Primeira_Liga,2022_2023
Petar Musa,CRO,FW,Benfica,24,1998,7.4,12,9,1,4,7,4,11,36.4,7,5,3,2,7,19,3,0,Primeira_Liga,2022_2023
Almoatasem Al Musrati,LBY,MF,Braga,26,1996,25.7,66,34,23,35,8,29,63,46.0,34,44,13,31,57,123,26,0,Primeira_Liga,2022_2023
Kosuke Nakamura,JPN,GK,Portimonense,27,1995,30.0,1,1,1,0,0,1,3,33.3,2,0,0,0,0,1,24,2,Primeira_Liga,2022_2023
Léo Natel,BRA,FW,Casa Pia,25,1997,0.6,0,0,0,0,0,0,0,,0,0,0,0,0,0,1,0,Primeira_Liga,2022_2023
Fran Navarro,ESP,FW,Gil Vicente FC,24,1998,33.7,23,12,1,16,6,8,31,25.8,23,24,3,21,3,26,7,0,Primeira_Liga,2022_2023
Flávio Nazinho,POR,DF,Sporting CP,19,2003,1.1,3,2,2,1,0,2,3,66.7,1,1,1,0,0,3,2,0,Primeira_Liga,2022_2023
Mor Ndiaye,SEN,MF,Estoril,21,2000,15.6,32,21,14,16,2,21,29,72.4,8,19,10,9,13,45,63,2,Primeira_Liga,2022_2023
Cher Ndour,ITA,MF,Benfica,18,2004,0.0,0,0,0,0,0,0,0,,0,0,0,0,0,0,0,0,Primeira_Liga,2022_2023
Christian Neiva Afonso,POR,DF,Vizela,27,1994,24.7,46,34,27,15,4,24,38,63.2,14,23,13,10,46,92,79,0,Primeira_Liga,2022_2023
Nelson,ANG,"FW,MF",Vitória,24,1998,12.9,29,20,11,12,6,6,12,50.0,6,12,0,12,15,44,17,0,Primeira_Liga,2022_2023
David Neres,BRA,"FW,MF",Benfica,25,1997,21.8,21,8,5,10,6,10,27,37.0,17,11,0,11,3,24,1,0,Primeira_Liga,2022_2023
Neto,BRA,MF,Casa Pia,30,1991,17.0,33,18,17,14,2,15,52,28.8,37,20,4,16,28,61,20,1,Primeira_Liga,2022_2023
Luís Neto,POR,DF,Sporting CP,34,1988,3.0,6,3,4,2,0,4,5,80.0,1,2,1,1,1,7,6,0,Primeira_Liga,2022_2023
João Neves,POR,"MF,FW",Benfica,17,2004,6.8,26,19,14,9,3,13,26,50.0,13,15,3,12,9,35,5,0,Primeira_Liga,2022_2023
Sikou Niakaté,MLI,DF,Braga,23,1999,23.6,22,10,11,10,1,13,25,52.0,12,24,11,13,49,71,93,0,Primeira_Liga,2022_2023
Yusupha Njie,GAM,FW,Boavista,28,1994,23.6,25,16,3,14,8,4,18,22.2,14,22,5,17,8,33,17,0,Primeira_Liga,2022_2023
Miguel Nóbrega,POR,DF,Rio Ave,22,2000,6.2,8,5,4,3,1,5,8,62.5,3,10,6,4,4,12,28,0,Primeira_Liga,2022_2023
Gonçalo Nogueira,POR,MF,Vitória,18,2003,0.2,0,0,0,0,0,0,0,,0,0,0,0,0,0,1,0,Primeira_Liga,2022_2023
Ygor Nogueira,BRA,DF,Santa Clara,27,1995,11.3,18,10,13,4,1,10,15,66.7,5,17,11,6,18,36,49,1,Primeira_Liga,2022_2023
Nonoca,BRA,MF,Portimonense,24,1998,6.3,13,11,6,6,1,5,12,41.7,7,13,3,10,2,15,2,1,Primeira_Liga,2022_2023
Arsénio Martins Lafuente Nunes,POR,"FW,MF",Arouca,32,1989,10.8,7,4,5,1,1,4,13,30.8,9,13,2,11,2,9,10,0,Primeira_Liga,2022_2023
João Nunes,POR,DF,Casa Pia,26,1995,18.3,37,21,29,8,0,26,38,68.4,12,31,18,13,24,61,79,0,Primeira_Liga,2022_2023
Matheus Nunes,POR,MF,Sporting CP,23,1998,2.0,2,2,0,2,0,1,1,100.0,0,3,0,3,3,5,0,0,Primeira_Liga,2022_2023
Nwankwo Obiora,NGA,MF,Chaves,31,1991,6.9,12,8,6,6,0,8,14,57.1,6,8,2,6,8,20,11,0,Primeira_Liga,2022_2023
Ryoya Ogawa,JPN,"DF,MF",Vitória,25,1996,2.3,2,0,2,0,0,0,2,0.0,2,2,0,2,3,5,5,0,Primeira_Liga,2022_2023
Hugo Oliveira,POR,DF,Vizela,20,2002,0.1,0,0,0,0,0,0,0,,0,0,0,0,0,0,0,0,Primeira_Liga,2022_2023
Paulo Oliveira,POR,DF,Braga,30,1992,16.4,22,14,15,7,0,11,13,84.6,2,18,12,6,50,72,75,0,Primeira_Liga,2022_2023
Rúben Alexandre Gomes Oliveira,POR,MF,Santa Clara,27,1994,0.2,1,1,0,0,1,0,1,0.0,1,1,0,1,1,2,0,0,Primeira_Liga,2022_2023
Bruno Onyemaechi,NGA,DF,Boavista,23,1999,28.1,55,39,39,13,3,37,56,66.1,19,22,5,17,37,92,67,1,Primeira_Liga,2022_2023
Monsuru Opeyemi,NGA,FW,Vizela,18,2003,0.5,0,0,0,0,0,0,0,,0,2,0,2,0,0,0,0,Primeira_Liga,2022_2023
Jerome Opoku,GHA,DF,Arouca,23,1998,21.3,23,12,16,6,1,8,11,72.7,3,28,15,13,26,49,82,1,Primeira_Liga,2022_2023
Pedro Ortiz,ESP,MF,Vizela,21,2000,5.3,19,11,5,12,2,11,20,55.0,9,6,3,3,6,25,9,0,Primeira_Liga,2022_2023
Milutin Osmajić,MNE,FW,Vizela,23,1999,22.7,4,4,0,2,2,2,6,33.3,4,12,2,10,1,5,15,0,Primeira_Liga,2022_2023
Nicolás Otamendi,ARG,DF,Benfica,34,1988,30.8,67,48,32,31,4,48,67,71.6,19,32,11,21,66,133,92,1,Primeira_Liga,2022_2023
Otávio,POR,MF,Porto,27,1995,25.2,70,43,23,26,21,35,84,41.7,49,32,3,29,18,88,17,0,Primeira_Liga,2022_2023
João Othavio Basso,BRA,DF,Arouca,25,1997,31.6,55,31,39,15,1,22,44,50.0,22,43,27,16,51,106,159,1,Primeira_Liga,2022_2023
Amine Oudrhiri,MAR,MF,Rio Ave,29,1992,8.7,9,7,3,5,1,6,11,54.5,5,7,2,5,9,18,10,0,Primeira_Liga,2022_2023
Pablo,BRA,FW,Famalicão,18,2004,7.9,16,9,3,12,1,4,15,26.7,11,9,0,9,5,21,6,0,Primeira_Liga,2022_2023
Lucas Paes,BRA,GK,Casa Pia,24,1997,2.0,0,0,0,0,0,0,2,0.0,2,0,0,0,0,0,0,1,Primeira_Liga,2022_2023
Renato Pantalon,CRO,DF,Rio Ave,24,1997,19.9,30,18,15,15,0,16,26,61.5,10,29,18,11,26,56,80,0,Primeira_Liga,2022_2023
David Pastor,BRA,MF,Portimonense,22,2000,0.0,0,0,0,0,0,0,0,,0,0,0,0,0,0,0,0,Primeira_Liga,2022_2023
Patrick,BRA,DF,Rio Ave,25,1997,21.1,38,26,21,12,5,24,38,63.2,14,20,10,10,24,62,76,0,Primeira_Liga,2022_2023
Paulinho,POR,FW,Sporting CP,29,1992,15.1,26,13,2,15,9,6,9,66.7,3,9,1,8,7,33,9,0,Primeira_Liga,2022_2023
Pedrão,BRA,DF,Portimonense,25,1997,28.7,40,25,31,6,3,21,39,53.8,18,39,16,23,39,79,117,2,Primeira_Liga,2022_2023
João Pedro,POR,MF,Chaves,29,1993,6.6,13,6,10,3,0,5,13,38.5,8,5,0,5,9,22,7,0,Primeira_Liga,2022_2023
Zé Pedro,POR,GK,Paços,20,2002,3.0,0,0,0,0,0,0,0,,0,0,0,0,0,0,0,1,Primeira_Liga,2022_2023
Pelé,GNB,MF,Famalicão,30,1991,6.8,14,6,9,4,1,6,9,66.7,3,5,3,2,4,18,5,2,Primeira_Liga,2022_2023
Alexandre Penetra,POR,DF,Famalicão,20,2001,27.9,50,36,34,14,2,28,49,57.1,21,28,13,15,32,82,59,0,Primeira_Liga,2022_2023
Pepe,POR,DF,Porto,39,1983,21.8,41,28,22,18,1,26,38,68.4,12,18,12,6,25,66,58,0,Primeira_Liga,2022_2023
Pepê,BRA,"MF,DF",Porto,25,1997,29.4,41,28,21,15,5,21,50,42.0,29,26,2,24,44,85,21,0,Primeira_Liga,2022_2023
André Pereira,POR,FW,Rio Ave,27,1995,11.1,13,9,5,5,3,4,14,28.6,10,10,2,8,4,17,9,1,Primeira_Liga,2022_2023
Gabriel Pereira,BRA,DF,Gil Vicente FC,22,2000,4.6,10,6,9,1,0,6,13,46.2,7,9,7,2,6,16,17,0,Primeira_Liga,2022_2023
Marco André Rocha Pereira,POR,GK,Santa Clara,35,1987,8.0,0,0,0,0,0,0,1,0.0,1,0,0,0,0,0,3,0,Primeira_Liga,2022_2023
Matheus Pereira,BRA,DF,Vizela,21,2000,9.0,20,8,11,8,1,16,25,64.0,9,12,3,9,10,30,17,0,Primeira_Liga,2022_2023
Sebastián Pérez Cardona,COL,MF,Boavista,29,1993,27.3,71,38,26,40,5,35,82,42.7,47,24,4,20,40,111,25,0,Primeira_Liga,2022_2023
Kevin Pina,CPV,MF,Chaves,24,1997,4.1,11,4,6,4,1,4,8,50.0,4,6,2,4,10,21,8,0,Primeira_Liga,2022_2023
Rodrigo Pinho,BRA,FW,Benfica,31,1991,0.5,0,0,0,0,0,0,0,,0,1,0,1,0,0,0,0,Primeira_Liga,2022_2023
Dinis Pinto,POR,DF,Braga,21,2000,0.1,0,0,0,0,0,0,0,,0,0,0,0,0,0,1,0,Primeira_Liga,2022_2023
Diogo Pinto,POR,"FW,MF",Casa Pia,23,1999,5.1,8,6,6,2,0,5,9,55.6,4,1,0,1,2,10,2,0,Primeira_Liga,2022_2023
Gonçalo Pinto,POR,GK,Chaves,22,2000,0.0,0,0,0,0,0,0,0,,0,0,0,0,0,0,1,0,Primeira_Liga,2022_2023
Rui Pires,POR,MF,Paços,24,1998,26.8,59,42,29,25,5,30,51,58.8,21,38,16,22,37,96,60,1,Primeira_Liga,2022_2023
Pizzi,POR,"MF,FW",Braga,32,1989,5.4,11,7,6,2,3,4,14,28.6,10,4,0,4,2,13,7,0,Primeira_Liga,2022_2023
Carlos Ponck,CPV,DF,Chaves,27,1995,20.0,21,19,9,9,3,7,11,63.6,4,38,25,13,28,49,85,1,Primeira_Liga,2022_2023
Pedro Porro,ESP,"DF,MF",Sporting CP,22,1999,11.9,19,15,10,7,2,13,25,52.0,12,10,1,9,8,27,13,0,Primeira_Liga,2022_2023
Samuel Portugal,BRA,GK,Portimonense,28,1994,4.0,0,0,0,0,0,0,1,0.0,1,0,0,0,0,0,0,0,Primeira_Liga,2022_2023
Quaresma,BRA,DF,Arouca,25,1996,30.4,74,44,49,20,5,42,80,52.5,38,36,11,25,45,119,79,0,Primeira_Liga,2022_2023
Diogo Queirós,POR,FW,Famalicão,23,1999,0.1,0,0,0,0,0,0,0,,0,1,0,1,0,0,1,0,Primeira_Liga,2022_2023
João Queirós,POR,DF,Chaves,24,1998,2.9,7,6,7,0,0,5,8,62.5,3,7,4,3,1,8,20,1,Primeira_Liga,2022_2023
Xavi Quintillà,ESP,DF,Santa Clara,25,1996,8.0,15,13,7,6,2,8,16,50.0,8,7,2,5,3,18,22,0,Primeira_Liga,2022_2023
Uroš Račić,SRB,MF,Braga,24,1998,12.4,20,13,7,11,2,9,20,45.0,11,20,6,14,20,40,27,0,Primeira_Liga,2022_2023
Rafa,POR,GK,Vitória,18,2003,2.0,1,1,1,0,0,1,2,50.0,1,0,0,0,0,1,1,1,Primeira_Liga,2022_2023
Jesús Ramírez,VEN,"FW,MF",Marítimo,24,1998,6.5,6,4,0,2,4,3,7,42.9,4,3,1,2,1,7,6,0,Primeira_Liga,2022_2023
Cláudio Ramos,POR,GK,Porto,30,1991,1.0,0,0,0,0,0,0,0,,0,0,0,0,0,0,0,1,Primeira_Liga,2022_2023
Flávio Ramos,BRA,DF,Paços,28,1994,8.3,9,2,7,2,0,5,8,62.5,3,15,10,5,13,22,41,0,Primeira_Liga,2022_2023
Gonçalo Ramos,POR,FW,Benfica,21,2001,25.4,20,12,3,10,7,7,22,31.8,15,10,3,7,3,23,35,0,Primeira_Liga,2022_2023
Osama Rashid,IRQ,"MF,FW",Vizela,30,1992,4.2,2,0,1,1,0,1,6,16.7,5,7,1,6,4,6,8,0,Primeira_Liga,2022_2023
Bruno Reis,POR,"MF,DF",Portimonense,23,1999,0.8,1,1,0,1,0,0,1,0.0,1,2,0,2,1,2,0,0,Primeira_Liga,2022_2023
Matheus Reis,BRA,DF,Sporting CP,27,1995,25.4,32,18,12,15,5,20,27,74.1,7,23,6,17,11,43,35,0,Primeira_Liga,2022_2023
Miguel Reisinho,POR,"DF,MF",Boavista,23,1999,0.2,0,0,0,0,0,0,0,,0,0,0,0,0,0,1,0,Primeira_Liga,2022_2023
Filipe Relvas,POR,DF,Portimonense,22,1999,31.9,50,30,27,19,4,21,30,70.0,9,46,24,22,57,107,137,0,Primeira_Liga,2022_2023
Brayan Riascos,COL,"FW,MF",Marítimo,27,1994,9.7,12,8,3,5,4,4,10,40.0,6,6,0,6,3,15,16,0,Primeira_Liga,2022_2023
Rodrigo Ribeiro,POR,FW,Sporting CP,17,2005,0.3,2,0,0,1,1,0,1,0.0,1,0,0,0,1,3,0,0,Primeira_Liga,2022_2023
Tiago Ribeiro,POR,MF,Paços,20,2002,2.0,4,3,2,2,0,1,7,14.3,6,2,2,0,2,6,2,0,Primeira_Liga,2022_2023
Ricardinho,POR,"FW,MF",Santa Clara,23,1998,20.0,24,17,8,12,4,13,36,36.1,23,20,3,17,7,31,14,0,Primeira_Liga,2022_2023
Riccieli,BRA,DF,Famalicão,23,1998,28.7,40,26,30,10,0,23,44,52.3,21,54,29,25,29,69,161,0,Primeira_Liga,2022_2023
Rildo,BRA,"FW,MF",Santa Clara,22,2000,9.1,19,9,7,7,5,7,17,41.2,10,11,1,10,3,22,6,0,Primeira_Liga,2022_2023
Mihailo Ristić,SRB,DF,Benfica,26,1995,1.3,2,2,1,0,1,1,1,100.0,0,3,0,3,2,4,1,0,Primeira_Liga,2022_2023
Robson,BRA,DF,Boavista,22,2000,1.4,2,0,1,1,0,0,2,0.0,2,3,1,2,2,4,12,0,Primeira_Liga,2022_2023
Bryan Róchez,HON,"FW,MF",Portimonense,27,1995,9.9,10,8,2,6,2,2,9,22.2,7,5,2,3,1,11,8,0,Primeira_Liga,2022_2023
Rochinha,POR,"FW,MF",Sporting CP,27,1995,4.8,4,1,0,4,0,1,4,25.0,3,3,1,2,5,9,0,0,Primeira_Liga,2022_2023
Bruno Rodrigues,POR,DF,Braga,21,2001,1.0,1,1,0,1,0,1,2,50.0,1,1,1,0,1,2,3,0,Primeira_Liga,2022_2023
Gonçalo Rodrigues,POR,MF,Rio Ave,25,1997,32.2,64,37,18,40,6,29,72,40.3,43,25,5,20,25,89,22,1,Primeira_Liga,2022_2023
Ivo Rodrigues,POR,"MF,FW",Famalicão,27,1995,26.3,61,36,24,26,11,30,65,46.2,35,30,6,24,20,81,23,0,Primeira_Liga,2022_2023
Diego Rosa,BRA,"MF,FW",Vizela,19,2002,2.9,10,5,5,4,1,6,12,50.0,6,6,2,4,5,15,7,0,Primeira_Liga,2022_2023
Loreintz Rosier,FRA,MF,Estoril,23,1998,11.5,34,23,16,18,0,15,28,53.6,13,11,2,9,22,56,25,3,Primeira_Liga,2022_2023
Mabrouk Rouai,FRA,"FW,MF",Estoril,21,2000,0.4,1,0,0,0,1,1,1,100.0,0,1,1,0,0,1,0,0,Primeira_Liga,2022_2023
Abel Ruiz,ESP,FW,Braga,22,2000,23.0,13,7,4,7,2,5,19,26.3,14,18,2,16,7,20,9,0,Primeira_Liga,2022_2023
Alan Ruiz,ARG,MF,Arouca,28,1993,27.7,39,24,13,25,1,21,45,46.7,24,18,4,14,9,48,23,1,Primeira_Liga,2022_2023
Leonardo Ruíz,COL,FW,Rio Ave,26,1996,10.3,5,4,2,2,1,3,15,20.0,12,7,4,3,2,7,4,0,Primeira_Liga,2022_2023
Gustavo sá,POR,"MF,FW",Famalicão,17,2004,4.3,11,7,3,6,2,3,10,30.0,7,3,1,2,2,13,6,0,Primeira_Liga,2022_2023
Helder Sá,POR,"DF,MF",Vitória,19,2002,8.9,21,12,14,5,2,11,20,55.0,9,15,3,12,5,26,21,0,Primeira_Liga,2022_2023
Josué Sá,POR,DF,Rio Ave,30,1992,15.0,21,15,15,5,1,6,14,42.9,8,14,8,6,16,37,57,0,Primeira_Liga,2022_2023
Pedro Sá,POR,MF,Portimonense,28,1993,8.2,11,3,2,7,2,7,27,25.9,20,7,3,4,6,17,20,0,Primeira_Liga,2022_2023
Tiago Sá,POR,GK,Braga,27,1995,1.9,0,0,0,0,0,0,0,,0,0,0,0,0,0,0,0,Primeira_Liga,2022_2023
Serdar Saatçı,TUR,DF,Braga,19,2003,2.4,2,2,1,1,0,1,3,33.3,2,1,0,1,8,10,3,0,Primeira_Liga,2022_2023
Safira,BRA,FW,Vitória,27,1995,9.1,8,5,1,5,2,1,8,12.5,7,7,2,5,1,9,8,0,Primeira_Liga,2022_2023
Pierre Sagna,SEN,DF,Santa Clara,31,1990,19.5,37,19,22,13,2,17,25,68.0,8,16,4,12,33,70,60,1,Primeira_Liga,2022_2023
Arthur Sales,BRA,"FW,MF",Paços,20,2002,4.0,5,2,0,3,2,1,5,20.0,4,3,0,3,3,8,2,0,Primeira_Liga,2022_2023
Andreas Samaris,GRE,MF,Rio Ave,33,1989,15.6,34,15,13,19,2,15,29,51.7,14,26,7,19,9,43,23,0,Primeira_Liga,2022_2023
Samu,POR,MF,Vizela,26,1996,29.8,76,44,30,34,12,33,77,42.9,44,46,7,39,45,121,41,0,Primeira_Liga,2022_2023
Leandro Sanca,GNB,"FW,MF",Famalicão,22,2000,4.9,12,7,7,3,2,7,20,35.0,13,9,0,9,4,16,5,0,Primeira_Liga,2022_2023
Elder Santana,BRA,"MF,FW",Gil Vicente FC,29,1993,0.5,2,1,0,0,2,0,2,0.0,2,0,0,0,0,2,1,0,Primeira_Liga,2022_2023
Aderlan Santos,BRA,DF,Rio Ave,33,1989,31.3,55,35,35,20,0,22,34,64.7,12,41,27,14,53,108,167,1,Primeira_Liga,2022_2023
Luís Santos,POR,"FW,MF",Boavista,22,2000,3.2,5,3,1,4,0,0,5,0.0,5,3,0,3,3,8,3,0,Primeira_Liga,2022_2023
Nuno Santos,POR,"DF,MF",Sporting CP,27,1995,25.2,22,12,7,10,5,17,32,53.1,15,14,2,12,23,45,12,0,Primeira_Liga,2022_2023
Pedro Santos,POR,"FW,MF",Braga,21,2000,0.1,0,0,0,0,0,0,0,,0,0,0,0,0,0,0,0,Primeira_Liga,2022_2023
Rene Santos,BRA,"DF,MF",Marítimo,30,1992,12.1,25,17,13,8,4,14,19,73.7,5,19,8,11,10,35,44,0,Primeira_Liga,2022_2023
Tiago Santos,POR,DF,Estoril,20,2002,26.9,75,50,43,28,4,45,61,73.8,16,26,5,21,16,91,45,0,Primeira_Liga,2022_2023
Zaidu Sanusi,NGA,DF,Porto,25,1997,11.7,15,7,8,5,2,11,21,52.4,10,13,4,9,11,26,20,0,Primeira_Liga,2022_2023
Adewele Sapara,NGA,"FW,MF",Portimonense,27,1995,1.3,5,4,4,1,0,2,2,100.0,0,0,0,0,3,8,2,0,Primeira_Liga,2022_2023
Andrés Sarmiento,COL,"FW,MF",Vizela,24,1998,0.4,2,1,0,2,0,2,3,66.7,1,1,0,1,1,3,0,0,Primeira_Liga,2022_2023
Sidy Sarr,SEN,MF,Chaves,26,1996,1.3,7,5,6,1,0,1,3,33.3,2,5,0,5,2,9,3,0,Primeira_Liga,2022_2023
Vincent Sasso,FRA,DF,Boavista,31,1991,21.9,32,22,24,7,1,14,21,66.7,7,16,10,6,27,59,93,0,Primeira_Liga,2022_2023
Savio,BRA,DF,Rio Ave,27,1995,3.6,6,3,5,0,1,6,7,85.7,1,7,2,5,3,9,7,0,Primeira_Liga,2022_2023
Andreas Schjelderup,NOR,FW,Benfica,18,2004,0.0,0,0,0,0,0,0,0,,0,0,0,0,0,0,0,0,Primeira_Liga,2022_2023
Alexander Schmidt,AUT,FW,Vizela,24,1998,3.6,2,2,0,2,0,2,2,100.0,0,4,0,4,2,4,5,0,Primeira_Liga,2022_2023
Moustapha Seck,SEN,"DF,FW",Portimonense,26,1996,24.9,52,35,24,19,9,31,51,60.8,20,26,8,18,31,83,40,2,Primeira_Liga,2022_2023
Alfa Semedo,GNB,MF,Vitória,24,1997,0.3,1,1,1,0,0,1,2,50.0,1,0,0,0,0,1,1,0,Primeira_Liga,2022_2023
Nuno Sequeira,POR,DF,Braga,31,1990,22.9,48,28,25,15,8,32,68,47.1,36,23,3,20,35,83,37,0,Primeira_Liga,2022_2023
Serginho,nan,"FW,MF",Estoril,21,2001,1.5,5,3,2,3,0,1,3,33.3,2,2,0,2,0,5,1,0,Primeira_Liga,2022_2023
Paulo Sérgio Mota,POR,"DF,MF",Marítimo,31,1991,8.0,8,6,6,0,2,5,8,62.5,3,5,2,3,8,16,16,0,Primeira_Liga,2022_2023
André Silva,BRA,"FW,MF",Vitória,25,1997,19.4,14,9,4,8,2,3,11,27.3,8,16,2,14,13,27,20,0,Primeira_Liga,2022_2023
António Silva,POR,DF,Benfica,18,2003,29.9,57,30,36,20,1,38,55,69.1,17,23,13,10,38,95,89,2,Primeira_Liga,2022_2023
Guilherme Silva,BRA,"DF,MF",Chaves,21,2000,0.2,0,0,0,0,0,0,0,,0,0,0,0,0,0,1,0,Primeira_Liga,2022_2023
João Miguel Macedo Silva,POR,GK,Marítimo,27,1995,8.0,0,0,0,0,0,0,0,,0,1,0,1,1,1,6,0,Primeira_Liga,2022_2023
Joel silva,POR,MF,Boavista,19,2003,1.1,1,0,1,0,0,0,1,0.0,1,0,0,0,1,2,2,0,Primeira_Liga,2022_2023
Jorge Fernando Santos Silva,POR,"DF,MF",Paços,26,1996,5.2,14,10,11,0,3,9,18,50.0,9,4,2,2,4,18,18,0,Primeira_Liga,2022_2023
Jota Silva,POR,"FW,MF",Vitória,22,1999,17.8,40,23,14,17,9,16,42,38.1,26,29,2,27,9,49,13,0,Primeira_Liga,2022_2023
Lucas Silva,BRA,FW,Paços,24,1998,0.2,0,0,0,0,0,0,1,0.0,1,1,1,0,0,0,0,0,Primeira_Liga,2022_2023
Pedro Manuel da Silva Moreira,POR,MF,Arouca,33,1989,0.8,1,1,0,1,0,1,2,50.0,1,0,0,0,1,2,1,0,Primeira_Liga,2022_2023
Pedro José Moreira Silva,POR,GK,Estoril,25,1997,2.3,0,0,0,0,0,0,0,,0,0,0,0,0,0,1,0,Primeira_Liga,2022_2023
Rafa Silva,POR,"MF,FW",Benfica,29,1993,24.2,16,9,1,8,7,7,21,33.3,14,17,0,17,2,18,1,0,Primeira_Liga,2022_2023
Tiago Silva,POR,MF,Vitória,29,1993,23.3,47,30,21,18,8,23,47,48.9,24,20,5,15,27,74,12,0,Primeira_Liga,2022_2023
David Simão,POR,MF,Arouca,32,1990,28.7,55,31,28,21,6,29,64,45.3,35,35,15,20,29,84,26,0,Primeira_Liga,2022_2023
André Simões,POR,MF,Famalicão,32,1989,1.9,8,5,2,4,2,4,6,66.7,2,1,0,1,5,13,3,0,Primeira_Liga,2022_2023
André Simões,POR,"MF,FW",Gil Vicente FC,18,2003,0.2,0,0,0,0,0,0,1,0.0,1,0,0,0,0,0,0,0,Primeira_Liga,2022_2023
Luther Singh,RSA,"FW,MF",Chaves,24,1997,7.0,14,11,6,7,1,7,9,77.8,2,5,0,5,8,22,7,0,Primeira_Liga,2022_2023
Lucas Soares,BRA,"MF,DF",Casa Pia,24,1998,24.2,40,24,20,17,3,21,48,43.8,27,19,0,19,21,61,40,1,Primeira_Liga,2022_2023
Samuel Soares,POR,GK,Benfica,20,2002,0.0,0,0,0,0,0,0,0,,0,0,0,0,0,0,0,0,Primeira_Liga,2022_2023
Val Soares,BRA,MF,Marítimo,25,1997,13.5,38,23,18,18,2,23,52,44.2,29,9,2,7,13,51,8,0,Primeira_Liga,2022_2023
Yuki Soma,JPN,"FW,MF",Casa Pia,25,1997,13.5,21,16,6,13,2,13,27,48.1,14,15,2,13,6,27,4,0,Primeira_Liga,2022_2023
Joel Soñora,USA,MF,Marítimo,25,1996,2.0,1,0,0,1,0,0,1,0.0,1,2,0,2,2,3,1,0,Primeira_Liga,2022_2023
Ismaila Soro,CIV,MF,Arouca,24,1998,16.9,39,21,25,10,4,17,46,37.0,29,19,6,13,37,76,27,0,Primeira_Liga,2022_2023
Miguel Sousa,POR,MF,Marítimo,23,1998,2.0,1,1,0,1,0,0,1,0.0,1,1,0,1,2,3,0,1,Primeira_Liga,2022_2023
Vasco Sousa,POR,MF,Porto,19,2003,0.0,0,0,0,0,0,0,1,0.0,1,0,0,0,0,0,0,0,Primeira_Liga,2022_2023
Claudemir de Souza,BRA,MF,Vizela,34,1988,15.1,27,15,12,12,3,22,38,57.9,16,25,11,14,18,45,30,0,Primeira_Liga,2022_2023
Jerry St. Juste,NED,DF,Sporting CP,25,1996,10.1,15,8,6,7,2,7,11,63.6,4,8,3,5,14,29,22,1,Primeira_Liga,2022_2023
Filip Stevanovic,SRB,"FW,MF",Santa Clara,19,2002,1.7,4,3,0,3,1,3,5,60.0,2,1,0,1,0,4,0,0,Primeira_Liga,2022_2023
Habib sylla,CIV,DF,Chaves,23,1999,6.9,7,6,3,3,1,4,9,44.4,5,13,6,7,6,13,19,0,Primeira_Liga,2022_2023
Morlaye Sylla,GUI,"FW,MF",Arouca,24,1998,25.3,44,28,15,22,7,24,53,45.3,29,31,4,27,27,71,18,1,Primeira_Liga,2022_2023
Kyosuke Tagawa,JPN,FW,Santa Clara,23,1999,13.2,10,6,3,6,1,2,11,18.2,9,2,0,2,4,14,8,0,Primeira_Liga,2022_2023
Afonso Taira,POR,MF,Casa Pia,30,1992,23.3,94,55,40,51,3,39,80,48.8,41,44,5,39,35,129,29,0,Primeira_Liga,2022_2023
Mateo Tanlongo,ARG,MF,Sporting CP,18,2003,1.6,4,1,3,0,1,1,5,20.0,4,1,0,1,0,4,1,0,Primeira_Liga,2022_2023
Mehdi Taremi,IRN,FW,Porto,30,1992,29.0,22,14,6,8,8,9,30,30.0,21,19,1,18,8,30,20,0,Primeira_Liga,2022_2023
David Tavares,CPV,"MF,FW",Famalicão,23,1999,0.5,0,0,0,0,0,0,1,0.0,1,2,0,2,1,1,1,0,Primeira_Liga,2022_2023
Heriberto Tavares,POR,"MF,FW",Famalicão,25,1997,2.4,3,2,0,1,2,1,5,20.0,4,2,0,2,4,7,4,0,Primeira_Liga,2022_2023
Martim Tavares,POR,"FW,MF",Boavista,18,2003,4.0,2,2,1,0,1,0,3,0.0,3,1,0,1,5,7,5,0,Primeira_Liga,2022_2023
Duplexe Tchamba,CMR,DF,Casa Pia,24,1998,4.3,7,3,5,1,1,4,8,50.0,4,5,3,2,5,12,19,0,Primeira_Liga,2022_2023
João Teixeira,POR,MF,Chaves,28,1994,30.4,68,41,28,30,10,31,87,35.6,56,37,6,31,24,92,21,1,Primeira_Liga,2022_2023
André Teles,POR,MF,Marítimo,25,1997,0.7,2,2,1,1,0,2,3,66.7,1,0,0,0,0,2,0,0,Primeira_Liga,2022_2023
Casper Tengstedt,DEN,"FW,MF",Benfica,22,2000,0.3,0,0,0,0,0,0,0,,0,0,0,0,0,0,1,0,Primeira_Liga,2022_2023
Nigel Thomas,NED,"FW,MF",Paços,21,2001,22.5,16,8,7,6,3,6,25,24.0,19,18,1,17,17,33,16,0,Primeira_Liga,2022_2023
Pedro Tiba,POR,MF,Gil Vicente FC,33,1988,13.9,19,9,4,7,8,11,25,44.0,14,16,7,9,10,29,20,0,Primeira_Liga,2022_2023
Bastien Toma,SUI,MF,Paços,23,1999,4.8,6,3,0,3,3,2,8,25.0,6,4,0,4,2,8,0,0,Primeira_Liga,2022_2023
Vítor Tormena,BRA,DF,Braga,26,1996,26.1,24,18,14,8,2,17,27,63.0,10,42,21,21,31,55,109,1,Primeira_Liga,2022_2023
Mamadou Tounkara,MLI,DF,Vitória,20,2001,11.6,11,8,7,3,1,8,10,80.0,2,11,4,7,5,16,50,0,Primeira_Liga,2022_2023
Francisco Trincão,POR,"MF,FW",Sporting CP,22,1999,24.5,36,18,7,19,10,19,44,43.2,25,18,2,16,8,44,4,0,Primeira_Liga,2022_2023
Matouš Trmal,CZE,GK,Marítimo,23,1998,6.0,0,0,0,0,0,0,1,0.0,1,0,0,0,0,0,2,0,Primeira_Liga,2022_2023
Manuel Ugarte Ribeiro,URU,MF,Sporting CP,21,2001,26.1,121,69,37,61,23,66,123,53.7,57,43,7,36,57,178,17,0,Primeira_Liga,2022_2023
Zé Uilton,BRA,"FW,MF",Paços,30,1992,15.3,21,13,11,8,2,8,13,61.5,5,6,0,6,6,27,22,1,Primeira_Liga,2022_2023
Ukra,POR,"FW,MF",Rio Ave,34,1988,4.1,4,4,1,2,1,4,12,33.3,8,8,1,7,3,7,4,0,Primeira_Liga,2022_2023
Mateus Uribe,COL,MF,Porto,31,1991,27.3,73,46,35,33,5,35,71,49.3,36,34,4,30,51,124,42,1,Primeira_Liga,2022_2023
Rodrigo Valente,POR,"MF,FW",Santa Clara,21,2001,1.1,1,0,0,0,1,1,1,100.0,0,4,1,3,1,2,1,0,Primeira_Liga,2022_2023
João Valido,POR,GK,Arouca,22,2000,0.0,0,0,0,0,0,0,0,,0,0,0,0,0,0,0,0,Primeira_Liga,2022_2023
Bruno Varela,CPV,GK,Vitória,27,1994,27.0,0,0,0,0,0,0,0,,0,0,0,0,0,0,14,2,Primeira_Liga,2022_2023
Fernando Varela,CPV,DF,Casa Pia,34,1987,22.6,26,17,16,10,0,16,24,66.7,8,33,24,9,26,52,85,1,Primeira_Liga,2022_2023
Luciano Vega,ARG,"MF,FW",Marítimo,23,1999,2.1,7,5,3,3,1,3,9,33.3,6,3,1,2,1,8,5,0,Primeira_Liga,2022_2023
Danilo Veiga,POR,DF,Gil Vicente FC,19,2002,7.6,24,14,12,10,2,11,13,84.6,2,5,1,4,14,38,20,0,Primeira_Liga,2022_2023
Igor Vekič,SVN,GK,Paços,24,1998,9.1,0,0,0,0,0,0,1,0.0,1,0,0,0,0,0,8,1,Primeira_Liga,2022_2023
Bruno Ventura,POR,FW,Rio Ave,21,2001,1.1,1,1,0,1,0,0,1,0.0,1,1,0,1,0,1,0,0,Primeira_Liga,2022_2023
Lucas Veríssimo,BRA,DF,Benfica,27,1995,0.1,0,0,0,0,0,0,0,,0,0,0,0,0,0,0,0,Primeira_Liga,2022_2023
Gabriel Veron,BRA,"MF,FW",Porto,19,2002,4.5,14,10,5,5,4,4,7,57.1,3,5,0,5,2,16,4,0,Primeira_Liga,2022_2023
Jan Vertonghen,BEL,DF,Benfica,35,1987,0.0,0,0,0,0,0,0,0,,0,0,0,0,0,0,0,0,Primeira_Liga,2022_2023
André Vidigal,POR,"FW,MF",Marítimo,23,1998,28.6,36,22,13,10,13,16,27,59.3,11,19,1,18,13,49,6,0,Primeira_Liga,2022_2023
Gabriel Vieira,BRA,"FW,MF",Santa Clara,20,2002,24.4,37,26,21,13,3,14,38,36.8,24,9,2,7,16,53,11,0,Primeira_Liga,2022_2023
João Vigário,POR,DF,Paços,26,1995,0.2,0,0,0,0,0,0,0,,0,2,1,1,0,0,1,0,Primeira_Liga,2022_2023
Mikel Villanueva,VEN,DF,Vitória,29,1993,28.2,26,15,20,5,1,15,22,68.2,7,23,12,11,44,70,97,2,Primeira_Liga,2022_2023
Bernardo Vital,POR,DF,Estoril,21,2000,25.1,22,14,19,3,0,15,21,71.4,6,26,18,8,16,38,124,1,Primeira_Liga,2022_2023
Vitinha,POR,FW,Braga,22,2000,12.2,22,9,7,12,3,6,14,42.9,8,17,2,15,4,26,17,0,Primeira_Liga,2022_2023
Vitinho,BRA,"MF,FW",Arouca,22,2000,2.7,3,1,1,0,2,0,2,0.0,2,3,0,3,4,7,4,0,Primeira_Liga,2022_2023
Paulo Vitor,BRA,"MF,DF",Rio Ave,23,1999,12.3,22,15,18,4,0,14,25,56.0,11,20,2,18,14,36,21,0,Primeira_Liga,2022_2023
Steven Vitória,CAN,DF,Chaves,35,1987,29.4,20,10,15,4,1,14,19,73.7,5,53,43,10,31,51,116,1,Primeira_Liga,2022_2023
Odisseas Vlachodimos,GRE,GK,Benfica,28,1994,34.0,0,0,0,0,0,0,1,0.0,1,0,0,0,0,0,10,1,Primeira_Liga,2022_2023
Ilija Vukotić,MNE,MF,Boavista,23,1999,4.5,8,5,3,4,1,0,4,0.0,4,6,3,3,6,14,12,0,Primeira_Liga,2022_2023
Wagner,BRA,DF,Portimonense,23,1999,1.0,3,3,1,2,0,2,3,66.7,1,1,0,1,2,5,2,0,Primeira_Liga,2022_2023
Masaki Watai,JPN,"MF,FW",Boavista,23,1999,5.8,6,3,1,3,2,2,11,18.2,9,3,0,3,2,8,2,1,Primeira_Liga,2022_2023
Julian Weigl,GER,MF,Benfica,26,1995,0.6,2,2,1,1,0,0,0,,0,2,0,2,0,2,0,0,Primeira_Liga,2022_2023
Wendell,BRA,DF,Porto,29,1993,21.8,48,28,24,19,5,23,47,48.9,24,15,0,15,25,73,25,0,Primeira_Liga,2022_2023
Weverson,BRA,"DF,FW",Arouca,22,2000,0.8,0,0,0,0,0,0,0,,0,0,0,0,0,0,1,0,Primeira_Liga,2022_2023
Willyan,BRA,"DF,MF",Portimonense,27,1995,4.0,7,4,6,1,0,5,8,62.5,3,4,3,1,8,15,16,0,Primeira_Liga,2022_2023
Bruno Wilson,POR,DF,Vizela,25,1996,22.8,21,11,12,8,1,11,15,73.3,4,37,30,7,42,63,124,1,Primeira_Liga,2022_2023
Roan Wilson,CRC,MF,Gil Vicente FC,20,2002,1.3,5,2,4,1,0,4,7,57.1,3,3,0,3,1,6,0,0,Primeira_Liga,2022_2023
Cláudio Winck,BRA,"DF,MF",Marítimo,28,1994,26.9,62,39,34,20,8,36,61,59.0,25,34,8,26,28,90,36,0,Primeira_Liga,2022_2023
Xadas,POR,"MF,FW",Marítimo,24,1997,26.3,28,16,10,15,3,14,46,30.4,32,37,8,29,13,41,17,0,Primeira_Liga,2022_2023
Abdul-Aziz Yakubu,GHA,FW,Rio Ave,23,1998,14.2,4,3,1,2,1,1,3,33.3,2,6,1,5,4,8,17,0,Primeira_Liga,2022_2023
Roman Yaremchuk,UKR,FW,Benfica,26,1995,0.6,0,0,0,0,0,0,0,,0,0,0,0,0,0,0,0,Primeira_Liga,2022_2023
Moses Yaw,GHA,MF,Arouca,23,1999,3.5,6,4,2,4,0,4,12,33.3,8,3,1,2,7,13,9,0,Primeira_Liga,2022_2023
Zaydou Youssouf,FRA,MF,Famalicão,23,1999,23.8,79,50,37,35,7,33,65,50.8,32,26,3,23,33,112,29,1,Primeira_Liga,2022_2023
Antonio Zarzana,ESP,"MF,FW",Marítimo,20,2002,3.2,5,4,2,2,1,4,7,57.1,3,1,0,1,3,8,0,0,Primeira_Liga,2022_2023
Ivan Zlobin,RUS,GK,Famalicão,25,1997,1.0,0,0,0,0,0,0,0,,0,0,0,0,0,0,0,0,Primeira_Liga,2022_2023
Kévin Zohi,MLI,"FW,MF",Vizela,25,1996,10.0,18,7,6,8,4,8,15,53.3,7,11,0,11,5,23,8,0,Primeira_Liga,2022_2023
Nermin Zolotić,BIH,DF,Casa Pia,29,1993,24.3,31,21,17,14,0,22,43,51.2,21,39,18,21,37,68,90,2,Primeira_Liga,2022_2023
Emilijus Zubas,LTU,GK,Arouca,32,1990,3.0,0,0,0,0,0,0,0,,0,0,0,0,0,0,3,0,Primeira_Liga,2022_2023
Nabil Aberdin,FRA,DF,Getafe,20,2002,2.0,0,0,0,0,0,0,1,0.0,1,0,0,0,0,0,4,0,La_Liga,2023_2024
Abner,BRA,DF,Betis,23,2000,15.6,25,19,15,9,1,17,34,50.0,17,23,5,18,15,40,62,0,La_Liga,2023_2024
Abdel Abqar,MAR,DF,Alavés,24,1999,25.7,35,19,28,5,2,21,35,60.0,14,31,26,5,23,58,115,0,La_Liga,2023_2024
Marcos Acuña,ARG,DF,Sevilla,31,1991,14.4,33,21,20,12,1,9,14,64.3,5,12,2,10,4,37,25,0,La_Liga,2023_2024
Julen Agirrezabala,ESP,GK,Athletic Club,22,2000,2.6,0,0,0,0,0,0,0,,0,0,0,0,0,0,0,0,La_Liga,2023_2024
Lucien Agoume,FRA,MF,Sevilla,21,2002,8.6,23,18,7,14,2,9,12,75.0,3,6,1,5,7,30,8,0,La_Liga,2023_2024
Joseph Aidoo,GHA,DF,Celta Vigo,27,1995,4.5,8,3,6,2,0,4,8,50.0,4,3,1,2,4,12,28,0,La_Liga,2023_2024
Ilias Akhomach,MAR,"MF,FW",Villarreal,19,2004,16.8,36,21,11,16,9,10,20,50.0,10,10,2,8,13,49,13,0,La_Liga,2023_2024
Sergio Akieme,ESP,DF,Almería,25,1997,18.6,27,15,18,7,2,13,16,81.3,3,14,4,10,10,37,34,0,La_Liga,2023_2024
Paul Akouokou,CIV,MF,Betis,25,1997,0.3,5,3,0,2,3,3,3,100.0,0,3,1,2,1,6,1,0,La_Liga,2023_2024
David Alaba,AUT,DF,Real Madrid,31,1992,12.8,13,9,7,5,1,4,8,50.0,4,10,7,3,15,28,34,0,La_Liga,2023_2024
Raúl Albiol,ESP,DF,Villarreal,37,1985,22.6,25,14,15,9,1,18,27,66.7,9,31,24,7,16,41,102,0,La_Liga,2023_2024
Rubén Alcaraz,ESP,MF,Cádiz,32,1991,34.8,97,59,39,52,6,50,121,41.3,71,60,14,46,33,130,55,2,La_Liga,2023_2024
Omar Alderete,PAR,DF,Getafe,26,1996,24.4,28,21,15,13,0,19,35,54.3,16,30,18,12,13,41,111,0,La_Liga,2023_2024
Iván Alejo,ESP,MF,Cádiz,28,1995,18.8,40,23,23,11,6,17,57,29.8,40,20,0,20,7,47,17,0,La_Liga,2023_2024
Carles Aleñá,ESP,MF,Getafe,25,1998,11.3,24,8,7,14,3,10,24,41.7,14,14,3,11,4,28,13,0,La_Liga,2023_2024
Mohamed Ali Cho,FRA,"FW,MF",Real Sociedad,19,2004,2.8,4,3,3,1,0,2,7,28.6,5,6,0,6,1,5,1,0,La_Liga,2023_2024
Tadeo Allende,ARG,"MF,FW",Celta Vigo,24,1999,3.7,6,1,3,2,1,4,6,66.7,2,3,0,3,3,9,3,0,La_Liga,2023_2024
Domingos André Ribeiro Almeida,POR,"FW,MF",Valencia,23,2000,10.7,25,15,9,12,4,9,19,47.4,10,13,1,12,6,31,5,0,La_Liga,2023_2024
Marcos Alonso,ESP,DF,Barcelona,32,1990,2.8,5,3,2,3,0,3,4,75.0,1,2,0,2,4,9,6,0,La_Liga,2023_2024
Adrià Altimira,ESP,"DF,MF",Villarreal,22,2001,8.6,16,7,9,6,1,9,24,37.5,15,18,5,13,5,21,18,0,La_Liga,2023_2024
Sergi Altimira,ESP,MF,Betis,21,2001,6.3,15,8,8,6,1,11,23,47.8,12,12,1,11,9,24,10,0,La_Liga,2023_2024
Gastón Álvarez,URU,DF,Getafe,23,2000,28.2,68,37,43,20,5,37,57,64.9,20,40,11,29,35,103,80,0,La_Liga,2023_2024
Hugo Álvarez,ESP,"MF,DF",Celta Vigo,20,2003,8.5,14,9,8,3,3,9,20,45.0,11,4,1,3,5,19,9,0,La_Liga,2023_2024
Yeray Álvarez,ESP,DF,Athletic Club,28,1995,12.8,18,9,15,3,0,12,19,63.2,7,8,5,3,11,29,34,1,La_Liga,2023_2024
Selim Amallah,MAR,"FW,MF",Valencia,26,1996,6.7,17,12,7,7,3,3,9,33.3,6,13,0,13,11,28,6,0,La_Liga,2023_2024
Amath,SEN,"FW,MF",Mallorca,27,1996,4.4,9,6,7,2,0,2,10,20.0,8,2,0,2,3,12,6,0,La_Liga,2023_2024
Miguel Ángel Rubio,ESP,DF,Granada,25,1998,17.3,20,12,14,6,0,14,21,66.7,7,31,18,13,28,48,74,2,La_Liga,2023_2024
Fabrizio Angileri,ARG,"DF,MF",Getafe,29,1994,1.8,1,1,1,0,0,1,3,33.3,2,0,0,0,4,5,8,0,La_Liga,2023_2024
Mauro Arambarri,URU,MF,Getafe,27,1995,3.8,6,2,3,2,1,1,6,16.7,5,1,0,1,2,8,7,0,La_Liga,2023_2024
Jon Aramburu,VEN,DF,Real Sociedad,21,2002,6.0,24,15,12,10,2,15,25,60.0,10,8,3,5,7,31,17,0,La_Liga,2023_2024
Julian Araujo,MEX,DF,Las Palmas,21,2001,16.2,41,22,29,7,5,23,33,69.7,10,23,16,7,10,51,52,1,La_Liga,2023_2024
Ronald Araújo,URU,DF,Barcelona,24,1999,22.2,27,22,11,15,1,12,17,70.6,5,20,11,9,12,39,66,2,La_Liga,2023_2024
Adu Ares,ESP,FW,Athletic Club,21,2001,2.9,8,4,4,2,2,2,3,66.7,1,1,0,1,1,9,0,0,La_Liga,2023_2024
Jesús Areso,ESP,DF,Osasuna,24,1999,29.6,45,24,25,13,7,31,38,81.6,7,36,15,21,18,63,58,0,La_Liga,2023_2024
Matias Arezo,URU,FW,Granada,20,2002,4.1,7,3,2,5,0,1,5,20.0,4,4,1,3,1,8,4,0,La_Liga,2023_2024
Iñigo Arguibide,ESP,DF,Osasuna,18,2005,0.2,1,0,0,1,0,0,0,,0,0,0,0,0,1,1,0,La_Liga,2023_2024
José Arnaiz,ESP,"FW,MF",Osasuna,28,1995,10.3,14,8,6,4,4,6,21,28.6,15,11,2,9,3,17,2,0,La_Liga,2023_2024
Sergio Arribas,ESP,"MF,FW",Almería,21,2001,22.7,34,17,16,17,1,14,31,45.2,17,20,1,19,16,50,8,1,La_Liga,2023_2024
Kepa Arrizabalaga,ESP,GK,Real Madrid,28,1994,13.3,0,0,0,0,0,0,1,0.0,1,0,0,0,0,0,4,0,La_Liga,2023_2024
Iago Aspas,ESP,FW,Celta Vigo,35,1987,30.1,11,6,4,6,1,1,15,6.7,14,23,3,20,10,21,8,0,La_Liga,2023_2024
Ezequiel Ávila,ARG,"FW,MF",Osasuna,29,1994,9.6,3,2,1,1,1,3,11,27.3,8,14,0,14,4,7,8,0,La_Liga,2023_2024
Ezequiel Ávila,ARG,FW,Betis,29,1994,3.3,2,1,0,2,0,1,3,33.3,2,2,0,2,1,3,4,0,La_Liga,2023_2024
César Azpilicueta,ESP,DF,Atlético Madrid,33,1989,15.8,25,14,15,9,1,12,19,63.2,7,25,6,19,16,41,46,0,La_Liga,2023_2024
Iddrisu Baba,GHA,MF,Almería,27,1996,15.9,46,26,27,18,1,17,39,43.6,22,20,6,14,11,57,27,2,La_Liga,2023_2024
Srđan Babić,SRB,DF,Almería,27,1996,1.0,2,2,0,2,0,1,1,100.0,0,1,1,0,0,2,2,0,La_Liga,2023_2024
Loïc Bade,FRA,DF,Sevilla,23,2000,25.3,65,41,53,12,0,30,49,61.2,19,23,15,8,38,103,116,2,La_Liga,2023_2024
Alex Baena,ESP,"MF,FW",Villarreal,22,2001,28.7,34,21,10,16,8,20,47,42.6,27,23,2,21,13,47,17,1,La_Liga,2023_2024
Eric Bailly,CIV,DF,Villarreal,29,1994,9.3,5,3,4,1,0,2,2,100.0,0,8,8,0,9,14,38,2,La_Liga,2023_2024
Cédric Bakambu,COD,FW,Betis,32,1991,2.2,1,0,0,1,0,0,0,,0,2,0,2,0,1,0,0,La_Liga,2023_2024
Alejandro Balde,ESP,DF,Barcelona,19,2003,15.3,20,11,11,6,3,7,11,63.6,4,14,1,13,5,25,21,1,La_Liga,2023_2024
Iván Balliu,ALB,DF,Rayo Vallecano,31,1992,31.9,44,31,20,24,0,22,39,56.4,17,27,11,16,29,73,66,1,La_Liga,2023_2024
Jonathan Bamba,CIV,"MF,FW",Celta Vigo,27,1996,22.0,14,9,4,8,2,2,17,11.8,15,20,0,20,18,32,12,0,La_Liga,2023_2024
Léo Baptistão,BRA,FW,Almería,30,1992,20.4,25,16,12,8,5,9,25,36.0,16,13,1,12,11,36,22,0,La_Liga,2023_2024
Kike Barja,ESP,"FW,MF",Osasuna,26,1997,3.4,6,2,2,2,2,3,8,37.5,5,2,1,1,2,8,2,0,La_Liga,2023_2024
Ander Barrenetxea,ESP,"FW,MF",Real Sociedad,21,2001,15.9,32,21,7,16,9,10,26,38.5,16,18,1,17,6,38,5,0,La_Liga,2023_2024
Pablo Barrios,ESP,MF,Atlético Madrid,20,2003,17.3,45,25,15,29,1,19,40,47.5,21,20,3,17,28,73,24,2,La_Liga,2023_2024
Marc Bartra,ESP,DF,Betis,32,1991,2.5,4,3,3,1,0,4,5,80.0,1,3,1,2,3,7,10,0,La_Liga,2023_2024
Augusto Batalla,ARG,GK,Granada,27,1996,17.0,0,0,0,0,0,0,1,0.0,1,0,0,0,0,0,10,2,La_Liga,2023_2024
Bebé,CPV,"MF,FW",Rayo Vallecano,33,1990,2.4,2,2,1,1,0,1,5,20.0,4,1,0,1,0,2,0,0,La_Liga,2023_2024
Sheraldo Becker,SUR,"FW,MF",Real Sociedad,28,1995,8.6,2,2,0,2,0,0,1,0.0,1,3,0,3,1,3,0,0,La_Liga,2023_2024
Héctor Bellerín,ESP,DF,Betis,28,1995,19.0,34,22,14,16,4,20,53,37.7,33,13,5,8,22,56,40,1,La_Liga,2023_2024
Jude Bellingham,ENG,MF,Real Madrid,20,2003,25.7,42,34,14,18,10,12,36,33.3,24,55,5,50,21,63,17,0,La_Liga,2023_2024
Fran Beltrán,ESP,MF,Celta Vigo,24,1999,27.0,56,32,22,23,11,24,63,38.1,39,28,2,26,18,74,34,0,La_Liga,2023_2024
Carlos Benavídez,URU,MF,Alavés,25,1998,12.6,56,35,19,26,11,19,34,55.9,15,13,5,8,19,75,31,0,La_Liga,2023_2024
Yuri Berchiche,ESP,DF,Athletic Club,33,1990,21.4,33,25,13,14,6,19,33,57.6,14,28,9,19,20,53,62,0,La_Liga,2023_2024
Álex Berenguer,ESP,FW,Athletic Club,28,1995,17.7,23,14,9,9,5,7,24,29.2,17,23,0,23,5,28,13,0,La_Liga,2023_2024
Antonio Blanco,ESP,MF,Alavés,23,2000,27.0,61,36,29,27,5,31,86,36.0,55,25,2,23,35,96,30,0,La_Liga,2023_2024
Daley Blind,NED,DF,Girona,33,1990,33.0,47,21,33,13,1,29,47,61.7,18,37,19,18,21,68,113,0,La_Liga,2023_2024
Adri Bosch,ESP,DF,Granada,22,2001,0.3,1,1,1,0,0,0,0,,0,0,0,0,0,1,1,0,La_Liga,2023_2024
Yassine Bounou,MAR,GK,Sevilla,32,1991,1.0,0,0,0,0,0,0,0,,0,0,0,0,0,0,0,0,La_Liga,2023_2024
Lucas Boyé,ARG,FW,Granada,27,1996,28.2,50,25,14,25,11,14,34,41.2,20,35,5,30,10,60,46,0,La_Liga,2023_2024
Darko Brašanac,SRB,MF,Osasuna,31,1992,0.5,1,0,1,0,0,1,1,100.0,0,1,0,1,0,1,0,0,La_Liga,2023_2024
Brau,ESP,DF,Granada,21,2001,0.3,1,0,1,0,0,1,1,100.0,0,0,0,0,0,1,2,0,La_Liga,2023_2024
Claudio Bravo,CHI,GK,Betis,40,1983,7.0,0,0,0,0,0,0,1,0.0,1,0,0,0,0,0,2,0,La_Liga,2023_2024
Ben Brereton,CHI,"FW,MF",Villarreal,24,1999,3.0,2,2,1,0,1,0,2,0.0,2,0,0,0,0,2,0,0,La_Liga,2023_2024
Ante Budimir,CRO,FW,Osasuna,32,1991,27.1,21,15,2,11,8,5,14,35.7,9,19,5,14,5,26,18,0,La_Liga,2023_2024
Manu Bueno,ESP,MF,Sevilla,19,2004,1.3,4,2,4,0,0,3,3,100.0,0,3,0,3,0,4,1,0,La_Liga,2023_2024
Pablo Busto,ESP,DF,Betis,17,2005,0.5,1,1,0,0,1,1,1,100.0,0,0,0,0,1,2,3,0,La_Liga,2023_2024
José Callejón,ESP,"MF,FW",Granada,36,1987,8.9,13,6,10,3,0,8,22,36.4,14,7,1,6,5,18,10,0,La_Liga,2023_2024
Eduardo Camavinga,FRA,"MF,DF",Real Madrid,20,2002,20.2,76,47,39,29,8,23,39,59.0,16,36,8,28,29,105,29,1,La_Liga,2023_2024
Sergio Camello,ESP,FW,Rayo Vallecano,22,2001,18.5,16,5,3,10,3,6,15,40.0,9,10,2,8,3,19,15,0,La_Liga,2023_2024
José Campaña,ESP,MF,Las Palmas,30,1993,1.9,2,2,1,1,0,0,2,0.0,2,3,2,1,2,4,3,0,La_Liga,2023_2024
João Cancelo,POR,DF,Barcelona,29,1994,27.8,64,44,35,21,8,38,58,65.5,20,35,6,29,29,93,59,1,La_Liga,2023_2024
Sergi Canós,ESP,"MF,FW",Valencia,26,1997,13.7,23,13,7,11,5,10,24,41.7,14,14,2,12,11,34,9,0,La_Liga,2023_2024
Étienne Capoue,FRA,MF,Villarreal,35,1988,16.2,32,18,17,12,3,15,22,68.2,7,20,4,16,22,54,24,1,La_Liga,2023_2024
Isaac Carcelen,ESP,DF,Cádiz,30,1993,29.0,50,31,30,15,5,25,45,55.6,20,24,7,17,27,77,87,2,La_Liga,2023_2024
Cárdenas,ESP,GK,Rayo Vallecano,26,1997,1.0,0,0,0,0,0,0,0,,0,0,0,0,0,0,1,0,La_Liga,2023_2024
Marc Cardona,ESP,FW,Las Palmas,28,1995,8.2,9,8,3,4,2,1,12,8.3,11,5,0,5,2,11,7,0,La_Liga,2023_2024
Sergi Cardona,ESP,DF,Las Palmas,24,1999,31.3,90,55,52,29,9,55,96,57.3,41,45,7,38,46,136,102,0,La_Liga,2023_2024
Johnny Cardoso,USA,MF,Betis,21,2001,14.8,48,29,19,24,5,22,33,66.7,11,20,5,15,32,80,31,0,La_Liga,2023_2024
Carmona,ESP,"DF,MF",Getafe,21,2002,14.6,30,21,13,14,3,9,28,32.1,19,15,2,13,21,51,25,0,La_Liga,2023_2024
Yannick Carrasco,BEL,DF,Atlético Madrid,29,1993,2.5,4,4,3,1,0,2,7,28.6,5,2,0,2,1,5,6,0,La_Liga,2023_2024
Álvaro Carreras,ESP,"MF,FW",Granada,20,2003,5.3,13,8,8,4,1,5,11,45.5,6,5,1,4,7,20,9,1,La_Liga,2023_2024
Dani Carvajal,ESP,DF,Real Madrid,31,1992,24.1,47,32,28,15,4,23,42,54.8,19,28,9,19,22,69,54,4,La_Liga,2023_2024
William Carvalho,POR,MF,Betis,31,1992,7.6,20,12,11,7,2,10,16,62.5,6,8,1,7,8,28,9,1,La_Liga,2023_2024
Marc Casado,ESP,MF,Barcelona,19,2003,0.2,1,1,1,0,0,1,1,100.0,0,0,0,0,1,2,2,0,La_Liga,2023_2024
Catena,ESP,DF,Osasuna,28,1994,28.2,33,18,26,6,1,19,35,54.3,16,24,15,9,15,48,119,3,La_Liga,2023_2024
Dani Ceballos,ESP,"MF,FW",Real Madrid,26,1996,6.6,10,5,4,5,1,5,14,35.7,9,9,2,7,0,10,4,1,La_Liga,2023_2024
Álex Centelles,ESP,DF,Almería,25,1997,10.9,11,6,9,2,0,8,18,44.4,10,5,2,3,18,29,29,0,La_Liga,2023_2024
Franco Cervi,ARG,"MF,DF",Celta Vigo,29,1994,6.1,24,18,13,9,2,13,24,54.2,11,16,0,16,9,33,4,0,La_Liga,2023_2024
Pep Chavarría,ESP,"DF,MF",Rayo Vallecano,25,1998,13.0,23,18,15,6,2,11,17,64.7,6,15,3,12,6,29,29,1,La_Liga,2023_2024
Andreas Christensen,DEN,"DF,MF",Barcelona,27,1996,22.0,23,14,7,14,2,16,28,57.1,12,23,10,13,21,44,41,0,La_Liga,2023_2024
Chumi,ESP,DF,Almería,24,1999,27.0,34,22,22,12,0,16,26,61.5,10,38,23,15,14,48,107,3,La_Liga,2023_2024
Víctor Chust,ESP,DF,Cádiz,23,2000,20.7,29,18,23,5,1,18,32,56.3,14,27,21,6,11,40,92,1,La_Liga,2023_2024
Pathé Ciss,SEN,MF,Rayo Vallecano,29,1994,18.5,44,24,16,26,2,16,29,55.2,13,27,10,17,30,74,54,0,La_Liga,2023_2024
Silvi Clúa,ESP,MF,Girona,18,2005,0.0,2,0,2,0,0,2,2,100.0,0,1,0,1,0,2,0,0,La_Liga,2023_2024
Saúl Coco,EQG,DF,Las Palmas,24,1999,25.5,32,19,25,7,0,11,18,61.1,7,27,15,12,20,52,120,3,La_Liga,2023_2024
Santi Comesaña,ESP,MF,Villarreal,26,1996,18.4,44,26,15,21,8,19,38,50.0,19,33,9,24,22,66,27,1,La_Liga,2023_2024
Copete,ESP,DF,Mallorca,23,1999,14.8,45,27,27,17,1,30,43,69.8,13,12,6,6,32,77,47,1,La_Liga,2023_2024
Francis Coquelin,FRA,MF,Villarreal,32,1991,10.1,20,12,8,10,2,5,13,38.5,8,14,4,10,16,36,15,0,La_Liga,2023_2024
Theo Corbeanu,CAN,"MF,FW",Granada,21,2002,2.0,5,2,2,3,0,1,3,33.3,2,3,0,3,3,8,2,0,La_Liga,2023_2024
Jesús Corona,MEX,"MF,DF",Sevilla,30,1993,0.2,0,0,0,0,0,0,0,,0,0,0,0,1,1,0,0,La_Liga,2023_2024
Ángel Correa,ARG,"FW,MF",Atlético Madrid,28,1995,17.0,22,15,3,11,8,5,17,29.4,12,13,0,13,2,24,6,0,La_Liga,2023_2024
Thierry Correia,POR,DF,Valencia,24,1999,23.9,63,35,39,20,4,28,49,57.1,21,39,16,23,33,96,61,0,La_Liga,2023_2024
Jaume Costa,ESP,DF,Mallorca,35,1988,18.7,38,22,23,10,5,18,29,62.1,11,14,4,10,16,54,35,0,La_Liga,2023_2024
Samu Costa,POR,MF,Mallorca,22,2000,25.6,91,50,40,46,5,46,93,49.5,47,28,14,14,39,130,59,3,La_Liga,2023_2024
Thibaut Courtois,BEL,GK,Real Madrid,31,1992,3.7,1,0,1,0,0,0,0,,0,0,0,0,0,1,0,0,La_Liga,2023_2024
Yan Couto,BRA,"DF,FW",Girona,21,2002,24.9,45,34,25,14,6,20,40,50.0,20,14,2,12,10,55,31,1,La_Liga,2023_2024
Crespo,POR,MF,Rayo Vallecano,26,1996,5.9,16,9,8,6,2,9,17,52.9,8,15,6,9,10,26,7,0,La_Liga,2023_2024
Cristian,ESP,GK,Valencia,25,1998,0.6,0,0,0,0,0,0,0,,0,0,0,0,0,0,0,0,La_Liga,2023_2024
Juan Cruz Armada,ESP,DF,Osasuna,31,1992,18.5,27,15,16,10,1,17,25,68.0,8,14,7,7,12,39,39,1,La_Liga,2023_2024
Juan Cruz,ESP,FW,Betis,23,2000,0.8,0,0,0,0,0,0,1,0.0,1,0,0,0,0,0,0,0,La_Liga,2023_2024
Pau Cubarsí,ESP,DF,Barcelona,16,2007,17.3,22,14,18,3,1,13,18,72.2,5,20,16,4,12,34,65,0,La_Liga,2023_2024
Iván Cuéllar,ESP,GK,Mallorca,39,1984,1.0,0,0,0,0,0,0,0,,0,0,0,0,0,0,0,0,La_Liga,2023_2024
Jorge Cuenca,ESP,DF,Villarreal,23,1999,21.8,42,29,26,10,6,19,30,63.3,11,26,15,11,21,63,114,0,La_Liga,2023_2024
Eric Curbelo,ESP,"DF,MF",Las Palmas,29,1994,1.1,4,3,2,2,0,3,4,75.0,1,3,1,2,2,6,5,1,La_Liga,2023_2024
Alberto Dadie,ESP,MF,Real Sociedad,21,2002,0.3,2,1,2,0,0,0,0,,0,1,0,1,0,2,0,0,La_Liga,2023_2024
Sergi Darder,ESP,MF,Mallorca,29,1993,24.0,39,26,13,21,5,12,31,38.7,19,20,4,16,16,55,16,0,La_Liga,2023_2024
Rodrigo De Paul,ARG,MF,Atlético Madrid,29,1994,23.1,31,21,11,14,6,15,38,39.5,23,28,1,27,11,42,15,2,La_Liga,2023_2024
Mouctar Diakhaby,GUI,"DF,MF",Valencia,26,1996,11.9,18,11,9,9,0,11,13,84.6,2,17,7,10,11,29,62,0,La_Liga,2023_2024
Moussa Diakité,MLI,MF,Cádiz,19,2003,0.0,0,0,0,0,0,0,0,,0,0,0,0,0,0,0,0,La_Liga,2023_2024
Assane Diao,ESP,FW,Betis,17,2005,11.6,20,12,5,9,6,6,17,35.3,11,22,4,18,7,27,7,0,La_Liga,2023_2024
Brahim Díaz,MAR,"FW,MF",Real Madrid,23,1999,17.2,29,19,4,16,9,6,13,46.2,7,16,1,15,5,34,2,0,La_Liga,2023_2024
Víctor Díaz,ESP,"DF,MF",Granada,35,1988,1.8,5,3,2,3,0,1,3,33.3,2,1,0,1,1,6,8,0,La_Liga,2023_2024
Famara Diedhiou,SEN,"FW,MF",Granada,30,1992,1.0,1,1,0,1,0,0,1,0.0,1,0,0,0,0,1,2,0,La_Liga,2023_2024
Stole Dimitrievski,MKD,GK,Rayo Vallecano,29,1993,37.0,1,1,1,0,0,1,1,100.0,0,0,0,0,0,1,17,3,La_Liga,2023_2024
Djené,TOG,"DF,MF",Getafe,31,1991,27.6,34,19,18,13,3,15,26,57.7,11,31,15,16,23,57,70,0,La_Liga,2023_2024
Marko Dmitrović,SRB,GK,Sevilla,31,1992,13.0,1,1,1,0,0,1,2,50.0,1,0,0,0,1,2,5,0,La_Liga,2023_2024
Jaume Doménech,ESP,GK,Valencia,32,1990,0.9,0,0,0,0,0,0,0,,0,0,0,0,0,0,0,0,La_Liga,2023_2024
Carlos Dominguez,ESP,DF,Celta Vigo,22,2001,17.6,33,21,17,9,7,23,37,62.2,14,24,12,12,22,55,78,0,La_Liga,2023_2024
Mario Dominguez,ESP,FW,Valencia,19,2004,0.3,0,0,0,0,0,0,0,,0,0,0,0,0,0,0,0,La_Liga,2023_2024
Carlos Dotor,ESP,MF,Celta Vigo,22,2001,7.9,14,7,3,8,3,4,13,30.8,9,12,2,10,4,18,4,0,La_Liga,2023_2024
Anastasios Douvikas,GRE,FW,Celta Vigo,23,1999,10.1,15,7,2,6,7,3,8,37.5,5,6,3,3,2,17,9,0,La_Liga,2023_2024
Artem Dovbyk,UKR,FW,Girona,26,1997,28.7,4,3,2,1,1,0,2,0.0,2,8,1,7,0,4,17,0,La_Liga,2023_2024
Domingos Duarte,POR,DF,Getafe,28,1995,10.1,7,4,6,0,1,5,7,71.4,2,7,5,2,8,15,27,0,La_Liga,2023_2024
Rubén Duarte,ESP,DF,Alavés,27,1995,20.9,39,20,21,16,2,21,31,67.7,10,21,6,15,23,62,69,0,La_Liga,2023_2024
Hugo Duro,ESP,FW,Valencia,23,1999,33.1,16,8,5,8,3,9,29,31.0,20,24,5,19,5,21,27,0,La_Liga,2023_2024
Aritz Elustondo,ESP,DF,Real Sociedad,29,1994,9.0,11,7,5,4,2,6,14,42.9,8,12,10,2,7,18,26,0,La_Liga,2023_2024
Adri Embarba,ESP,"FW,MF",Almería,31,1992,27.5,55,37,29,15,11,26,53,49.1,27,37,1,36,15,70,12,0,La_Liga,2023_2024
Youssef En-Nesyri,MAR,FW,Sevilla,26,1997,28.6,10,7,3,4,3,0,10,0.0,10,9,1,8,7,17,29,1,La_Liga,2023_2024
Gonzalo Escalante,ARG,MF,Cádiz,30,1993,18.9,39,24,16,14,9,20,55,36.4,35,23,5,18,26,65,33,2,La_Liga,2023_2024
Aarón Escandell,ESP,GK,Las Palmas,27,1995,1.7,0,0,0,0,0,0,0,,0,0,0,0,0,0,1,1,La_Liga,2023_2024
Alfonso Espino,URU,DF,Rayo Vallecano,31,1992,27.9,67,45,43,22,2,30,82,36.6,52,26,4,22,40,107,63,0,La_Liga,2023_2024
Bernardo Espinosa,COL,DF,Girona,34,1989,0.0,1,1,1,0,0,1,1,100.0,0,0,0,0,0,1,2,0,La_Liga,2023_2024
Karl Etta,CMR,FW,Cádiz,19,2003,0.2,1,1,0,1,0,0,0,,0,0,0,0,0,1,0,0,La_Liga,2023_2024
Abde Ezzalzouli,MAR,"FW,MF",Barcelona,21,2001,0.8,1,1,0,0,1,0,1,0.0,1,1,0,1,0,1,0,0,La_Liga,2023_2024
Abde Ezzalzouli,MAR,FW,Betis,21,2001,9.6,17,14,7,5,5,4,14,28.6,10,10,0,10,5,22,5,0,La_Liga,2023_2024
Radamel Falcao,COL,"FW,DF",Rayo Vallecano,37,1986,4.5,7,5,1,5,1,1,3,33.3,2,2,0,2,3,10,4,0,La_Liga,2023_2024
Fali,ESP,DF,Cádiz,29,1993,28.3,41,26,29,11,1,21,36,58.3,15,38,24,14,27,68,120,0,La_Liga,2023_2024
Ansu Fati,ESP,"MF,FW",Barcelona,20,2002,0.6,0,0,0,0,0,0,1,0.0,1,0,0,0,0,0,0,0,La_Liga,2023_2024
Peter Federico,DOM,"MF,FW",Valencia,21,2002,7.2,5,3,3,1,1,1,10,10.0,9,11,0,11,7,12,10,0,La_Liga,2023_2024
Nabil Fekir,FRA,"MF,FW",Betis,30,1993,11.7,15,10,5,7,3,5,10,50.0,5,9,0,9,7,22,3,0,La_Liga,2023_2024
Luiz Felipe,ITA,DF,Betis,26,1997,4.0,7,3,5,2,0,4,5,80.0,1,10,4,6,4,11,16,0,La_Liga,2023_2024
João Félix,POR,FW,Barcelona,23,1999,17.1,22,16,9,7,6,8,22,36.4,14,14,1,13,10,32,11,0,La_Liga,2023_2024
Kiko Femenía,ESP,DF,Villarreal,32,1991,17.6,35,25,19,13,3,19,34,55.9,15,21,6,15,31,66,45,0,La_Liga,2023_2024
Aitor Fernández,ESP,GK,Osasuna,32,1991,6.1,0,0,0,0,0,0,1,0.0,1,0,0,0,0,0,5,1,La_Liga,2023_2024
Álex Fernández,ESP,MF,Cádiz,30,1992,14.3,19,9,10,9,0,11,22,50.0,11,17,5,12,15,34,30,0,La_Liga,2023_2024
Carlos Fernández,ESP,FW,Real Sociedad,27,1996,4.5,11,7,3,6,2,0,2,0.0,2,4,0,4,0,11,5,0,La_Liga,2023_2024
Raúl Fernández,ESP,GK,Granada,35,1988,3.1,0,0,0,0,0,0,1,0.0,1,0,0,0,0,0,1,2,La_Liga,2023_2024
Valery Fernández,ESP,"MF,FW",Girona,23,1999,5.6,11,9,4,7,0,6,8,75.0,2,6,1,5,1,12,4,0,La_Liga,2023_2024
Fernando,ESP,GK,Almería,33,1990,4.0,0,0,0,0,0,0,0,,0,1,0,1,0,0,2,0,La_Liga,2023_2024
Fernando,BRA,MF,Sevilla,36,1987,5.1,9,8,2,4,3,5,9,55.6,4,2,0,2,7,16,9,0,La_Liga,2023_2024
André Ferreira,POR,GK,Granada,27,1996,14.9,0,0,0,0,0,0,1,0.0,1,0,0,0,0,0,9,2,La_Liga,2023_2024
Rachad Fettal,MAR,FW,Almería,18,2005,0.2,1,1,1,0,0,0,0,,0,0,0,0,0,1,0,0,La_Liga,2023_2024
Pablo Fornals,ESP,"FW,MF",Betis,27,1996,12.8,24,16,8,11,5,12,22,54.5,10,14,0,14,22,46,10,2,La_Liga,2023_2024
Héctor Fort,ESP,DF,Barcelona,16,2006,3.5,6,5,5,1,0,4,10,40.0,6,0,0,0,2,8,4,0,La_Liga,2023_2024
Dimitri Foulquier,FRA,"DF,MF",Valencia,30,1993,20.5,39,22,22,13,4,18,26,69.2,8,10,1,9,16,55,49,1,La_Liga,2023_2024
Juan Foyth,ARG,DF,Villarreal,25,1998,11.8,26,15,18,8,0,12,27,44.4,15,17,4,13,12,38,44,0,La_Liga,2023_2024
Jorge de Frutos,ESP,"FW,MF",Rayo Vallecano,26,1997,17.2,19,8,5,8,6,7,22,31.8,15,12,0,12,7,26,18,0,La_Liga,2023_2024
Daniel Fuzato,BRA,GK,Getafe,26,1997,0.1,0,0,0,0,0,0,0,,0,0,0,0,0,0,1,0,La_Liga,2023_2024
Matteo Gabbia,ITA,DF,Villarreal,23,1999,5.3,10,6,4,6,0,5,8,62.5,3,5,2,3,8,18,36,1,La_Liga,2023_2024
Javi Galán,ESP,DF,Atlético Madrid,28,1994,1.0,5,4,2,2,1,4,5,80.0,1,1,0,1,1,6,3,0,La_Liga,2023_2024
Javi Galán,ESP,DF,Real Sociedad,28,1994,11.9,38,22,15,19,4,15,30,50.0,15,24,1,23,14,52,17,1,La_Liga,2023_2024
Iñigo Ruiz de Galarreta,ESP,MF,Athletic Club,29,1993,23.2,49,31,15,26,8,24,49,49.0,25,18,5,13,12,61,17,0,La_Liga,2023_2024
Aleix García,ESP,MF,Girona,26,1997,35.5,49,28,17,26,6,28,54,51.9,26,45,17,28,36,85,53,3,La_Liga,2023_2024
Álvaro García,ESP,"FW,MF",Rayo Vallecano,30,1992,27.5,34,25,15,10,9,7,34,20.6,27,35,0,35,36,70,33,0,La_Liga,2023_2024
Dani García,ESP,MF,Athletic Club,33,1990,8.3,17,11,4,7,6,12,24,50.0,12,9,3,6,8,25,11,0,La_Liga,2023_2024
David García,ESP,DF,Osasuna,29,1994,25.9,29,18,19,9,1,16,26,61.5,10,40,19,21,18,47,115,2,La_Liga,2023_2024
Eric García,ESP,DF,Barcelona,22,2001,0.6,0,0,0,0,0,0,0,,0,1,1,0,0,0,0,0,La_Liga,2023_2024
Eric García,ESP,DF,Girona,22,2001,29.3,55,37,34,18,3,34,49,69.4,15,36,18,18,30,85,79,2,La_Liga,2023_2024
Fran Garcia,ESP,DF,Real Madrid,23,1999,15.5,25,17,11,12,2,13,31,41.9,18,16,3,13,19,44,28,1,La_Liga,2023_2024
Gonzalo García,ESP,"FW,MF",Real Madrid,19,2004,0.2,0,0,0,0,0,0,1,0.0,1,1,1,0,0,0,1,0,La_Liga,2023_2024
Jastin García,ESP,FW,Girona,19,2004,0.4,1,0,0,0,1,0,0,,0,0,0,0,0,1,1,0,La_Liga,2023_2024
Raúl García,ESP,"FW,MF",Athletic Club,37,1986,4.7,9,6,2,4,3,4,9,44.4,5,10,1,9,3,12,9,0,La_Liga,2023_2024
Rubén García,ESP,"FW,MF",Osasuna,30,1993,17.2,32,18,8,17,7,13,33,39.4,20,23,3,20,12,44,23,0,La_Liga,2023_2024
Santiago García,ESP,FW,Getafe,21,2001,0.3,1,0,0,0,1,1,1,100.0,0,0,0,0,0,1,0,0,La_Liga,2023_2024
Unai García,ESP,DF,Osasuna,31,1992,6.2,12,9,9,2,1,5,10,50.0,5,7,1,6,8,20,18,0,La_Liga,2023_2024
Yarek Gasiorowski,ESP,DF,Valencia,18,2005,8.2,22,12,14,5,3,13,19,68.4,6,15,8,7,15,37,50,1,La_Liga,2023_2024
Federico Gattoni,ARG,"DF,FW",Sevilla,24,1999,0.1,1,0,1,0,0,1,1,100.0,0,0,0,0,0,1,1,0,La_Liga,2023_2024
Gavi,ESP,"MF,FW",Barcelona,18,2004,10.5,39,21,20,14,5,18,36,50.0,18,19,3,16,8,47,16,1,La_Liga,2023_2024
Paulo Gazzaniga,ARG,GK,Girona,31,1992,38.0,2,2,2,0,0,2,4,50.0,2,0,0,0,0,2,12,1,La_Liga,2023_2024
David Gil,ESP,GK,Cádiz,29,1994,4.1,0,0,0,0,0,0,1,0.0,1,0,0,0,0,0,3,0,La_Liga,2023_2024
Maxi Gómez,URU,FW,Cádiz,26,1996,12.9,6,4,2,3,1,3,5,60.0,2,8,3,5,3,9,3,0,La_Liga,2023_2024
Moi Gómez,ESP,"MF,FW",Osasuna,29,1994,22.3,30,19,7,19,4,9,24,37.5,15,15,1,14,11,41,22,0,La_Liga,2023_2024
Unai Gómez,ESP,MF,Athletic Club,20,2003,9.7,12,10,2,6,4,5,10,50.0,5,13,2,11,2,14,9,0,La_Liga,2023_2024
Édgar González,ESP,"DF,MF",Almería,26,1997,28.0,45,21,22,20,3,25,49,51.0,24,48,28,20,38,83,130,3,La_Liga,2023_2024
Fabio González,ESP,MF,Las Palmas,26,1997,1.4,2,2,2,0,0,1,2,50.0,1,2,0,2,0,2,0,0,La_Liga,2023_2024
Giovanni González,URU,DF,Mallorca,28,1994,27.4,73,45,37,32,4,40,81,49.4,41,24,3,21,31,104,60,2,La_Liga,2023_2024
Hugo González,ESP,"MF,FW",Valencia,20,2003,1.0,2,1,0,2,0,0,0,,0,0,0,0,0,2,0,0,La_Liga,2023_2024
Iñaki González,ESP,MF,Las Palmas,19,2004,0.1,1,0,1,0,0,0,0,,0,0,0,0,0,1,1,0,La_Liga,2023_2024
Urko González,ESP,MF,Real Sociedad,22,2001,1.7,4,1,0,3,1,2,2,100.0,0,1,0,1,1,5,6,0,La_Liga,2023_2024
Andoni Gorosabel,ESP,DF,Alavés,26,1996,31.7,62,42,40,17,5,38,75,50.7,37,24,8,16,28,90,69,0,La_Liga,2023_2024
Pablo Gozalbez,ESP,"MF,FW",Valencia,22,2001,1.1,1,0,0,0,1,1,6,16.7,5,0,0,0,1,2,2,0,La_Liga,2023_2024
Mason Greenwood,ENG,"MF,FW",Getafe,21,2001,29.6,11,6,3,5,3,4,21,19.0,17,9,0,9,4,15,4,0,La_Liga,2023_2024
Dominik Greif,SVK,GK,Mallorca,26,1997,1.0,0,0,0,0,0,0,0,,0,0,0,0,0,0,0,0,La_Liga,2023_2024
Antoine Griezmann,FRA,"FW,MF",Atlético Madrid,32,1991,29.4,33,19,14,14,5,15,41,36.6,26,34,3,31,10,43,23,1,La_Liga,2023_2024
Vicente Guaita,ESP,GK,Celta Vigo,36,1987,26.7,1,1,1,0,0,1,2,50.0,1,0,0,0,0,1,9,1,La_Liga,2023_2024
Andrés Guardado,MEX,MF,Betis,36,1986,5.0,17,12,5,9,3,7,14,50.0,7,4,2,2,6,23,5,0,La_Liga,2023_2024
Sergi Guardiola,ESP,"FW,MF",Cádiz,32,1991,5.5,10,7,2,6,2,4,9,44.4,5,10,0,10,0,10,4,0,La_Liga,2023_2024
Nemanja Gudelj,SRB,"DF,MF",Sevilla,31,1991,19.4,31,24,18,10,3,17,31,54.8,14,17,9,8,27,58,56,0,La_Liga,2023_2024
Gonçalo Guedes,POR,"FW,MF",Villarreal,26,1996,10.6,6,4,1,2,3,2,7,28.6,5,8,0,8,2,8,3,0,La_Liga,2023_2024
Javier Guerra,ESP,MF,Valencia,20,2003,27.8,54,24,25,22,7,22,58,37.9,36,27,7,20,18,72,44,0,La_Liga,2023_2024
Ander Guevara,ESP,MF,Alavés,26,1997,32.6,59,32,28,25,6,31,64,48.4,33,34,12,22,13,72,46,1,La_Liga,2023_2024
Hugo Guillamón,ESP,MF,Valencia,23,2000,14.6,24,15,7,14,3,11,17,64.7,6,8,3,5,12,36,25,2,La_Liga,2023_2024
Marc Guiu,ESP,"FW,MF",Barcelona,17,2006,0.8,1,0,0,1,0,0,0,,0,0,0,0,0,1,0,0,La_Liga,2023_2024
Arda Güler,TUR,"FW,MF",Real Madrid,18,2005,4.2,6,4,1,3,2,5,8,62.5,3,0,0,0,2,8,5,0,La_Liga,2023_2024
Gerard Gumbau,ESP,MF,Granada,28,1994,29.7,55,34,21,30,4,23,62,37.1,39,24,5,19,25,80,30,2,La_Liga,2023_2024
İlkay Gündoğan,GER,MF,Barcelona,32,1990,33.3,32,22,14,16,2,12,39,30.8,27,19,4,15,21,53,18,1,La_Liga,2023_2024
Jon Guridi,ESP,MF,Alavés,28,1995,29.8,42,24,10,27,5,12,45,26.7,33,23,3,20,22,64,22,0,La_Liga,2023_2024
Gorka Guruzeta,ESP,FW,Athletic Club,26,1996,24.6,34,23,6,25,3,9,30,30.0,21,36,2,34,17,51,23,0,La_Liga,2023_2024
Miguel Gutiérrez,ESP,DF,Girona,22,2001,33.7,29,18,11,14,4,13,35,37.1,22,27,11,16,22,51,66,2,La_Liga,2023_2024
Munir El Haddadi,MAR,FW,Las Palmas,27,1995,27.2,40,27,18,17,5,17,38,44.7,21,27,1,26,11,51,16,0,La_Liga,2023_2024
Ianis Hagi,ROU,"MF,FW",Alavés,24,1998,8.9,17,12,2,14,1,5,12,41.7,7,8,0,8,5,22,4,0,La_Liga,2023_2024
Luiz Henrique,BRA,FW,Betis,22,2001,6.8,15,11,4,10,1,9,14,64.3,5,11,0,11,5,20,8,0,La_Liga,2023_2024
Mario Hermoso,ESP,DF,Atlético Madrid,28,1995,28.4,46,25,29,13,4,28,51,54.9,23,27,9,18,30,76,93,0,La_Liga,2023_2024
Javi Hernández ,ESP,DF,Cádiz,25,1998,27.9,43,24,26,12,5,25,46,54.3,21,34,9,25,19,62,72,1,La_Liga,2023_2024
Aridane Hernández,ESP,DF,Rayo Vallecano,34,1989,18.8,10,8,5,4,1,4,11,36.4,7,19,14,5,14,24,98,1,La_Liga,2023_2024
Luis Hernández,ESP,DF,Cádiz,34,1989,8.0,7,3,4,3,0,4,8,50.0,4,3,2,1,8,15,25,0,La_Liga,2023_2024
Jorge Herrando,ESP,DF,Osasuna,22,2001,18.3,29,19,23,6,0,12,19,63.2,7,20,11,9,15,44,69,1,La_Liga,2023_2024
Ander Herrera,ESP,MF,Athletic Club,33,1989,11.4,44,32,11,26,7,20,36,55.6,16,16,6,10,15,59,18,1,La_Liga,2023_2024
Cristian Herrera,ESP,"FW,MF",Las Palmas,32,1991,1.8,1,1,0,1,0,1,2,50.0,1,1,0,1,0,1,2,0,La_Liga,2023_2024
Sergio Herrera,ESP,GK,Osasuna,30,1993,31.9,2,2,2,0,0,2,3,66.7,1,0,0,0,0,2,22,3,La_Liga,2023_2024
Yangel Herrera,VEN,MF,Girona,25,1998,23.4,64,37,28,30,6,30,56,53.6,26,30,8,22,24,88,45,1,La_Liga,2023_2024
Juan Herzog,ESP,DF,Las Palmas,20,2003,3.2,6,5,5,1,0,3,6,50.0,3,4,1,3,2,8,17,0,La_Liga,2023_2024
Martin Hongla,CMR,"MF,DF",Granada,25,1998,6.2,7,3,2,5,0,3,9,33.3,6,6,3,3,6,13,13,1,La_Liga,2023_2024
Xabier Huarte Armendáriz,ESP,MF,Osasuna,22,2001,0.1,0,0,0,0,0,0,0,,0,0,0,0,0,0,0,0,La_Liga,2023_2024
Pablo Ibáñez,ESP,MF,Osasuna,24,1998,12.8,18,9,5,7,6,5,21,23.8,16,26,3,23,9,27,17,0,La_Liga,2023_2024
Iglesias,ESP,"DF,FW",Getafe,25,1998,15.7,41,22,25,11,5,21,33,63.6,12,18,7,11,16,57,53,0,La_Liga,2023_2024
Borja Iglesias,ESP,FW,Betis,30,1993,4.5,0,0,0,0,0,0,3,0.0,3,0,0,0,2,2,2,0,La_Liga,2023_2024
Imanol,ESP,DF,Athletic Club,23,2000,5.8,7,5,1,5,1,5,18,27.8,13,6,0,6,7,14,15,0,La_Liga,2023_2024
Isco,ESP,MF,Betis,31,1992,25.8,41,27,15,21,5,14,38,36.8,24,19,1,18,10,51,7,0,La_Liga,2023_2024
Diego Iturralde,ESP,DF,Sevilla,20,2003,0.4,0,0,0,0,0,0,0,,0,1,1,0,0,0,2,0,La_Liga,2023_2024
Adnan Januzaj,BEL,"FW,MF",Sevilla,28,1995,2.1,3,3,2,0,1,0,1,0.0,1,2,0,2,1,4,0,0,La_Liga,2023_2024
Mikel Jauregizar,ESP,MF,Athletic Club,19,2003,1.7,0,0,0,0,0,0,6,0.0,6,5,0,5,0,0,2,0,La_Liga,2023_2024
Luis Javier Suárez,COL,FW,Almería,25,1997,10.2,7,5,2,5,0,2,6,33.3,4,11,0,11,0,7,13,0,La_Liga,2023_2024
Salim El Jebari,MAR,MF,Atlético Madrid,19,2004,0.1,1,0,0,1,0,0,0,,0,0,0,0,0,1,1,0,La_Liga,2023_2024
Frenkie de Jong,NED,MF,Barcelona,26,1997,18.2,43,26,14,23,6,8,19,42.1,11,18,8,10,14,57,28,1,La_Liga,2023_2024
Joan Jordán,ESP,MF,Sevilla,29,1994,4.2,8,7,3,3,2,7,15,46.7,8,4,2,2,4,12,2,0,La_Liga,2023_2024
Jordi,ESP,"MF,DF",Getafe,22,2001,6.4,16,11,3,11,2,7,15,46.7,8,7,2,5,8,24,7,0,La_Liga,2023_2024
Jeremy Jorge,ESP,FW,Getafe,20,2003,0.0,0,0,0,0,0,0,0,,0,0,0,0,0,0,0,0,La_Liga,2023_2024
Willian José,BRA,FW,Betis,31,1991,21.9,7,3,1,2,4,2,5,40.0,3,8,2,6,2,9,15,0,La_Liga,2023_2024
Joselu,ESP,FW,Real Madrid,33,1990,18.7,6,3,1,4,1,0,7,0.0,7,11,1,10,6,12,11,0,La_Liga,2023_2024
Kamil Jóźwiak,POL,MF,Granada,25,1998,6.3,13,10,4,6,3,9,17,52.9,8,4,0,4,2,15,6,0,La_Liga,2023_2024
Juanmi,ESP,FW,Cádiz,30,1993,9.7,9,4,2,7,0,2,9,22.2,7,6,0,6,6,15,3,0,La_Liga,2023_2024
Juanpe,ESP,DF,Girona,32,1991,8.3,11,8,8,3,0,9,10,90.0,1,17,11,6,7,18,50,1,La_Liga,2023_2024
Vinicius Júnior,BRA,FW,Real Madrid,23,2000,20.7,18,13,5,5,8,3,12,25.0,9,13,0,13,1,19,3,2,La_Liga,2023_2024
Filip Jørgensen,DEN,GK,Villarreal,21,2002,36.0,3,1,3,0,0,3,4,75.0,1,0,0,0,2,5,10,3,La_Liga,2023_2024
Sory Kaba,GUI,FW,Las Palmas,28,1995,8.0,2,0,0,2,0,0,5,0.0,5,6,0,6,0,2,9,0,La_Liga,2023_2024
Kaiky,BRA,DF,Almería,19,2004,5.8,7,4,6,0,1,3,6,50.0,3,9,7,2,3,10,29,1,La_Liga,2023_2024
Jon Karrikaburu,ESP,"MF,FW",Alavés,20,2002,0.2,0,0,0,0,0,0,0,,0,0,0,0,0,0,0,0,La_Liga,2023_2024
Ibrahima Kebe,MLI,MF,Girona,22,2000,0.1,1,1,0,1,0,0,0,,0,1,0,1,1,2,0,0,La_Liga,2023_2024
Kiké,ESP,"FW,MF",Alavés,33,1989,15.8,8,4,2,3,3,4,9,44.4,5,16,5,11,1,9,12,0,La_Liga,2023_2024
Koke,ESP,MF,Atlético Madrid,31,1992,27.7,66,44,27,32,7,36,79,45.6,43,37,12,25,16,82,34,1,La_Liga,2023_2024
Ibrahima Koné,MLI,FW,Almería,24,1999,3.1,1,0,1,0,0,1,1,100.0,0,1,0,1,0,1,4,0,La_Liga,2023_2024
Rominigue Kouamé,MLI,MF,Cádiz,26,1996,9.1,14,9,6,7,1,7,15,46.7,8,10,2,8,13,27,10,1,La_Liga,2023_2024
Jules Koundé,FRA,DF,Barcelona,24,1998,32.2,37,23,22,10,5,28,51,54.9,23,32,12,20,25,62,83,5,La_Liga,2023_2024
Toni Kroos,GER,MF,Real Madrid,33,1990,23.6,53,34,19,25,9,24,59,40.7,35,22,4,18,17,70,11,1,La_Liga,2023_2024
Takefusa Kubo,JPN,"FW,MF",Real Sociedad,22,2001,23.9,26,17,15,6,5,9,23,39.1,14,21,2,19,11,37,8,1,La_Liga,2023_2024
Luca de la Torre,USA,MF,Celta Vigo,25,1998,21.7,39,21,12,22,5,22,43,51.2,21,23,4,19,12,51,17,0,La_Liga,2023_2024
Yoel Lago,ESP,DF,Celta Vigo,19,2004,1.0,2,0,2,0,0,0,0,,0,1,0,1,0,2,2,0,La_Liga,2023_2024
Érik Lamela,ARG,"FW,MF",Sevilla,31,1992,5.1,21,14,4,10,7,10,15,66.7,5,12,0,12,1,22,5,0,La_Liga,2023_2024
Bruno Langa,MOZ,DF,Almería,25,1997,9.1,17,12,10,5,2,6,14,42.9,8,11,4,7,4,21,33,2,La_Liga,2023_2024
Cyle Larin,CAN,FW,Mallorca,28,1995,20.3,17,8,6,4,7,2,7,28.6,5,16,5,11,3,20,17,0,La_Liga,2023_2024
Juanmi Latasa,ESP,FW,Getafe,22,2001,17.3,9,7,0,6,3,1,11,9.1,10,9,0,9,4,13,21,0,La_Liga,2023_2024
Toni Lato,ESP,DF,Mallorca,25,1997,17.2,38,23,19,13,6,16,27,59.3,11,17,3,14,17,55,27,0,La_Liga,2023_2024
Lázaro,BRA,"FW,MF",Almería,21,2002,3.2,4,1,2,0,2,2,8,25.0,6,4,0,4,1,5,1,0,La_Liga,2023_2024
Robin Le Normand,ESP,DF,Real Sociedad,26,1996,27.4,31,22,16,15,0,17,30,56.7,13,26,15,11,28,59,96,1,La_Liga,2023_2024
Jeremías Ledesma,ARG,GK,Cádiz,30,1993,33.9,1,1,1,0,0,1,4,25.0,3,0,0,0,0,1,15,3,La_Liga,2023_2024
Florian Lejeune,FRA,DF,Rayo Vallecano,32,1991,37.0,39,25,26,11,2,19,30,63.3,11,33,18,15,23,62,155,1,La_Liga,2023_2024
Stefan Lekovic,SRB,DF,Villarreal,19,2004,0.3,0,0,0,0,0,0,0,,0,1,1,0,0,0,1,0,La_Liga,2023_2024
Iñigo Lekue,ESP,DF,Athletic Club,30,1993,22.2,40,22,25,10,5,27,53,50.9,26,24,6,18,15,55,50,0,La_Liga,2023_2024
Thomas Lemar,FRA,MF,Atlético Madrid,27,1995,1.8,3,1,2,1,0,1,2,50.0,1,0,0,0,0,3,0,0,La_Liga,2023_2024
Álvaro Lemos,ESP,DF,Las Palmas,30,1993,2.8,4,1,1,3,0,0,2,0.0,2,3,1,2,2,6,4,0,La_Liga,2023_2024
Ruben Lendinez,ESP,DF,Valencia,20,2003,0.1,2,2,0,2,0,1,1,100.0,0,0,0,0,0,2,1,0,La_Liga,2023_2024
Robert Lewandowski,POL,FW,Barcelona,34,1988,30.6,8,5,0,6,2,4,12,33.3,8,13,4,9,9,17,18,0,La_Liga,2023_2024
Samuel Lino,BRA,"DF,MF",Atlético Madrid,23,1999,23.1,61,34,32,17,12,35,70,50.0,35,37,1,36,14,75,27,0,La_Liga,2023_2024
Javier Llabrés,ESP,"MF,FW",Mallorca,20,2002,2.7,3,1,1,1,1,1,2,50.0,1,1,0,1,3,6,4,0,La_Liga,2023_2024
Marcos Llorente,ESP,"MF,DF",Atlético Madrid,28,1995,28.5,40,23,18,17,5,16,44,36.4,28,36,11,25,14,54,35,0,La_Liga,2023_2024
Enzo Loiodice,FRA,MF,Las Palmas,22,2000,19.9,62,35,15,34,13,20,42,47.6,22,20,2,18,12,74,16,1,La_Liga,2023_2024
David López,ESP,DF,Girona,33,1989,21.8,33,20,21,12,0,17,22,77.3,5,28,19,9,20,53,63,4,La_Liga,2023_2024
Diego López,ESP,"MF,FW",Valencia,21,2002,29.5,37,25,14,16,7,13,56,23.2,43,23,1,22,20,57,12,0,La_Liga,2023_2024
Fermin López,ESP,"MF,FW",Barcelona,20,2003,16.1,41,21,15,18,8,14,40,35.0,26,14,1,13,4,45,9,0,La_Liga,2023_2024
Javi López,ESP,DF,Alavés,21,2002,26.5,23,12,11,9,3,15,26,57.7,11,25,9,16,10,33,77,1,La_Liga,2023_2024
Unai López,ESP,MF,Rayo Vallecano,27,1995,23.4,48,24,18,23,7,21,53,39.6,32,24,3,21,16,64,15,2,La_Liga,2023_2024
Dion Lopy,SEN,MF,Almería,21,2002,21.3,62,37,36,20,6,17,44,38.6,27,23,5,18,15,77,22,2,La_Liga,2023_2024
Anthony Lozano,HON,"MF,FW",Getafe,30,1993,1.0,0,0,0,0,0,0,1,0.0,1,0,0,0,0,0,1,0,La_Liga,2023_2024
Anthony Lozano,HON,FW,Almería,30,1993,8.6,7,5,2,5,0,4,7,57.1,3,6,1,5,2,9,12,0,La_Liga,2023_2024
Lucas,BRA,DF,Cádiz,22,2001,17.1,47,27,32,11,4,32,55,58.2,23,27,4,23,17,64,45,0,La_Liga,2023_2024
José Luis Gayà,ESP,DF,Valencia,28,1995,19.9,71,36,44,23,4,43,67,64.2,24,18,3,15,11,82,42,0,La_Liga,2023_2024
José Luis Morales,ESP,"FW,MF",Villarreal,36,1987,11.6,5,3,1,4,0,3,13,23.1,10,9,1,8,7,12,4,0,La_Liga,2023_2024
Dodi Lukebakio,BEL,"FW,MF",Sevilla,25,1997,12.5,5,2,2,2,1,1,6,16.7,5,9,2,7,2,7,5,0,La_Liga,2023_2024
Andriy Lunin,UKR,GK,Real Madrid,24,1999,21.0,0,0,0,0,0,0,1,0.0,1,0,0,0,0,0,15,1,La_Liga,2023_2024
Darwin Machís,VEN,MF,Cádiz,30,1993,8.7,23,14,7,9,7,13,24,54.2,11,8,1,7,4,27,2,0,La_Liga,2023_2024
Pablo Maffeo,ESP,DF,Mallorca,26,1997,16.2,35,22,18,13,4,23,40,57.5,17,12,2,10,10,45,23,0,La_Liga,2023_2024
Jon Magunacelaya,ESP,"FW,MF",Real Sociedad,23,2000,1.3,5,3,2,3,0,4,8,50.0,4,3,0,3,0,5,2,0,La_Liga,2023_2024
Nemanja Maksimović,SRB,MF,Getafe,28,1995,36.3,65,43,26,31,8,23,41,56.1,18,56,23,33,46,111,61,0,La_Liga,2023_2024
Giorgi Mamardashvili,GEO,GK,Valencia,22,2000,36.5,4,3,4,0,0,4,4,100.0,0,1,0,1,2,6,22,2,La_Liga,2023_2024
Wilson Manafá,POR,"DF,MF",Granada,29,1994,2.7,6,4,3,2,1,4,7,57.1,3,1,0,1,1,7,4,1,La_Liga,2023_2024
Reinildo Mandava,MOZ,DF,Atlético Madrid,29,1994,8.1,30,22,16,11,3,19,22,86.4,3,10,2,8,15,45,21,0,La_Liga,2023_2024
Aïssa Mandi,ALG,DF,Villarreal,31,1991,12.4,13,8,8,5,0,7,14,50.0,7,10,7,3,8,21,41,0,La_Liga,2023_2024
Javier Manquillo,ESP,"DF,MF",Celta Vigo,29,1994,8.3,15,11,6,5,4,8,15,53.3,7,14,3,11,3,18,17,0,La_Liga,2023_2024
Faitout Maouassa,FRA,"DF,MF",Granada,25,1998,2.5,8,5,6,1,1,4,5,80.0,1,6,0,6,1,9,3,0,La_Liga,2023_2024
Marcão,BRA,DF,Sevilla,27,1996,3.9,9,6,5,4,0,6,10,60.0,4,8,6,2,4,13,11,1,La_Liga,2023_2024
Óscar de Marcos,ESP,DF,Athletic Club,34,1989,25.1,56,39,26,24,6,42,71,59.2,29,28,6,22,15,71,44,0,La_Liga,2023_2024
Alberto Marí,ESP,FW,Valencia,22,2001,3.1,4,2,0,1,3,1,1,100.0,0,3,0,3,0,4,5,0,La_Liga,2023_2024
José Mari,ESP,"MF,FW",Cádiz,35,1987,0.2,2,1,0,2,0,1,2,50.0,1,0,0,0,0,2,0,0,La_Liga,2023_2024
José María Giménez,URU,DF,Atlético Madrid,28,1995,14.7,18,10,10,7,1,5,16,31.3,11,16,12,4,10,28,95,0,La_Liga,2023_2024
Mariano,DOM,"FW,MF",Sevilla,29,1993,2.7,1,1,0,1,0,0,1,0.0,1,1,0,1,0,1,2,0,La_Liga,2023_2024
Rafa Marín ,ESP,DF,Alavés,21,2002,27.1,32,20,23,9,0,14,27,51.9,13,34,21,13,33,65,129,2,La_Liga,2023_2024
Diego Mariño,ESP,GK,Almería,33,1990,1.0,0,0,0,0,0,0,0,,0,0,0,0,0,0,1,0,La_Liga,2023_2024
Mika Màrmol,ESP,DF,Las Palmas,21,2002,35.3,70,42,44,24,2,35,53,66.0,18,39,19,20,44,114,147,2,La_Liga,2023_2024
Unai Marrero,ESP,GK,Real Sociedad,21,2001,1.6,0,0,0,0,0,0,0,,0,0,0,0,0,0,0,0,La_Liga,2023_2024
Roger Martí,ESP,FW,Cádiz,32,1991,15.1,12,6,1,9,2,2,7,28.6,5,16,1,15,7,19,4,0,La_Liga,2023_2024
Iván Martín,ESP,MF,Girona,24,1999,30.3,44,25,22,15,7,22,57,38.6,35,25,3,22,21,65,14,0,La_Liga,2023_2024
Jon Martin,ESP,DF,Real Sociedad,17,2006,0.3,0,0,0,0,0,0,0,,0,0,0,0,0,0,3,0,La_Liga,2023_2024
Mario Martín,ESP,MF,Real Madrid,19,2004,0.2,5,1,0,2,3,3,4,75.0,1,2,1,1,0,5,0,0,La_Liga,2023_2024
Arnau Martinez,ESP,DF,Girona,20,2003,13.8,25,16,17,6,2,15,32,46.9,17,15,5,10,10,35,41,3,La_Liga,2023_2024
Iñigo Martínez,ESP,DF,Barcelona,32,1991,14.4,10,7,9,1,0,6,8,75.0,2,13,10,3,11,21,50,0,La_Liga,2023_2024
Marc Martínez,ESP,GK,Granada,33,1990,3.0,0,0,0,0,0,0,1,0.0,1,0,0,0,0,0,1,0,La_Liga,2023_2024
Marvin,ESP,"FW,DF",Las Palmas,23,2000,20.6,39,25,18,17,4,18,36,50.0,18,28,2,26,14,53,18,1,La_Liga,2023_2024
Omar Mascarell,EQG,MF,Mallorca,30,1993,17.5,33,16,16,17,0,18,35,51.4,17,24,8,16,31,64,30,1,La_Liga,2023_2024
Jaime Mata,ESP,"FW,MF",Getafe,34,1988,19.9,24,15,12,8,4,11,26,42.3,15,18,1,17,17,41,31,0,La_Liga,2023_2024
Luís Maximiano,POR,GK,Almería,24,1999,33.0,0,0,0,0,0,0,1,0.0,1,0,0,0,0,0,19,2,La_Liga,2023_2024
Borja Mayoral,ESP,FW,Getafe,26,1997,23.9,9,5,2,2,5,5,22,22.7,17,7,0,7,4,13,16,0,La_Liga,2023_2024
Mamadou Mbaye,SEN,DF,Cádiz,25,1998,3.2,6,3,3,3,0,2,5,40.0,3,10,7,3,5,11,26,0,La_Liga,2023_2024
Hannibal Mejbri,TUN,MF,Sevilla,20,2003,1.2,3,3,1,2,0,0,1,0.0,1,1,0,1,0,3,0,0,La_Liga,2023_2024
Óscar Melendo,ESP,"MF,FW",Granada,25,1997,12.5,14,6,4,10,0,4,12,33.3,8,13,0,13,5,19,4,1,La_Liga,2023_2024
Gonzalo Melero,ESP,"MF,FW",Almería,29,1994,12.3,14,8,7,5,2,7,19,36.8,12,12,4,8,4,18,11,0,La_Liga,2023_2024
Memphis,NED,FW,Atlético Madrid,29,1994,9.9,5,2,0,3,2,3,6,50.0,3,2,0,2,1,6,0,0,La_Liga,2023_2024
Houboulang Mendes,GNB,DF,Almería,25,1998,4.4,16,13,11,5,0,8,16,50.0,8,4,2,2,1,17,17,1,La_Liga,2023_2024
Tomás Mendes,ESP,MF,Alavés,18,2004,0.1,0,0,0,0,0,0,0,,0,0,0,0,0,0,0,0,La_Liga,2023_2024
Brais Méndez,ESP,"MF,FW",Real Sociedad,26,1997,26.8,42,28,13,20,9,15,43,34.9,28,23,4,19,12,54,21,0,La_Liga,2023_2024
Bruno Méndez,URU,DF,Granada,23,1999,14.8,36,17,19,12,5,21,37,56.8,16,24,6,18,26,62,45,0,La_Liga,2023_2024
Diego Méndez,ESP,MF,Rayo Vallecano,19,2003,0.1,1,1,1,0,0,1,1,100.0,0,0,0,0,1,2,0,0,La_Liga,2023_2024
Ferland Mendy,FRA,DF,Real Madrid,28,1995,19.1,15,10,12,2,1,11,14,78.6,3,12,2,10,13,28,26,1,La_Liga,2023_2024
Jorge Meré,ESP,DF,Cádiz,26,1997,7.5,8,7,6,2,0,4,7,57.1,3,5,3,2,8,16,33,0,La_Liga,2023_2024
Mikel Merino,ESP,MF,Real Sociedad,27,1996,27.6,77,43,25,34,18,22,48,45.8,26,36,11,25,16,93,55,3,La_Liga,2023_2024
Omenuke Mfulu,COD,"MF,FW",Las Palmas,29,1994,0.9,4,3,3,1,0,0,1,0.0,1,1,1,0,2,6,5,0,La_Liga,2023_2024
Miguel,ESP,"FW,MF",Alavés,23,1999,0.7,0,0,0,0,0,0,0,,0,2,0,2,0,0,0,0,La_Liga,2023_2024
Éder Militão,BRA,DF,Real Madrid,25,1998,5.5,7,3,4,3,0,6,9,66.7,3,4,3,1,4,11,19,1,La_Liga,2023_2024
Luis Milla,ESP,MF,Getafe,28,1994,23.5,57,33,19,28,10,28,47,59.6,19,20,1,19,32,89,10,0,La_Liga,2023_2024
Marko Milovanović,SRB,"FW,MF",Almería,19,2003,3.4,4,4,1,3,0,2,4,50.0,2,2,0,2,0,4,5,0,La_Liga,2023_2024
Óscar Mingueza,ESP,"DF,MF",Celta Vigo,24,1999,33.3,62,38,44,11,7,37,80,46.3,43,38,7,31,17,79,49,2,La_Liga,2023_2024
Ignasi Miquel,ESP,DF,Granada,30,1992,33.2,47,30,39,6,2,23,40,57.5,17,32,16,16,45,92,132,4,La_Liga,2023_2024
Rafa Mir,ESP,"FW,MF",Sevilla,26,1997,4.3,2,2,1,1,0,1,2,50.0,1,2,0,2,1,3,1,0,La_Liga,2023_2024
Juan Miranda,ESP,DF,Betis,23,2000,20.6,38,24,21,13,4,17,31,54.8,14,31,6,25,19,57,62,0,La_Liga,2023_2024
Stefan Mitrović,SRB,DF,Getafe,33,1990,7.8,9,3,7,2,0,4,8,50.0,4,3,2,1,6,15,26,0,La_Liga,2023_2024
Luka Modrić,CRO,MF,Real Madrid,37,1985,18.8,22,15,10,6,6,9,25,36.0,16,13,4,9,21,43,9,0,La_Liga,2023_2024
Johan Mojica,COL,DF,Osasuna,30,1992,22.7,30,22,11,15,4,16,25,64.0,9,15,2,13,21,51,40,2,La_Liga,2023_2024
Alberto Moleiro,ESP,"FW,MF",Las Palmas,19,2003,20.0,15,6,4,7,4,6,30,20.0,24,11,0,11,7,22,10,0,La_Liga,2023_2024
Nahuel Molina,ARG,DF,Atlético Madrid,25,1998,20.6,38,22,16,18,4,26,54,48.1,28,19,3,16,9,47,36,1,La_Liga,2023_2024
Jon Moncayola,ESP,MF,Osasuna,25,1998,20.0,27,18,14,10,3,17,42,40.5,25,31,5,26,15,42,21,0,La_Liga,2023_2024
César Montes,MEX,DF,Almería,26,1997,19.9,22,13,13,9,0,9,18,50.0,9,21,9,12,11,33,94,0,La_Liga,2023_2024
Álvaro Morata,ESP,FW,Atlético Madrid,30,1992,21.2,16,10,4,7,5,3,5,60.0,2,18,3,15,1,17,26,0,La_Liga,2023_2024
Alberto Moreno,ESP,DF,Villarreal,31,1992,16.5,31,21,19,10,2,10,30,33.3,20,12,2,10,24,55,33,0,La_Liga,2023_2024
Gerard Moreno,ESP,FW,Villarreal,31,1992,24.6,25,12,10,7,8,11,25,44.0,14,24,7,17,9,34,24,0,La_Liga,2023_2024
Jorge Moreno,ESP,DF,Osasuna,22,2001,0.2,0,0,0,0,0,0,0,,0,1,0,1,0,0,3,0,La_Liga,2023_2024
Ilaix Moriba,GUI,"MF,FW",Getafe,20,2003,6.7,20,11,3,11,6,4,9,44.4,5,3,1,2,4,24,10,0,La_Liga,2023_2024
Manu Morlanes,ESP,MF,Mallorca,24,1999,17.9,50,29,23,26,1,23,53,43.4,30,13,1,12,20,70,21,0,La_Liga,2023_2024
Cristhian Mosquera,ESP,DF,Valencia,19,2004,34.2,57,34,36,18,3,25,39,64.1,14,42,23,19,36,93,137,2,La_Liga,2023_2024
Yerson Mosquera,COL,DF,Villarreal,22,2001,13.7,27,13,18,7,2,12,15,80.0,3,12,2,10,17,44,65,0,La_Liga,2023_2024
Abdul Mumin,GHA,DF,Rayo Vallecano,25,1998,18.8,19,10,13,4,2,8,10,80.0,2,27,19,8,22,41,82,1,La_Liga,2023_2024
Iker Muniain,ESP,"MF,FW",Athletic Club,30,1992,6.6,5,1,2,3,0,1,3,33.3,2,4,1,3,0,5,0,0,La_Liga,2023_2024
Aihen Muñoz,ESP,DF,Real Sociedad,25,1997,12.5,36,21,20,10,6,24,35,68.6,11,16,8,8,9,45,33,0,La_Liga,2023_2024
Iker Muñoz,ESP,MF,Osasuna,20,2002,20.6,32,18,13,17,2,15,31,48.4,16,16,5,11,11,43,50,0,La_Liga,2023_2024
Javier Muñoz,ESP,MF,Las Palmas,28,1995,29.3,42,23,14,22,6,16,44,36.4,28,40,4,36,20,62,29,1,La_Liga,2023_2024
Vedat Muriqi,KVX,FW,Mallorca,29,1994,25.9,11,6,4,3,4,2,14,14.3,12,11,4,7,6,17,26,0,La_Liga,2023_2024
Nacho,ESP,DF,Real Madrid,33,1990,19.4,18,10,9,7,2,6,13,46.2,7,23,13,10,18,36,56,0,La_Liga,2023_2024
Matija Nastasić,SRB,DF,Mallorca,30,1993,25.1,35,17,26,9,0,24,32,75.0,8,33,20,13,29,64,114,0,La_Liga,2023_2024
Roberto Navarro,ESP,"MF,FW",Cádiz,21,2002,21.0,46,29,20,21,5,22,43,51.2,21,33,0,33,19,65,7,1,La_Liga,2023_2024
Jesús Navas,ESP,DF,Sevilla,37,1985,22.3,37,27,21,14,2,22,40,55.0,18,15,7,8,22,59,48,0,La_Liga,2023_2024
Álvaro Negredo,ESP,"FW,MF",Cádiz,37,1985,0.6,0,0,0,0,0,0,0,,0,1,0,1,1,1,0,0,La_Liga,2023_2024
Carlos Neva,ESP,DF,Granada,27,1996,35.0,32,21,22,9,1,17,40,42.5,23,39,14,25,30,62,108,2,La_Liga,2023_2024
Tanguy Nianzou,FRA,DF,Sevilla,21,2002,3.5,12,8,9,2,1,8,11,72.7,3,2,0,2,3,15,9,1,La_Liga,2023_2024
Saúl Ñíguez,ESP,MF,Atlético Madrid,28,1994,15.3,64,39,29,29,6,30,49,61.2,19,36,9,27,14,78,56,0,La_Liga,2023_2024
Peru Nolaskoain,ESP,"DF,MF",Athletic Club,24,1998,0.1,1,1,1,0,0,1,1,100.0,0,0,0,0,0,1,1,0,La_Liga,2023_2024
Randy Nteka,ANG,"FW,MF",Rayo Vallecano,25,1997,6.4,11,4,1,6,4,4,10,40.0,6,6,1,5,2,13,11,1,La_Liga,2023_2024
Unai Núñez,ESP,DF,Celta Vigo,26,1997,31.1,51,28,30,19,2,23,49,46.9,26,38,24,14,52,103,153,3,La_Liga,2023_2024
Ørjan Nyland,NOR,GK,Sevilla,32,1990,24.0,0,0,0,0,0,0,1,0.0,1,0,0,0,0,0,9,1,La_Liga,2023_2024
Jan Oblak,SVN,GK,Atlético Madrid,30,1993,38.0,0,0,0,0,0,0,0,,0,0,0,0,0,0,10,0,La_Liga,2023_2024
Brian Ocampo,URU,"MF,FW",Cádiz,24,1999,2.8,4,3,1,3,0,2,5,40.0,3,4,0,4,3,7,0,0,La_Liga,2023_2024
Lucas Ocampos,ARG,"FW,MF",Sevilla,29,1994,31.9,66,47,22,27,17,29,58,50.0,29,34,1,33,21,87,29,0,La_Liga,2023_2024
Álvaro Odriozola,ESP,DF,Real Sociedad,27,1995,4.4,9,7,7,1,1,5,5,100.0,0,2,1,1,8,17,7,0,La_Liga,2023_2024
Aingeru Olabarrieta,ESP,FW,Athletic Club,17,2005,0.1,0,0,0,0,0,0,0,,0,0,0,0,0,0,0,0,La_Liga,2023_2024
Olasagasti,ESP,MF,Real Sociedad,22,2000,4.0,16,13,4,7,5,5,8,62.5,3,2,0,2,3,19,5,1,La_Liga,2023_2024
Samu Omorodion,ESP,FW,Alavés,19,2004,21.3,6,3,1,4,1,0,4,0.0,4,11,2,9,1,7,14,0,La_Liga,2023_2024
Samu Omorodion,ESP,FW,Granada,19,2004,0.9,1,1,0,1,0,1,1,100.0,0,0,0,0,0,1,0,0,La_Liga,2023_2024
Aimar Oroz,ESP,MF,Osasuna,21,2001,26.0,43,26,18,20,5,13,37,35.1,24,27,2,25,16,59,11,0,La_Liga,2023_2024
Eneko Ortiz,ESP,DF,Alavés,20,2003,0.2,0,0,0,0,0,0,0,,0,0,0,0,0,0,0,0,La_Liga,2023_2024
Asier Osambela,ESP,MF,Osasuna,19,2004,0.1,2,1,0,1,1,0,0,,0,0,0,0,0,2,0,0,La_Liga,2023_2024
Milutin Osmajić,MNE,MF,Cádiz,24,1999,0.1,0,0,0,0,0,0,0,,0,0,0,0,0,0,0,0,La_Liga,2023_2024
Aiham Ousou,SYR,DF,Cádiz,23,2000,4.8,8,5,6,2,0,5,5,100.0,0,1,0,1,7,15,15,0,La_Liga,2023_2024
Jesús Owono,EQG,GK,Alavés,22,2001,4.0,0,0,0,0,0,0,0,,0,0,0,0,0,0,3,0,La_Liga,2023_2024
Mikel Oyarzabal,ESP,"FW,MF",Real Sociedad,26,1997,24.0,23,18,7,11,5,7,21,33.3,14,25,4,21,4,27,12,0,La_Liga,2023_2024
Cenk Özkacar,TUR,DF,Valencia,22,2000,17.8,26,15,22,4,0,15,23,65.2,8,18,7,11,18,44,84,1,La_Liga,2023_2024
Jon Pacheco,ESP,DF,Real Sociedad,22,2001,17.0,25,15,21,4,0,14,22,63.6,8,17,6,11,10,35,53,1,La_Liga,2023_2024
Isaac Palazón Camacho,ESP,"MF,FW",Rayo Vallecano,28,1994,31.0,46,25,16,21,9,20,58,34.5,38,29,2,27,16,62,41,0,La_Liga,2023_2024
Joaquín Panichelli,ARG,"FW,MF",Alavés,20,2002,2.5,3,3,1,1,1,1,2,50.0,1,1,0,1,1,4,4,0,La_Liga,2023_2024
Sokratis Papastathopoulos,GRE,DF,Betis,35,1988,12.6,21,14,16,5,0,13,17,76.5,4,15,9,6,6,27,60,0,La_Liga,2023_2024
Victor Parada,ESP,"FW,MF",Alavés,21,2002,0.0,1,1,0,1,0,1,1,100.0,0,0,0,0,0,1,0,0,La_Liga,2023_2024
Aitor Paredes,ESP,DF,Athletic Club,23,2000,30.0,20,11,11,9,0,7,14,50.0,7,23,11,12,33,53,104,0,La_Liga,2023_2024
Daniel Parejo,ESP,MF,Villarreal,34,1989,28.7,43,30,16,21,6,20,46,43.5,26,25,9,16,21,64,29,3,La_Liga,2023_2024
Pascu,ESP,FW,Villarreal,20,2003,0.2,0,0,0,0,0,0,0,,0,0,0,0,0,0,0,0,La_Liga,2023_2024
Gabriel Paulista,BRA,DF,Atlético Madrid,32,1990,4.5,7,5,4,3,0,3,4,75.0,1,5,3,2,4,11,27,0,La_Liga,2023_2024
Gabriel Paulista,BRA,DF,Valencia,32,1990,15.5,10,7,8,2,0,6,11,54.5,5,15,7,8,24,34,78,0,La_Liga,2023_2024
Nicolás Paz,ARG,"MF,FW",Real Madrid,18,2004,0.3,0,0,0,0,0,0,0,,0,2,0,2,1,1,0,0,La_Liga,2023_2024
Alfonso Pedraza,ESP,DF,Villarreal,27,1996,12.4,25,9,18,5,2,9,17,52.9,8,16,7,9,13,38,19,0,La_Liga,2023_2024
Pedri,ESP,"MF,FW",Barcelona,20,2002,16.4,33,24,16,13,4,8,27,29.6,19,27,3,24,14,47,10,0,La_Liga,2023_2024
Adrià Pedrosa,ESP,DF,Sevilla,25,1998,19.5,46,26,28,14,4,23,34,67.6,11,26,6,20,15,61,54,0,La_Liga,2023_2024
Pejiño,ESP,FW,Las Palmas,27,1996,5.6,12,8,3,6,3,6,18,33.3,12,4,0,4,2,14,5,0,La_Liga,2023_2024
Facundo Pellistri,URU,"MF,FW",Granada,21,2001,13.7,29,19,12,10,7,6,21,28.6,15,18,0,18,4,33,7,0,La_Liga,2023_2024
Iñaki Peña ,ESP,GK,Barcelona,24,1999,10.0,0,0,0,0,0,0,1,0.0,1,0,0,0,0,0,5,1,La_Liga,2023_2024
Marcos Peña,ESP,MF,Almería,18,2005,4.9,19,14,12,7,0,6,12,50.0,6,9,3,6,13,32,8,0,La_Liga,2023_2024
Rubén Peña,ESP,"DF,FW",Osasuna,32,1991,23.2,47,25,22,18,7,20,49,40.8,29,37,8,29,30,77,39,3,La_Liga,2023_2024
Alberto Perea,ESP,"MF,FW",Granada,32,1990,0.0,0,0,0,0,0,0,2,0.0,2,0,0,0,0,0,0,0,La_Liga,2023_2024
Ayoze Pérez,ESP,FW,Betis,30,1993,25.5,59,32,16,33,10,21,49,42.9,28,42,4,38,22,81,18,0,La_Liga,2023_2024
Carles Pérez,ESP,"MF,DF",Celta Vigo,25,1998,8.6,13,5,6,5,2,7,18,38.9,11,14,1,13,5,18,8,0,La_Liga,2023_2024
Francisco Perez,ESP,"MF,FW",Valencia,20,2002,22.8,30,17,10,14,6,15,44,34.1,29,19,0,19,14,44,5,0,La_Liga,2023_2024
Kike Pérez,ESP,"MF,FW",Rayo Vallecano,26,1997,9.3,27,11,11,15,1,11,23,47.8,12,11,0,11,8,35,6,0,La_Liga,2023_2024
Máximo Perrone,ARG,MF,Las Palmas,20,2003,18.0,42,21,17,22,3,19,39,48.7,20,27,4,23,24,66,21,0,La_Liga,2023_2024
Njegoš Petrović,SRB,"MF,FW",Granada,24,1999,1.7,5,2,4,1,0,2,3,66.7,1,2,0,2,1,6,3,0,La_Liga,2023_2024
Germán Pezzella,ARG,DF,Betis,32,1991,30.7,34,24,24,10,0,23,38,60.5,15,31,18,13,31,65,150,0,La_Liga,2023_2024
Kamil Piątkowski,POL,DF,Granada,23,2000,5.6,18,10,16,1,1,10,14,71.4,4,6,5,1,8,26,28,1,La_Liga,2023_2024
Yeremi Pino,ESP,"MF,FW",Villarreal,20,2002,5.3,25,18,12,10,3,9,18,50.0,9,11,1,10,5,30,5,0,La_Liga,2023_2024
Portu,ESP,FW,Getafe,31,1992,1.1,5,3,4,0,1,5,6,83.3,1,0,0,0,0,5,0,0,La_Liga,2023_2024
Portu,ESP,"MF,FW",Girona,31,1992,13.2,18,13,3,10,5,3,18,16.7,15,9,1,8,4,22,6,0,La_Liga,2023_2024
José Pozo,ESP,MF,Rayo Vallecano,27,1996,0.2,1,1,0,1,0,1,1,100.0,0,1,0,1,0,1,0,0,La_Liga,2023_2024
Alejandro Pozo Pozo,ESP,"DF,MF",Almería,24,1999,10.8,19,12,11,6,2,12,20,60.0,8,14,4,10,7,26,21,0,La_Liga,2023_2024
Beñat Prados,ESP,"MF,DF",Athletic Club,22,2001,16.1,45,28,11,23,11,23,42,54.8,19,32,5,27,23,68,27,0,La_Liga,2023_2024
Abdón Prats,ESP,"FW,MF",Mallorca,30,1992,14.1,6,4,2,2,2,3,5,60.0,2,6,3,3,2,8,12,0,La_Liga,2023_2024
Marc Pubill,ESP,DF,Almería,20,2003,20.9,47,23,35,8,4,22,39,56.4,17,20,8,12,15,62,83,1,La_Liga,2023_2024
Antonio Puertas,ESP,"MF,FW",Granada,31,1992,8.1,12,8,6,5,1,6,15,40.0,9,5,0,5,6,18,4,0,La_Liga,2023_2024
Arnau Puigmal,ESP,"FW,DF",Almería,22,2001,2.8,2,1,1,1,0,1,3,33.3,2,3,0,3,3,5,2,0,La_Liga,2023_2024
Nemanja Radonjić,SRB,"MF,DF",Mallorca,27,1996,3.9,4,2,1,3,0,1,4,25.0,3,2,0,2,3,7,3,0,La_Liga,2023_2024
Aleksandar Radovanović,SRB,DF,Almería,29,1993,6.3,8,7,7,1,0,6,6,100.0,0,8,8,0,11,19,48,0,La_Liga,2023_2024
Abdellah Raihani,MAR,FW,Atlético Madrid,19,2004,0.1,0,0,0,0,0,0,1,0.0,1,0,0,0,0,0,0,0,La_Liga,2023_2024
Antonio Raillo,ESP,DF,Mallorca,31,1991,24.4,30,23,18,12,0,17,23,73.9,6,44,30,14,37,67,104,2,La_Liga,2023_2024
Predrag Rajković,SRB,GK,Mallorca,27,1995,36.0,2,1,2,0,0,2,2,100.0,0,0,0,0,0,2,14,0,La_Liga,2023_2024
Ivan Rakitić,CRO,MF,Sevilla,35,1988,15.8,30,16,9,12,9,11,19,57.9,8,16,5,11,14,44,12,0,La_Liga,2023_2024
Largie Ramazani,BEL,"FW,MF",Almería,22,2001,17.3,12,7,5,6,1,6,26,23.1,20,16,2,14,34,46,10,0,La_Liga,2023_2024
Benito Ramírez,ESP,"FW,MF",Las Palmas,28,1995,4.3,5,3,2,3,0,3,6,50.0,3,7,1,6,3,8,0,0,La_Liga,2023_2024
Sandro Ramírez,ESP,FW,Las Palmas,28,1995,20.1,12,8,4,6,2,6,15,40.0,9,13,1,12,4,16,14,1,La_Liga,2023_2024
Chris Ramos,ESP,"FW,MF",Cádiz,26,1997,29.0,28,15,9,15,4,8,27,29.6,19,23,7,16,9,37,44,0,La_Liga,2023_2024
Sergio Ramos,ESP,DF,Sevilla,37,1986,28.0,45,30,32,11,2,27,40,67.5,13,35,30,5,41,86,156,0,La_Liga,2023_2024
Raphinha,BRA,"FW,MF",Barcelona,26,1996,15.2,14,8,6,6,2,4,18,22.2,14,17,1,16,13,27,11,0,La_Liga,2023_2024
Andrei Ratiu,ROU,"DF,MF",Rayo Vallecano,25,1998,7.0,12,4,6,5,1,8,15,53.3,7,4,1,3,0,12,12,0,La_Liga,2023_2024
Raúl,ESP,FW,Osasuna,22,2000,15.1,10,4,4,2,4,2,10,20.0,8,9,1,8,5,15,11,0,La_Liga,2023_2024
Abderrahman Rebbach,ALG,"FW,MF",Alavés,24,1998,8.0,9,5,4,2,3,5,15,33.3,10,10,1,9,3,12,7,0,La_Liga,2023_2024
Pepe Reina,ESP,GK,Villarreal,40,1982,2.0,0,0,0,0,0,0,0,,0,0,0,0,0,0,1,0,La_Liga,2023_2024
Álex Remiro,ESP,GK,Real Sociedad,28,1995,36.4,0,0,0,0,0,0,0,,0,0,0,0,0,0,24,2,La_Liga,2023_2024
Chadi Riad,MAR,DF,Betis,20,2003,24.0,35,24,17,18,0,17,27,63.0,10,23,14,9,23,58,108,0,La_Liga,2023_2024
Diego Rico,ESP,DF,Getafe,30,1993,28.2,64,48,32,23,9,41,76,53.9,35,25,8,17,41,105,76,0,La_Liga,2023_2024
Luis Rioja,ESP,"FW,MF",Alavés,29,1993,27.8,27,19,10,12,5,14,43,32.6,29,28,1,27,16,43,28,0,La_Liga,2023_2024
Rodrigo Riquelme,ESP,"DF,MF",Atlético Madrid,23,2000,17.0,30,19,18,4,8,18,46,39.1,28,19,0,19,9,39,20,0,La_Liga,2023_2024
Alberto Risco,ESP,MF,Getafe,17,2005,1.5,2,2,1,1,0,0,4,0.0,4,0,0,0,0,2,1,0,La_Liga,2023_2024
Mihailo Ristić,SRB,"DF,MF",Celta Vigo,27,1995,9.0,15,9,9,6,0,9,12,75.0,3,9,2,7,10,25,23,0,La_Liga,2023_2024
Gorka Rivera Alonso,ESP,DF,Getafe,18,2004,0.0,0,0,0,0,0,0,0,,0,0,0,0,0,0,0,0,La_Liga,2023_2024
Sergi Roberto,ESP,"MF,DF",Barcelona,31,1992,9.6,15,10,4,10,1,3,11,27.3,8,7,2,5,8,23,7,1,La_Liga,2023_2024
Lucas Robertone,ARG,MF,Almería,26,1997,26.5,61,33,28,23,10,25,50,50.0,25,43,9,34,51,112,43,0,La_Liga,2023_2024
Marc Roca,ESP,MF,Betis,26,1996,22.0,52,36,17,29,6,30,53,56.6,23,29,6,23,17,69,23,1,La_Liga,2023_2024
Sergio Rodelas,ESP,"FW,DF",Granada,18,2004,1.4,3,2,1,0,2,0,3,0.0,3,0,0,0,0,3,0,0,La_Liga,2023_2024
Rodri,ESP,"FW,MF",Betis,23,2000,11.7,17,10,6,7,4,8,21,38.1,13,11,0,11,8,25,2,0,La_Liga,2023_2024
Álvaro Rodríguez,URU,FW,Real Madrid,19,2004,0.0,0,0,0,0,0,0,0,,0,0,0,0,0,0,1,0,La_Liga,2023_2024
Óscar Rodríguez Arnaiz,ESP,"MF,FW",Getafe,25,1998,10.7,24,13,2,15,7,9,15,60.0,6,12,1,11,5,29,5,0,La_Liga,2023_2024
Damián Rodríguez,ESP,MF,Celta Vigo,20,2003,2.9,6,3,1,3,2,1,3,33.3,2,4,2,2,1,7,2,0,La_Liga,2023_2024
Dani Rodríguez,ESP,MF,Mallorca,35,1988,29.1,47,24,21,20,6,21,45,46.7,24,34,5,29,15,62,21,0,La_Liga,2023_2024
Guido Rodríguez,ARG,MF,Betis,29,1994,20.5,53,30,21,24,8,34,55,61.8,21,27,6,21,29,82,44,0,La_Liga,2023_2024
Kirian Rodríguez,ESP,MF,Las Palmas,27,1996,35.7,52,32,22,25,5,24,67,35.8,43,39,3,36,28,80,23,1,La_Liga,2023_2024
Miguel Rodríguez,ESP,MF,Celta Vigo,20,2003,3.3,6,3,3,1,2,3,9,33.3,6,8,0,8,4,10,0,0,La_Liga,2023_2024
Rodrygo,BRA,FW,Real Madrid,22,2001,26.4,16,15,2,9,5,5,19,26.3,14,14,0,14,8,24,6,0,La_Liga,2023_2024
Carlos Romero,ESP,DF,Villarreal,21,2001,2.9,11,5,8,1,2,7,12,58.3,5,3,0,3,1,12,11,0,La_Liga,2023_2024
Isaac Romero,ESP,FW,Sevilla,23,2000,11.5,6,3,2,2,2,5,9,55.6,4,12,0,12,0,6,11,0,La_Liga,2023_2024
Luka Romero,ARG,FW,Almería,18,2004,4.9,5,1,2,3,0,2,4,50.0,2,12,1,11,1,6,2,1,La_Liga,2023_2024
Oriol Romeu,ESP,MF,Barcelona,31,1991,10.4,34,20,17,14,3,13,24,54.2,11,12,2,10,10,44,18,0,La_Liga,2023_2024
Unai Ropero,ESP,MF,Alavés,21,2001,0.1,0,0,0,0,0,0,0,,0,0,0,0,0,0,0,0,La_Liga,2023_2024
Vitor Roque,BRA,FW,Barcelona,18,2005,3.6,3,2,2,0,1,0,2,0.0,2,3,0,3,0,3,5,0,La_Liga,2023_2024
Antonio Rüdiger,GER,DF,Real Madrid,30,1993,30.1,26,15,18,4,4,16,20,80.0,4,27,20,7,11,37,89,0,La_Liga,2023_2024
Javier Rueda Garcia,ESP,"MF,DF",Celta Vigo,21,2002,0.2,0,0,0,0,0,0,0,,0,0,0,0,0,0,0,0,La_Liga,2023_2024
Aitor Ruibal,ESP,"DF,FW",Betis,27,1996,11.3,46,27,28,13,5,32,59,54.2,27,12,1,11,14,60,33,1,La_Liga,2023_2024
Sergio Ruiz,ESP,MF,Granada,28,1994,27.7,83,46,43,36,4,38,84,45.2,46,24,6,18,28,111,43,1,La_Liga,2023_2024
Youssouf Sabaly,SEN,DF,Betis,30,1993,11.6,16,11,12,3,1,8,12,66.7,4,6,3,3,11,27,27,0,La_Liga,2023_2024
Umar Sadiq,NGA,FW,Real Sociedad,26,1997,12.0,15,10,2,8,5,4,8,50.0,4,9,0,9,0,15,10,0,La_Liga,2023_2024
Pablo Saenz,ESP,MF,Granada,22,2001,0.2,3,3,2,0,1,1,3,33.3,2,0,0,0,0,3,0,0,La_Liga,2023_2024
Kike Salas,ESP,DF,Sevilla,21,2002,17.8,41,23,26,12,3,22,36,61.1,14,25,14,11,26,67,91,1,La_Liga,2023_2024
Salvi,ESP,MF,Rayo Vallecano,32,1991,0.3,0,0,0,0,0,0,4,0.0,4,0,0,0,1,1,0,0,La_Liga,2023_2024
Diadie Samassékou,MLI,MF,Cádiz,27,1996,1.0,5,3,2,2,1,5,6,83.3,1,0,0,0,3,8,1,0,La_Liga,2023_2024
Fede San Emeterio,ESP,MF,Cádiz,26,1997,1.7,3,2,2,1,0,1,4,25.0,3,3,2,1,2,5,1,0,La_Liga,2023_2024
Oihan Sancet,ESP,MF,Athletic Club,23,2000,21.9,19,11,3,10,6,8,21,38.1,13,5,1,4,10,29,5,0,La_Liga,2023_2024
Ricard Sánchez ,ESP,DF,Granada,23,2000,25.5,29,18,15,8,6,12,24,50.0,12,32,4,28,13,42,64,0,La_Liga,2023_2024
Antonio Sánchez,ESP,MF,Mallorca,26,1997,16.1,25,11,13,10,2,11,32,34.4,21,24,5,19,13,38,13,0,La_Liga,2023_2024
Juanlu Sánchez,ESP,DF,Sevilla,19,2003,13.1,56,35,34,18,4,34,58,58.6,24,24,7,17,12,68,36,0,La_Liga,2023_2024
Manu Sánchez,ESP,"DF,MF",Celta Vigo,22,2000,19.7,54,28,21,25,8,31,55,56.4,24,23,3,20,19,73,65,0,La_Liga,2023_2024
Jesús Santiago,ESP,MF,Getafe,19,2004,7.3,17,8,8,5,4,4,7,57.1,3,3,0,3,0,17,8,0,La_Liga,2023_2024
Paco Sanz,ESP,DF,Almería,18,2004,0.3,0,0,0,0,0,0,1,0.0,1,0,0,0,0,0,4,0,La_Liga,2023_2024
Stefan Savić,MNE,DF,Atlético Madrid,32,1991,18.1,27,19,16,7,4,15,30,50.0,15,29,15,14,27,54,61,1,La_Liga,2023_2024
Sávio,BRA,"FW,MF",Girona,19,2004,33.1,42,25,14,22,6,16,28,57.1,12,34,0,34,18,60,11,1,La_Liga,2023_2024
Aleksandar Sedlar,SRB,DF,Alavés,31,1991,10.5,14,10,10,4,0,10,16,62.5,6,8,4,4,13,27,43,0,La_Liga,2023_2024
André Silva,POR,FW,Real Sociedad,27,1995,8.1,2,2,0,0,2,0,4,0.0,4,3,0,3,1,3,3,0,La_Liga,2023_2024
Rui Silva,POR,GK,Betis,29,1994,27.5,0,0,0,0,0,0,3,0.0,3,0,0,0,1,1,13,1,La_Liga,2023_2024
Giuliano Simeone,ARG,FW,Alavés,20,2002,7.0,7,5,2,3,2,5,17,29.4,12,10,0,10,5,12,3,0,La_Liga,2023_2024
Unai Simón,ESP,GK,Athletic Club,26,1997,35.4,2,1,1,1,0,2,3,66.7,1,0,0,0,1,3,9,0,La_Liga,2023_2024
Daley Sinkgraven,NED,DF,Las Palmas,28,1995,4.2,11,5,6,5,0,2,8,25.0,6,5,3,2,6,17,9,0,La_Liga,2023_2024
Jailson Siqueira,BRA,"DF,MF",Celta Vigo,27,1995,10.0,27,18,22,5,0,13,24,54.2,11,13,5,8,12,39,32,0,La_Liga,2023_2024
Antonio Sivera,ESP,GK,Alavés,26,1996,34.0,0,0,0,0,0,0,1,0.0,1,0,0,0,0,0,17,1,La_Liga,2023_2024
Rubén Sobrino,ESP,"MF,FW",Cádiz,31,1992,18.3,52,28,18,26,8,22,51,43.1,29,26,2,24,16,68,18,0,La_Liga,2023_2024
Alex Sola,ESP,"FW,MF",Alavés,24,1999,14.0,27,15,11,9,7,14,26,53.8,12,18,2,16,11,38,16,0,La_Liga,2023_2024
Alex Sola,ESP,"DF,MF",Real Sociedad,24,1999,0.3,0,0,0,0,0,0,0,,0,0,0,0,1,1,2,0,La_Liga,2023_2024
Jhon Solis,COL,MF,Girona,18,2004,4.3,10,8,4,5,1,4,12,33.3,8,8,3,5,8,18,7,1,La_Liga,2023_2024
David Soria,ESP,GK,Getafe,30,1993,37.9,0,0,0,0,0,0,2,0.0,2,0,0,0,0,0,21,6,La_Liga,2023_2024
Alberto Soro,ESP,MF,Granada,24,1999,0.1,0,0,0,0,0,0,0,,0,0,0,0,0,0,0,0,La_Liga,2023_2024
Hugo Sotelo,ESP,MF,Celta Vigo,19,2003,8.0,19,17,3,13,3,8,20,40.0,12,7,1,6,2,21,5,0,La_Liga,2023_2024
Boubakary Soumaré,FRA,MF,Sevilla,24,1999,25.4,39,28,24,14,1,14,26,53.8,12,25,7,18,26,65,20,1,La_Liga,2023_2024
Djibril Sow,SUI,MF,Sevilla,26,1997,16.2,28,21,15,8,5,9,25,36.0,16,20,3,17,17,45,8,1,La_Liga,2023_2024
Çağlar Söyüncü,TUR,DF,Atlético Madrid,27,1996,1.3,1,1,1,0,0,0,0,,0,1,0,1,1,2,7,0,La_Liga,2023_2024
Carl Starfelt,SWE,DF,Celta Vigo,28,1995,24.6,36,30,30,5,1,19,28,67.9,9,35,28,7,34,70,159,2,La_Liga,2023_2024
Jørgen Strand Larsen,NOR,FW,Celta Vigo,23,2000,31.8,21,11,1,15,5,8,38,21.1,30,15,1,14,5,26,17,0,La_Liga,2023_2024
Cristhian Stuani,URU,FW,Girona,36,1986,8.9,14,11,4,6,4,4,7,57.1,3,9,2,7,5,19,13,0,La_Liga,2023_2024
Álex Suárez,ESP,DF,Las Palmas,30,1993,28.5,53,36,33,15,5,31,37,83.8,6,33,14,19,18,71,84,0,La_Liga,2023_2024
Damián Suárez,URU,DF,Getafe,35,1988,14.4,36,21,16,16,4,26,45,57.8,19,13,3,10,10,46,31,0,La_Liga,2023_2024
Denis Suárez,ESP,"MF,FW",Villarreal,29,1994,1.5,0,0,0,0,0,0,2,0.0,2,2,2,0,0,0,4,0,La_Liga,2023_2024
Suso,ESP,"MF,FW",Sevilla,29,1993,16.9,24,17,14,8,2,8,28,28.6,20,9,0,9,5,29,4,0,La_Liga,2023_2024
Max Svensson,ESP,FW,Osasuna,,,0.0,1,0,0,0,1,0,0,,0,0,0,0,0,1,0,0,La_Liga,2023_2024
Williot Swedberg,SWE,"FW,MF",Celta Vigo,19,2004,4.9,9,4,3,6,0,5,8,62.5,3,11,1,10,0,9,4,0,La_Liga,2023_2024
Mamadou Sylla,SEN,"FW,MF",Alavés,29,1994,0.2,0,0,0,0,0,0,0,,0,1,1,0,0,0,1,0,La_Liga,2023_2024
Alexander Sørloth,NOR,FW,Villarreal,27,1995,27.7,6,3,1,2,3,2,6,33.3,4,9,4,5,0,6,26,0,La_Liga,2023_2024
Yassin Tallal,ESP,FW,Getafe,18,2005,0.0,0,0,0,0,0,0,0,,0,0,0,0,0,0,0,0,La_Liga,2023_2024
Renato Tapia,PER,"MF,DF",Celta Vigo,28,1995,14.9,41,29,19,19,3,14,25,56.0,11,31,7,24,21,62,50,1,La_Liga,2023_2024
César Tárrega,ESP,DF,Valencia,21,2002,0.1,0,0,0,0,0,0,0,,0,0,0,0,0,0,2,0,La_Liga,2023_2024
Marciano Tchami,GNB,"FW,MF",Almería,19,2004,0.5,0,0,0,0,0,0,0,,0,0,0,0,0,0,0,0,La_Liga,2023_2024
Aurélien Tchouaméni,FRA,"MF,DF",Real Madrid,23,2000,22.1,38,23,19,17,2,9,18,50.0,9,21,13,8,28,66,52,1,La_Liga,2023_2024
Nahuel Tenaglia,ARG,DF,Alavés,27,1996,12.7,29,19,22,4,3,16,28,57.1,12,14,8,6,12,41,59,0,La_Liga,2023_2024
Marc-André ter Stegen,GER,GK,Barcelona,31,1992,28.0,0,0,0,0,0,0,0,,0,0,0,0,0,0,3,3,La_Liga,2023_2024
Ramón Terrats,ESP,"MF,DF",Villarreal,22,2000,8.7,17,13,8,8,1,7,15,46.7,8,11,1,10,3,20,9,0,La_Liga,2023_2024
Kieran Tierney,SCO,DF,Real Sociedad,26,1997,13.8,37,24,16,18,3,18,27,66.7,9,22,8,14,10,47,45,0,La_Liga,2023_2024
Raúl de Tomás,ESP,FW,Rayo Vallecano,28,1994,14.1,9,5,4,3,2,3,6,50.0,3,3,0,3,1,10,8,0,La_Liga,2023_2024
Pablo Torre,ESP,"MF,FW",Girona,20,2003,7.8,5,2,0,5,0,4,10,40.0,6,10,2,8,4,9,6,1,La_Liga,2023_2024
Raúl Torrente,ESP,DF,Granada,21,2001,13.9,29,16,20,9,0,17,22,77.3,5,16,10,6,11,40,68,2,La_Liga,2023_2024
Ferrán Torres,ESP,FW,Barcelona,23,2000,13.5,9,6,1,6,2,5,16,31.3,11,7,1,6,5,14,6,0,La_Liga,2023_2024
Óliver Torres,ESP,MF,Sevilla,28,1994,18.0,37,22,17,15,5,22,57,38.6,35,40,4,36,6,43,6,0,La_Liga,2023_2024
Lucas Torró,ESP,MF,Osasuna,29,1994,19.9,25,15,11,8,6,11,28,39.3,17,10,2,8,33,58,37,0,La_Liga,2023_2024
Bertrand Traoré,BFA,MF,Villarreal,27,1995,6.3,5,4,2,1,2,1,4,25.0,3,6,0,6,1,6,2,0,La_Liga,2023_2024
Hamari Traoré,MLI,DF,Real Sociedad,31,1992,25.5,44,19,24,17,3,25,43,58.1,18,27,8,19,24,68,59,2,La_Liga,2023_2024
Óscar Trejo,ARG,"FW,MF",Rayo Vallecano,35,1988,15.3,27,15,11,9,7,13,21,61.9,8,21,1,20,5,32,9,0,La_Liga,2023_2024
Manu Trigueros,ESP,MF,Villarreal,31,1991,3.4,7,5,6,1,0,4,10,40.0,6,1,1,0,3,10,9,0,La_Liga,2023_2024
Viktor Tsyhankov,UKR,"MF,FW",Girona,25,1997,22.8,29,20,11,13,5,14,26,53.8,12,18,1,17,12,41,24,0,La_Liga,2023_2024
Beñat Turrientes,ESP,MF,Real Sociedad,21,2002,18.7,31,17,6,20,5,13,30,43.3,17,19,8,11,6,37,17,0,La_Liga,2023_2024
Enes Ünal,TUR,"FW,MF",Getafe,26,1997,1.6,0,0,0,0,0,0,0,,0,1,0,1,0,0,2,0,La_Liga,2023_2024
Myrto Uzuni,ALB,FW,Granada,28,1995,27.2,18,14,8,7,3,6,27,22.2,21,19,3,16,4,22,7,0,La_Liga,2023_2024
Óscar Valentín,ESP,MF,Rayo Vallecano,28,1994,29.9,107,66,39,62,6,46,101,45.5,55,62,10,52,35,142,52,1,La_Liga,2023_2024
Martin Valjent,SVK,DF,Mallorca,27,1995,26.1,34,18,19,13,2,18,30,60.0,12,26,11,15,29,63,112,1,La_Liga,2023_2024
Jesús Vallejo,ESP,DF,Granada,26,1997,1.2,3,1,1,2,0,2,2,100.0,0,3,2,1,0,3,1,1,La_Liga,2023_2024
Álvaro Vallés,ESP,GK,Las Palmas,26,1997,36.3,3,2,3,0,0,3,8,37.5,5,0,0,0,0,3,40,1,La_Liga,2023_2024
Federico Valverde,URU,MF,Real Madrid,25,1998,32.3,47,34,22,13,12,24,42,57.1,18,39,2,37,43,90,40,0,La_Liga,2023_2024
Siebe Van Der Heyden,BEL,DF,Mallorca,25,1998,3.2,9,2,7,2,0,4,6,66.7,2,1,1,0,7,16,12,0,La_Liga,2023_2024
José Luis García Vayá,ESP,MF,Valencia,24,1998,36.7,78,53,36,36,6,37,71,52.1,34,41,10,31,49,127,71,0,La_Liga,2023_2024
Borja Vázquez,ESP,FW,Cádiz,18,2005,0.0,1,0,1,0,0,1,1,100.0,0,0,0,0,0,1,1,0,La_Liga,2023_2024
Jesus Vazquez,ESP,"DF,MF",Valencia,20,2003,8.0,24,12,13,8,3,10,16,62.5,6,17,4,13,3,27,24,0,La_Liga,2023_2024
Kevin Vázquez,ESP,DF,Celta Vigo,30,1993,7.8,15,13,7,7,1,12,21,57.1,9,11,3,8,5,20,25,0,La_Liga,2023_2024
Lucas Vázquez,ESP,DF,Real Madrid,32,1991,15.8,37,25,22,14,1,18,25,72.0,7,27,5,22,12,49,36,0,La_Liga,2023_2024
Gabriel Veiga,ESP,FW,Celta Vigo,21,2002,0.2,0,0,0,0,0,0,0,,0,0,0,0,0,0,0,0,La_Liga,2023_2024
Alejo Véliz,ARG,FW,Sevilla,19,2003,0.4,1,0,0,1,0,1,2,50.0,1,0,0,0,0,1,1,0,La_Liga,2023_2024
Arthur Vermeeren,BEL,MF,Atlético Madrid,18,2005,1.8,1,0,0,1,0,0,1,0.0,1,5,0,5,6,7,2,0,La_Liga,2023_2024
Mikel Vesga,ESP,MF,Athletic Club,30,1993,17.0,40,20,11,23,6,19,49,38.8,30,19,7,12,32,72,35,1,La_Liga,2023_2024
Carlos Vicente,ESP,FW,Alavés,24,1999,12.4,16,6,7,7,2,10,25,40.0,15,4,0,4,4,20,9,0,La_Liga,2023_2024
Nacho Vidal,ESP,"DF,FW",Osasuna,28,1995,1.1,5,4,2,2,1,2,5,40.0,3,2,0,2,0,5,6,0,La_Liga,2023_2024
Nacho Vidal,ESP,DF,Mallorca,28,1995,4.6,12,5,4,5,3,6,13,46.2,7,5,2,3,3,15,9,0,La_Liga,2023_2024
Fran Vieites,ESP,GK,Betis,24,1999,3.5,1,0,1,0,0,1,1,100.0,0,0,0,0,0,1,2,1,La_Liga,2023_2024
Jonathan Viera,ESP,"MF,FW",Las Palmas,33,1989,6.9,6,3,1,2,3,1,9,11.1,8,0,0,0,0,6,1,0,La_Liga,2023_2024
Jonathan Viera,ESP,MF,Almería,33,1989,10.1,19,9,6,9,4,10,19,52.6,9,4,0,4,4,23,1,0,La_Liga,2023_2024
Toni Villa,ESP,FW,Girona,28,1995,0.1,0,0,0,0,0,0,0,,0,0,0,0,0,0,0,0,La_Liga,2023_2024
Asier Villalibre,ESP,FW,Athletic Club,25,1997,5.7,2,1,0,0,2,2,2,100.0,0,2,1,1,0,2,6,0,La_Liga,2023_2024
Gonzalo Villar,ESP,MF,Granada,25,1998,20.0,51,33,26,20,5,26,41,63.4,15,32,10,22,6,57,26,1,La_Liga,2023_2024
Iván Villar,ESP,GK,Celta Vigo,26,1997,11.3,0,0,0,0,0,0,1,0.0,1,0,0,0,0,0,6,0,La_Liga,2023_2024
Ricardo Visus,ESP,DF,Betis,22,2001,1.8,2,2,1,1,0,2,2,100.0,0,2,2,0,2,4,9,1,La_Liga,2023_2024
Daniel Vivian,ESP,DF,Athletic Club,24,1999,32.0,42,28,29,11,2,28,45,62.2,17,49,25,24,31,73,104,0,La_Liga,2023_2024
Shon Weissman,ISR,FW,Granada,27,1996,0.9,1,1,0,0,1,1,4,25.0,3,3,0,3,0,1,1,0,La_Liga,2023_2024
Iñaki Williams,GHA,FW,Athletic Club,29,1994,31.6,24,17,6,8,10,13,34,38.2,21,42,8,34,14,38,29,0,La_Liga,2023_2024
Nico Williams,ESP,FW,Athletic Club,21,2002,25.1,31,12,9,15,7,13,36,36.1,23,18,2,16,3,34,4,1,La_Liga,2023_2024
Axel Witsel,BEL,DF,Atlético Madrid,34,1989,30.9,35,21,23,12,0,17,24,70.8,7,40,21,19,16,51,119,0,La_Liga,2023_2024
Xeber,ESP,"FW,MF",Alavés,26,1997,3.4,5,5,3,2,0,3,7,42.9,4,2,1,1,1,6,2,0,La_Liga,2023_2024
Antal Yaakobishvili,HUN,DF,Girona,19,2004,0.7,2,1,1,1,0,1,1,100.0,0,0,0,0,3,5,3,0,La_Liga,2023_2024
Lamine Yamal,ESP,FW,Barcelona,16,2007,24.5,61,37,32,15,14,18,48,37.5,30,32,0,32,19,80,11,0,La_Liga,2023_2024
Roman Yaremchuk,UKR,FW,Valencia,27,1995,10.3,5,2,1,2,2,3,6,50.0,3,4,0,4,1,6,9,0,La_Liga,2023_2024
Arsen Zakharyan,RUS,"MF,FW",Real Sociedad,20,2003,13.6,22,15,8,11,3,9,22,40.9,13,16,0,16,4,26,10,0,La_Liga,2023_2024
Joseba Zaldúa,ESP,DF,Cádiz,31,1992,7.8,20,12,17,2,1,13,21,61.9,8,6,4,2,2,22,20,0,La_Liga,2023_2024
Bryan Zaragoza,ESP,"MF,FW",Granada,22,2001,18.2,18,9,8,6,4,8,23,34.8,15,9,0,9,3,21,3,0,La_Liga,2023_2024
Igor Zubeldia,ESP,DF,Real Sociedad,26,1997,28.0,32,25,20,10,2,19,26,73.1,7,28,19,9,32,64,97,3,La_Liga,2023_2024
Martín Zubimendi,ESP,MF,Real Sociedad,24,1999,29.5,49,27,18,29,2,23,42,54.8,19,33,9,24,37,86,54,0,La_Liga,2023_2024
Keyliane Abdallah,FRA,FW,Marseille,17,2006,0.0,0,0,0,0,0,0,0,,0,0,0,0,0,0,0,0,Ligue_1,2023_2024
Yunis Abdelhamid,MAR,DF,Reims,35,1987,30.9,64,35,36,23,5,26,45,57.8,19,51,32,19,39,103,109,2,Ligue_1,2023_2024
Salis Abdul Samed,GHA,MF,Lens,23,2000,16.9,21,14,8,10,3,8,18,44.4,10,12,1,11,12,33,18,0,Ligue_1,2023_2024
Laurent Abergel,FRA,MF,Lorient,30,1993,31.8,85,52,43,34,8,38,96,39.6,58,29,6,23,61,146,61,3,Ligue_1,2023_2024
Matthis Abline,FRA,FW,Nantes,20,2003,11.6,9,4,4,3,2,3,8,37.5,5,3,0,3,3,12,5,0,Ligue_1,2023_2024
Zakaria Aboukhlal,MAR,"MF,FW",Toulouse,23,2000,8.4,9,8,1,5,3,3,12,25.0,9,9,1,8,1,10,2,0,Ligue_1,2023_2024
Akor Adams,NGA,FW,Montpellier,23,2000,25.0,12,4,3,4,5,3,7,42.9,4,9,2,7,5,17,11,0,Ligue_1,2023_2024
Nathaniel Adjei,GHA,DF,Lorient,20,2002,13.8,13,9,8,3,2,6,7,85.7,1,15,8,7,18,31,64,1,Ligue_1,2023_2024
Adryelson,BRA,"DF,FW",Lyon,25,1998,0.1,0,0,0,0,0,0,0,,0,0,0,0,1,1,3,0,Ligue_1,2023_2024
Adson,BRA,"MF,FW",Nantes,22,2000,2.6,7,6,1,6,0,2,2,100.0,0,5,0,5,2,9,2,0,Ligue_1,2023_2024
Emmanuel Agbadou,CIV,DF,Reims,26,1997,28.8,65,41,38,23,4,44,64,68.8,20,47,25,22,55,120,116,1,Ligue_1,2023_2024
Ruben Aguilar,FRA,DF,Lens,30,1993,21.4,53,31,27,23,3,27,45,60.0,18,35,5,30,26,79,46,0,Ligue_1,2023_2024
Tosin Aiyegun,BEN,"MF,FW",Lorient,25,1998,10.0,6,4,2,3,1,3,9,33.3,6,4,1,3,2,8,8,0,Ligue_1,2023_2024
Sergio Akieme,ESP,DF,Reims,25,1997,9.1,11,5,6,3,2,8,11,72.7,3,9,3,6,10,21,25,0,Ligue_1,2023_2024
Maghnes Akliouche,FRA,"MF,FW",Monaco,21,2002,17.9,37,23,12,20,5,12,36,33.3,24,21,0,21,9,46,3,0,Ligue_1,2023_2024
Paul Akouokou,CIV,MF,Lyon,25,1997,3.4,14,9,2,10,2,6,7,85.7,1,5,1,4,6,20,11,0,Ligue_1,2023_2024
Aboubacar Ali,FRA,"MF,FW",Strasbourg,17,2006,1.4,2,0,0,2,0,0,0,,0,1,0,1,1,3,2,0,Ligue_1,2023_2024
Mohamed Ali Cho,FRA,FW,Nice,19,2004,9.6,12,9,4,7,1,3,11,27.3,8,10,0,10,3,15,6,0,Ligue_1,2023_2024
Nabil Alioui,FRA,"MF,FW",Le Havre,24,1999,11.2,3,2,2,1,0,2,4,50.0,2,6,1,5,3,6,4,0,Ligue_1,2023_2024
Jim Allevinah,GAB,"MF,DF",Clermont Foot,28,1995,20.7,30,18,11,14,5,14,35,40.0,21,20,3,17,13,43,30,0,Ligue_1,2023_2024
Skelly Alvero,FRA,MF,Lyon,21,2002,4.7,8,7,5,2,1,2,9,22.2,7,5,1,4,2,10,5,0,Ligue_1,2023_2024
Papa Amadou Diallo,SEN,FW,Metz,19,2004,9.9,18,8,10,7,1,7,21,33.3,14,11,1,10,11,29,16,0,Ligue_1,2023_2024
Jordan Amavi,FRA,DF,Brest,29,1994,1.0,1,1,0,1,0,1,3,33.3,2,2,1,1,3,4,2,0,Ligue_1,2023_2024
Kelvin Amian,FRA,DF,Nantes,25,1998,8.9,16,7,12,4,0,11,15,73.3,4,6,0,6,7,23,28,0,Ligue_1,2023_2024
Michael Amir Murillo,PAN,DF,Marseille,27,1996,11.1,23,11,13,6,4,15,23,65.2,8,9,2,7,11,34,34,2,Ligue_1,2023_2024
Benjamin André,FRA,MF,Lille,32,1990,28.6,89,49,39,45,5,43,81,53.1,38,34,5,29,35,124,60,0,Ligue_1,2023_2024
Komnen Andrić,SRB,FW,Clermont Foot,28,1995,1.9,2,1,0,1,1,0,4,0.0,4,2,0,2,0,2,1,0,Ligue_1,2023_2024
Ângelo,BRA,"FW,MF",Strasbourg,18,2004,12.2,24,11,9,7,8,11,31,35.5,20,18,0,18,9,33,2,0,Ligue_1,2023_2024
Stredair Appuah,FRA,"FW,MF",Nantes,19,2004,0.9,0,0,0,0,0,0,3,0.0,3,0,0,0,1,1,1,0,Ligue_1,2023_2024
Yoël Armougom,FRA,"DF,MF",Clermont Foot,25,1998,2.6,3,3,2,0,1,2,3,66.7,1,1,0,1,1,4,3,0,Ligue_1,2023_2024
Hákon Arnar Haraldsson,ISL,"FW,MF",Lille,20,2003,14.3,12,8,4,7,1,5,21,23.8,16,7,2,5,3,15,5,0,Ligue_1,2023_2024
Mohamed El Arouch,FRA,FW,Lyon,19,2004,0.0,0,0,0,0,0,0,0,,0,0,0,0,0,0,0,0,Ligue_1,2023_2024
Marco Asensio,ESP,"MF,FW",Paris S-G,27,1996,12.4,12,10,4,7,1,4,13,30.8,9,7,0,7,5,17,2,0,Ligue_1,2023_2024
Joel Asoro,SWE,"FW,MF",Metz,24,1999,9.4,13,9,7,6,0,3,10,30.0,7,7,1,6,6,19,9,0,Ligue_1,2023_2024
Lorenz Assignon,TOG,DF,Rennes,23,2000,11.2,24,12,12,8,4,9,24,37.5,15,9,4,5,9,33,27,1,Ligue_1,2023_2024
Youcef Atal,ALG,DF,Nice,27,1996,4.0,9,3,6,2,1,6,8,75.0,2,7,1,6,4,13,1,0,Ligue_1,2023_2024
Valentin Atangana Edoa,FRA,MF,Reims,17,2005,6.2,19,13,6,9,4,5,13,38.5,8,5,1,4,6,25,9,0,Ligue_1,2023_2024
Arthur Atta,FRA,"MF,FW",Metz,20,2003,10.3,18,14,8,7,3,8,19,42.1,11,13,3,10,10,28,23,0,Ligue_1,2023_2024
Pierre-Emerick Aubameyang,GAB,FW,Marseille,34,1989,29.1,22,14,4,11,7,7,26,26.9,19,30,5,25,9,31,26,0,Ligue_1,2023_2024
André Ayew,GHA,FW,Le Havre,33,1989,12.3,15,11,7,6,2,6,9,66.7,3,8,3,5,2,17,11,0,Ligue_1,2023_2024
Neil El Aynaoui,FRA,MF,Lens,22,2001,17.4,37,20,13,20,4,20,46,43.5,26,20,6,14,32,69,21,1,Ligue_1,2023_2024
Abdellah Baallal,MAR,MF,Clermont Foot,18,2004,0.0,0,0,0,0,0,0,0,,0,1,0,1,0,0,0,0,Ligue_1,2023_2024
Shavy Babicka,GAB,"FW,MF",Toulouse,23,2000,4.1,11,8,2,7,2,2,5,40.0,3,6,1,5,0,11,2,0,Ligue_1,2023_2024
Tiemoué Bakayoko,FRA,MF,Lorient,28,1994,14.6,34,17,14,17,3,15,28,53.6,13,10,4,6,26,60,15,1,Ligue_1,2023_2024
Dilane Bakwa,FRA,"FW,MF",Strasbourg,20,2002,24.2,30,22,12,13,5,11,40,27.5,29,26,1,25,20,50,11,0,Ligue_1,2023_2024
Aliou Baldé,GUI,"FW,DF",Nice,20,2002,0.8,4,1,0,3,1,1,1,100.0,0,2,1,1,3,7,0,0,Ligue_1,2023_2024
Carlos Baleba,CMR,MF,Lille,19,2004,0.7,6,2,1,4,1,3,4,75.0,1,0,0,0,2,8,0,0,Ligue_1,2023_2024
Leonardo Balerdi,ARG,DF,Marseille,24,1999,25.2,79,50,55,23,1,49,67,73.1,18,38,15,23,51,130,91,0,Ligue_1,2023_2024
Folarin Balogun,USA,FW,Monaco,22,2001,18.8,12,4,3,8,1,5,13,38.5,8,10,0,10,3,15,4,0,Ligue_1,2023_2024
Mohamed Bamba,CIV,FW,Lorient,21,2001,12.6,14,9,3,8,3,4,10,40.0,6,7,1,6,2,16,3,0,Ligue_1,2023_2024
Mamady Bangré,BFA,"FW,MF",Toulouse,22,2001,1.1,4,2,2,2,0,3,4,75.0,1,0,0,0,4,8,3,0,Ligue_1,2023_2024
Bradley Barcola,FRA,FW,Lyon,20,2002,3.0,5,2,0,2,3,1,7,14.3,6,4,0,4,2,7,0,0,Ligue_1,2023_2024
Bradley Barcola,FRA,"FW,MF",Paris S-G,20,2002,15.2,34,16,12,13,9,7,25,28.0,18,27,2,25,10,44,13,1,Ligue_1,2023_2024
Melvin Bard,FRA,DF,Nice,22,2000,29.5,69,38,28,30,11,37,63,58.7,26,46,12,34,42,111,46,0,Ligue_1,2023_2024
Steven Baseya,FRA,DF,Strasbourg,18,2005,0.1,2,1,1,1,0,1,1,100.0,0,0,0,0,0,2,1,0,Ligue_1,2023_2024
Mohamed Bechikh,FRA,"FW,MF",Strasbourg,18,2005,0.2,0,0,0,0,0,0,0,,0,0,0,0,0,0,0,0,Ligue_1,2023_2024
Yanis Begraoui,MAR,"FW,MF",Toulouse,22,2001,3.3,5,3,1,3,1,3,9,33.3,6,4,0,4,5,10,5,0,Ligue_1,2023_2024
Jérémie Bela,ANG,"MF,FW",Clermont Foot,30,1993,2.3,1,1,0,1,0,1,3,33.3,2,1,0,1,0,1,1,0,Ligue_1,2023_2024
Reda Belahyane,FRA,MF,Nice,19,2004,0.3,1,0,0,1,0,1,1,100.0,0,0,0,0,0,1,0,0,Ligue_1,2023_2024
Alaa Bellaarouch,MAR,GK,Strasbourg,21,2002,15.0,0,0,0,0,0,0,0,,0,0,0,0,1,1,11,2,Ligue_1,2023_2024
Jean-Ricner Bellegarde,FRA,"MF,FW",Strasbourg,25,1998,3.0,5,3,3,2,0,3,6,50.0,3,4,0,4,4,9,0,0,Ligue_1,2023_2024
Jeanuël Belocian,FRA,DF,Rennes,18,2005,16.1,32,22,23,8,1,22,28,78.6,6,18,10,8,13,45,49,0,Ligue_1,2023_2024
Eliesse Ben Seghir,MAR,"MF,FW",Monaco,18,2005,4.8,9,6,2,5,2,3,7,42.9,4,6,0,6,2,11,2,0,Ligue_1,2023_2024
Wissam Ben Yedder,FRA,FW,Monaco,32,1990,25.7,4,3,1,2,1,1,11,9.1,10,18,0,18,8,12,1,0,Ligue_1,2023_2024
Saïd Benrahma,ALG,"FW,MF",Lyon,27,1995,8.6,9,7,1,6,2,5,7,71.4,2,7,0,7,1,10,3,0,Ligue_1,2023_2024
Nabil Bentaleb,ALG,MF,Lille,28,1994,21.9,49,32,29,18,2,22,43,51.2,21,33,12,21,37,86,33,0,Ligue_1,2023_2024
Lucas Beraldo,BRA,DF,Paris S-G,19,2003,11.2,22,14,14,8,0,10,25,40.0,15,15,6,9,20,42,25,0,Ligue_1,2023_2024
Dimitry Bertaud,COD,GK,Montpellier,25,1998,4.0,0,0,0,0,0,0,0,,0,0,0,0,0,0,0,0,Ligue_1,2023_2024
Marco Bizot,NED,GK,Brest,32,1991,32.0,0,0,0,0,0,0,1,0.0,1,0,0,0,0,0,18,3,Ligue_1,2023_2024
Rubén Blanco,ESP,GK,Marseille,28,1995,1.3,0,0,0,0,0,0,0,,0,0,0,0,0,0,0,0,Ligue_1,2023_2024
Ludovic Blas,FRA,"FW,MF",Rennes,25,1997,17.4,30,14,16,13,1,12,28,42.9,16,13,1,12,6,36,9,0,Ligue_1,2023_2024
Myron Boadu,NED,FW,Monaco,22,2001,0.9,2,2,0,1,1,1,2,50.0,1,2,0,2,0,2,0,0,Ligue_1,2023_2024
Jeremie Boga,CIV,FW,Nice,26,1997,22.2,18,7,6,10,2,10,20,50.0,10,26,2,24,8,26,4,0,Ligue_1,2023_2024
Adama Bojang,GAM,FW,Reims,19,2004,0.9,2,1,1,0,1,0,0,,0,2,1,1,1,3,0,0,Ligue_1,2023_2024
Neto Borges,BRA,DF,Clermont Foot,26,1996,28.0,48,24,25,18,5,28,63,44.4,35,28,6,22,57,105,84,0,Ligue_1,2023_2024
Saïmon Bouabré,FRA,MF,Monaco,17,2006,0.5,2,2,0,2,0,1,2,50.0,1,1,0,1,0,2,0,0,Ligue_1,2023_2024
Ayyoub Bouaddi,FRA,MF,Lille,15,2007,1.5,6,2,6,0,0,2,5,40.0,3,2,0,2,1,7,3,0,Ligue_1,2023_2024
Badredine Bouanani,ALG,FW,Nice,18,2004,1.8,3,2,1,1,1,3,4,75.0,1,5,0,5,3,6,0,0,Ligue_1,2023_2024
Badredine Bouanani,ALG,MF,Lorient,18,2004,4.9,4,2,1,1,2,2,4,50.0,2,3,0,3,2,6,3,0,Ligue_1,2023_2024
Mohamed Bouchenna,FRA,"MF,FW",Clermont Foot,17,2006,0.3,1,0,1,0,0,0,0,,0,0,0,0,0,1,0,0,Ligue_1,2023_2024
Hicham Boudaoui,ALG,MF,Nice,23,1999,17.9,41,19,16,22,3,21,30,70.0,9,15,1,14,11,52,15,0,Ligue_1,2023_2024
Benjamin Bourigeaud,FRA,"MF,FW",Rennes,29,1994,26.9,31,18,14,9,8,13,44,29.5,31,31,2,29,22,53,39,2,Ligue_1,2023_2024
Bilal Boutobba,FRA,"FW,MF",Clermont Foot,24,1998,10.3,22,12,6,10,6,10,23,43.5,13,9,0,9,8,30,3,0,Ligue_1,2023_2024
Hugo Boutsingkham,FRA,"MF,FW",Nantes,20,2003,0.1,0,0,0,0,0,0,0,,0,0,0,0,0,0,1,0,Ligue_1,2023_2024
Bilal Brahimi,ALG,FW,Nice,23,2000,0.1,0,0,0,0,0,0,1,0.0,1,0,0,0,0,0,0,0,Ligue_1,2023_2024
Bilal Brahimi,ALG,"FW,MF",Brest,23,2000,2.5,0,0,0,0,0,0,3,0.0,3,3,0,3,0,0,0,0,Ligue_1,2023_2024
Lilian Brassier,FRA,DF,Brest,23,1999,29.7,31,18,18,13,0,12,24,50.0,12,28,21,7,41,72,93,0,Ligue_1,2023_2024
Maxime Busi,BEL,"FW,DF",Reims,23,1999,1.8,2,0,0,1,1,0,2,0.0,2,6,1,5,4,6,5,0,Ligue_1,2023_2024
Marcin Bułka,POL,GK,Nice,23,1999,34.0,0,0,0,0,0,0,2,0.0,2,0,0,0,0,0,9,3,Ligue_1,2023_2024
Rémy Cabella,FRA,"FW,MF",Lille,33,1990,16.4,54,36,19,20,15,20,54,37.0,34,32,0,32,5,59,5,0,Ligue_1,2023_2024
Duje Ćaleta-Car,CRO,DF,Lyon,26,1996,22.1,26,11,19,6,1,18,22,81.8,4,27,14,13,18,44,94,1,Ligue_1,2023_2024
Lamine Camara,SEN,MF,Metz,19,2004,25.1,62,42,26,30,6,24,49,49.0,25,35,2,33,28,90,34,0,Ligue_1,2023_2024
Mahdi Camara,FRA,MF,Brest,25,1998,22.4,55,39,8,40,7,20,49,40.8,29,24,1,23,27,82,19,0,Ligue_1,2023_2024
Mohamed Camara,MLI,MF,Monaco,23,2000,11.5,35,21,10,20,5,15,29,51.7,14,8,2,6,11,46,7,0,Ligue_1,2023_2024
Axel Camblan,FRA,FW,Brest,19,2003,1.0,3,1,0,2,1,2,4,50.0,2,2,0,2,0,3,0,0,Ligue_1,2023_2024
Fali Candé,GNB,DF,Metz,25,1998,20.5,40,19,31,9,0,20,35,57.1,15,41,28,13,20,60,107,1,Ligue_1,2023_2024
Gino Caoki,FRA,MF,Lorient,19,2004,0.1,0,0,0,0,0,0,1,0.0,1,0,0,0,0,0,0,0,Ligue_1,2023_2024
Maxence Caqueret,FRA,MF,Lyon,23,2000,33.6,91,64,39,37,15,38,107,35.5,69,40,9,31,48,139,26,2,Ligue_1,2023_2024
Igor Carioca,BRA,"DF,MF",Lorient,26,1996,2.9,8,6,6,1,1,4,6,66.7,2,0,0,0,3,11,6,0,Ligue_1,2023_2024
Antonin Cartillier,FRA,DF,Monaco,19,2004,0.1,0,0,0,0,0,0,0,,0,1,0,1,0,0,0,0,Ligue_1,2023_2024
Josué Casimir,FRA,"FW,DF",Le Havre,21,2001,22.4,31,18,14,14,3,7,18,38.9,11,23,2,21,13,44,25,0,Ligue_1,2023_2024
Cristian Cásseres Jr.,VEN,MF,Toulouse,23,2000,21.6,70,34,31,33,6,29,61,47.5,32,34,4,30,27,97,33,1,Ligue_1,2023_2024
Jean-Charles Castelletto,CMR,DF,Nantes,28,1995,27.4,34,26,22,10,2,18,29,62.1,11,19,10,9,32,66,81,0,Ligue_1,2023_2024
Maximiliano Caufriez,BEL,DF,Clermont Foot,26,1997,18.4,38,28,31,5,2,19,29,65.5,10,18,12,6,18,56,69,2,Ligue_1,2023_2024
Ivan Cavaleiro,POR,FW,Lille,29,1993,8.6,10,6,3,4,3,7,20,35.0,13,9,2,7,5,15,6,0,Ligue_1,2023_2024
Fabien Centonze,FRA,DF,Nantes,27,1996,1.0,2,1,2,0,0,2,3,66.7,1,2,1,1,0,2,1,0,Ligue_1,2023_2024
Fares Chaïbi,ALG,"FW,MF",Toulouse,20,2002,0.6,0,0,0,0,0,0,0,,0,0,0,0,0,0,2,0,Ligue_1,2023_2024
Muhammed Cham,AUT,"MF,FW",Clermont Foot,22,2000,28.4,25,14,10,13,2,11,27,40.7,16,20,2,18,8,33,5,1,Ligue_1,2023_2024
Brendan Chardonnet,FRA,DF,Brest,28,1994,33.0,57,34,33,22,2,32,63,50.8,31,58,34,24,53,110,139,3,Ligue_1,2023_2024
Jhoanner Chávez,ECU,DF,Lens,21,2002,5.3,6,5,2,2,2,3,9,33.3,6,2,0,2,5,11,11,0,Ligue_1,2023_2024
Rayan Cherki,FRA,"MF,FW",Lyon,19,2003,19.1,28,15,4,16,8,17,46,37.0,29,13,3,10,7,35,1,0,Ligue_1,2023_2024
Lucas Chevalier,FRA,GK,Lille,21,2001,33.0,3,0,3,0,0,3,4,75.0,1,1,0,1,0,3,11,2,Ligue_1,2023_2024
Pedro Chirivella,ESP,MF,Nantes,26,1997,28.8,50,28,20,29,1,30,76,39.5,46,22,5,17,31,81,28,0,Ligue_1,2023_2024
Joris Chotard,FRA,MF,Montpellier,21,2001,28.7,81,52,45,25,11,48,96,50.0,48,47,21,26,44,125,60,0,Ligue_1,2023_2024
Djaoui Cissé,FRA,MF,Rennes,19,2004,0.0,0,0,0,0,0,0,0,,0,0,0,0,0,0,0,0,Ligue_1,2023_2024
Ibrahim Cissoko,NED,"FW,MF",Toulouse,20,2003,2.7,4,3,3,1,0,1,3,33.3,2,3,0,3,1,5,0,0,Ligue_1,2023_2024
Alexis Claude-Maurice,FRA,MF,Nice,25,1998,5.6,12,5,3,6,3,1,5,20.0,4,4,1,3,5,17,7,0,Ligue_1,2023_2024
Jonathan Clauss,FRA,DF,Marseille,30,1992,23.0,47,20,22,19,6,26,49,53.1,23,17,3,14,36,83,46,0,Ligue_1,2023_2024
Marcus Coco,FRA,"DF,FW",Nantes,27,1996,16.5,43,26,29,10,4,28,60,46.7,32,19,1,18,21,64,38,0,Ligue_1,2023_2024
Maxime Colin,FRA,DF,Metz,31,1991,20.4,39,23,25,7,7,16,29,55.2,13,22,7,15,20,59,71,0,Ligue_1,2023_2024
Eray Cömert,SUI,DF,Nantes,25,1998,22.2,42,28,28,13,1,28,38,73.7,10,35,18,17,36,78,77,1,Ligue_1,2023_2024
Alois Confais,FRA,"MF,FW",Le Havre,26,1996,0.1,2,2,1,1,0,1,1,100.0,0,0,0,0,0,2,0,0,Ligue_1,2023_2024
Joaquín Correa,ARG,"FW,MF",Marseille,28,1994,4.8,7,5,4,2,1,0,8,0.0,8,2,0,2,1,8,1,0,Ligue_1,2023_2024
Oscar Cortés,COL,"FW,MF",Lens,19,2003,0.5,0,0,0,0,0,0,0,,0,1,0,1,0,0,0,0,Ligue_1,2023_2024
David Costa,POR,MF,Lens,22,2001,16.6,18,10,5,12,1,10,23,43.5,13,21,4,17,16,34,8,1,Ligue_1,2023_2024
Logan Costa,CPV,DF,Toulouse,22,2001,29.4,40,24,31,9,0,15,24,62.5,9,42,27,15,23,63,120,1,Ligue_1,2023_2024
Grégoire Coudert,FRA,GK,Brest,24,1999,2.0,0,0,0,0,0,0,0,,0,0,0,0,0,0,0,0,Ligue_1,2023_2024
Mamadou Coulibaly,FRA,MF,Monaco,19,2004,1.3,7,4,2,3,2,3,8,37.5,5,4,0,4,0,7,0,0,Ligue_1,2023_2024
Tanguy Coulibaly,FRA,"FW,MF",Montpellier,22,2001,6.9,13,11,8,4,1,4,9,44.4,5,11,1,10,2,15,2,0,Ligue_1,2023_2024
Nicolas Cozza,FRA,DF,Nantes,24,1999,9.9,35,23,23,10,2,17,24,70.8,7,7,0,7,14,49,32,0,Ligue_1,2023_2024
Trévis Dago,CIV,"FW,MF",Lille,18,2005,0.3,0,0,0,0,0,0,0,,0,0,0,0,1,1,0,0,Ligue_1,2023_2024
Thijs Dallinga,NED,FW,Toulouse,22,2000,27.9,29,15,6,11,12,9,15,60.0,6,11,4,7,3,32,35,0,Ligue_1,2023_2024
Kevin Danso,AUT,DF,Lens,24,1998,29.5,24,14,12,11,1,15,30,50.0,15,43,30,13,23,47,115,1,Ligue_1,2023_2024
Dante,BRA,DF,Nice,39,1983,31.6,62,30,44,16,2,38,52,73.1,14,43,22,21,37,99,77,2,Ligue_1,2023_2024
Raimane Daou,COM,"DF,MF",Marseille,18,2004,0.3,1,1,1,0,0,1,2,50.0,1,0,0,0,0,1,2,0,Ligue_1,2023_2024
Mohammed Daramy,DEN,"FW,MF",Reims,21,2002,18.3,10,9,4,4,2,6,16,37.5,10,5,1,4,4,14,4,0,Ligue_1,2023_2024
Achraf Dari,MAR,"DF,FW",Brest,24,1999,1.3,1,1,1,0,0,0,2,0.0,2,2,0,2,5,6,9,1,Ligue_1,2023_2024
Jonathan David,CAN,FW,Lille,23,2000,29.2,26,15,6,13,7,8,26,30.8,18,16,0,16,9,35,4,0,Ligue_1,2023_2024
Thibault De Smet,BEL,DF,Reims,25,1998,20.3,56,35,36,16,4,33,59,55.9,26,25,5,20,21,77,51,1,Ligue_1,2023_2024
Romain Del Castillo,FRA,FW,Brest,27,1996,27.7,46,29,14,18,14,18,70,25.7,52,33,1,32,9,55,8,0,Ligue_1,2023_2024
Thomas Delaine,FRA,"DF,MF",Strasbourg,31,1992,22.7,38,19,29,8,1,20,42,47.6,22,18,2,16,17,55,51,0,Ligue_1,2023_2024
Sacha Delaye,FRA,"MF,FW",Montpellier,21,2002,1.4,7,2,2,2,3,1,6,16.7,5,2,0,2,0,7,1,0,Ligue_1,2023_2024
Karamoko Dembélé,ENG,"MF,FW",Brest,20,2003,0.2,0,0,0,0,0,0,0,,0,0,0,0,0,0,0,0,Ligue_1,2023_2024
Ousmane Dembélé,FRA,"MF,FW",Paris S-G,26,1997,16.7,19,14,2,7,10,6,13,46.2,7,11,0,11,5,24,4,1,Ligue_1,2023_2024
Jessy Deminguet,FRA,"MF,FW",Strasbourg,25,1998,7.7,14,9,6,8,0,6,18,33.3,12,8,0,8,9,23,5,1,Ligue_1,2023_2024
Rémy Descamps,FRA,GK,Nantes,27,1996,6.0,0,0,0,0,0,0,0,,0,0,0,0,0,0,7,0,Ligue_1,2023_2024
Mikkel Desler,DEN,DF,Toulouse,28,1995,17.2,18,12,8,7,3,9,17,52.9,8,32,13,19,19,37,38,0,Ligue_1,2023_2024
Arthur Desmas,FRA,GK,Le Havre,29,1994,33.0,0,0,0,0,0,0,2,0.0,2,0,0,0,0,0,13,1,Ligue_1,2023_2024
Lamine Diack,SEN,MF,Nantes,22,2000,0.0,0,0,0,0,0,0,0,,0,0,0,0,0,0,0,0,Ligue_1,2023_2024
Mamadou Diakhon,FRA,"FW,MF",Reims,17,2005,2.3,5,3,2,1,2,3,9,33.3,6,1,0,1,1,6,1,0,Ligue_1,2023_2024
Bafodé Diakité,FRA,DF,Lille,22,2001,18.8,29,20,12,15,2,24,32,75.0,8,16,8,8,21,50,49,1,Ligue_1,2023_2024
Ibrahim Diakité,GUI,DF,Reims,19,2003,1.2,1,0,0,1,0,0,1,0.0,1,3,0,3,2,3,5,0,Ligue_1,2023_2024
Oumar Diakité,CIV,FW,Reims,19,2003,17.6,25,12,10,9,6,7,21,33.3,14,13,0,13,7,32,7,0,Ligue_1,2023_2024
Habib Diarra,SEN,"MF,FW",Strasbourg,19,2004,25.6,30,23,8,20,2,9,33,27.3,24,23,4,19,17,47,15,0,Ligue_1,2023_2024
Moussa Diarra,MLI,DF,Toulouse,22,2000,15.5,32,12,16,15,1,13,27,48.1,14,30,14,16,20,52,43,0,Ligue_1,2023_2024
Krépin Diatta,SEN,"DF,FW",Monaco,24,1999,13.4,37,20,17,16,4,27,49,55.1,22,17,2,15,16,53,22,0,Ligue_1,2023_2024
Mory Diaw,SEN,GK,Clermont Foot,30,1993,30.0,1,1,1,0,0,1,2,50.0,1,0,0,0,1,2,13,5,Ligue_1,2023_2024
Mahamadou Diawara,FRA,MF,Lyon,18,2005,4.0,9,6,4,5,0,3,11,27.3,8,4,1,3,4,13,4,0,Ligue_1,2023_2024
Bamba Dieng,SEN,FW,Lorient,23,2000,6.1,3,3,0,3,0,1,3,33.3,2,3,0,3,0,3,7,0,Ligue_1,2023_2024
Guillaume Dietsch,FRA,GK,Metz,22,2001,0.8,0,0,0,0,0,0,0,,0,0,0,0,0,0,0,0,Ligue_1,2023_2024
Sinaly Diomande,CIV,DF,Lyon,22,2001,9.9,10,4,5,3,2,9,16,56.3,7,12,9,3,15,25,26,1,Ligue_1,2023_2024
Edan Diop,FRA,"MF,DF",Monaco,18,2004,1.8,10,8,6,3,1,7,9,77.8,2,3,0,3,1,11,5,0,Ligue_1,2023_2024
Sofiane Diop,FRA,FW,Nice,23,2000,5.5,8,6,3,4,1,4,10,40.0,6,4,0,4,3,11,3,0,Ligue_1,2023_2024
Andy Diouf,FRA,MF,Lens,20,2003,14.6,28,19,12,11,5,14,22,63.6,8,13,3,10,3,31,5,1,Ligue_1,2023_2024
Yehvann Diouf,FRA,GK,Reims,23,1999,34.0,0,0,0,0,0,0,1,0.0,1,0,0,0,1,1,19,3,Ligue_1,2023_2024
Chaim El Djebali,TUN,MF,Lyon,19,2004,0.1,0,0,0,0,0,0,0,,0,0,0,0,0,0,0,0,Ligue_1,2023_2024
Jeremy Doku,BEL,FW,Rennes,21,2002,1.2,2,2,1,0,1,1,1,100.0,0,0,0,0,0,2,0,0,Ligue_1,2023_2024
Gianluigi Donnarumma,ITA,GK,Paris S-G,24,1999,24.1,0,0,0,0,0,0,0,,0,0,0,0,1,1,9,4,Ligue_1,2023_2024
Siriné Doucouré,MLI,FW,Lorient,21,2002,4.7,8,6,0,4,4,3,3,100.0,0,4,0,4,1,9,6,0,Ligue_1,2023_2024
Désiré Doué,FRA,"MF,FW",Rennes,18,2005,18.1,32,18,11,14,7,10,33,30.3,23,30,1,29,14,46,8,0,Ligue_1,2023_2024
Guela Doué,CIV,DF,Rennes,20,2002,13.7,28,21,14,12,2,22,32,68.8,10,12,1,11,15,43,65,1,Ligue_1,2023_2024
Douglas,BRA,MF,Nantes,26,1997,19.7,70,42,34,30,6,30,59,50.8,29,22,8,14,26,96,30,0,Ligue_1,2023_2024
Ismaël Doukouré,FRA,"MF,DF",Strasbourg,20,2003,18.4,23,16,7,14,2,13,21,61.9,8,19,7,12,19,42,29,2,Ligue_1,2023_2024
Kamory Doumbia,MLI,MF,Brest,20,2003,9.8,28,18,8,10,10,10,29,34.5,19,14,0,14,9,37,6,0,Ligue_1,2023_2024
Jean-Kevin Duverne,HAI,DF,Nantes,26,1997,15.0,37,19,16,17,4,18,44,40.9,26,17,5,12,18,55,34,0,Ligue_1,2023_2024
Aron Dønnum,NOR,"FW,MF",Toulouse,25,1998,17.7,16,10,3,8,5,7,22,31.8,15,13,0,13,8,24,16,1,Ligue_1,2023_2024
Simon Ebonog,CMR,MF,Le Havre,18,2004,0.2,1,1,0,1,0,1,1,100.0,0,1,1,0,0,1,1,0,Ligue_1,2023_2024
Hugo Ekitike,FRA,FW,Paris S-G,21,2002,0.1,0,0,0,0,0,0,0,,0,0,0,0,0,0,0,0,Ligue_1,2023_2024
Simon Elisor,FRA,FW,Metz,24,1999,8.5,9,2,3,2,4,2,6,33.3,4,6,1,5,0,9,9,0,Ligue_1,2023_2024
Breel Embolo,SUI,FW,Monaco,26,1997,2.0,3,3,0,2,1,1,4,25.0,3,1,0,1,1,4,2,0,Ligue_1,2023_2024
Emanuel Emegha,NED,FW,Strasbourg,20,2003,23.1,8,5,2,4,2,4,9,44.4,5,13,3,10,2,10,25,0,Ligue_1,2023_2024
Maxime Estève,FRA,DF,Montpellier,21,2002,11.1,16,12,11,5,0,10,15,66.7,5,13,9,4,18,34,50,0,Ligue_1,2023_2024
Oscar Estupiñan,COL,FW,Metz,26,1996,2.9,5,4,0,3,2,1,2,50.0,1,2,0,2,0,5,0,0,Ligue_1,2023_2024
Romain Faivre,FRA,"MF,FW",Lorient,25,1998,16.1,13,6,5,4,4,6,15,40.0,9,6,1,5,7,20,3,1,Ligue_1,2023_2024
Ilhan Fakili,FRA,"MF,FW",Clermont Foot,17,2006,1.0,0,0,0,0,0,0,1,0.0,1,1,0,1,1,1,0,0,Ligue_1,2023_2024
Khalil Fayad,FRA,"FW,MF",Montpellier,19,2004,11.4,28,15,17,7,4,9,22,40.9,13,15,3,12,14,42,6,0,Ligue_1,2023_2024
Ichem Ferrah,FRA,FW,Lille,17,2005,0.0,0,0,0,0,0,0,0,,0,0,0,0,0,0,0,0,Ligue_1,2023_2024
Jordan Ferri,FRA,MF,Montpellier,31,1992,22.6,36,22,16,17,3,20,67,29.9,47,19,1,18,13,49,23,0,Ligue_1,2023_2024
Malick Fofana,BEL,FW,Lyon,18,2005,6.2,5,4,3,1,1,4,9,44.4,5,3,0,3,5,10,9,0,Ligue_1,2023_2024
Youssouf Fofana,FRA,MF,Monaco,24,1999,30.0,61,39,19,36,6,30,66,45.5,36,35,7,28,37,98,31,1,Ligue_1,2023_2024
Thomas Foket,BEL,DF,Reims,28,1994,20.4,32,17,21,8,3,20,45,44.4,25,34,12,22,25,57,36,0,Ligue_1,2023_2024
Tiago Fonseca Morais,POR,FW,Lille,19,2003,0.5,1,1,0,1,0,0,0,,0,0,0,0,1,2,0,0,Ligue_1,2023_2024
Przemysław Frankowski,POL,DF,Lens,28,1995,24.4,60,39,25,26,9,31,74,41.9,43,30,7,23,25,85,36,0,Ligue_1,2023_2024
Angelo Fulgini,FRA,MF,Lens,26,1996,15.3,23,14,6,13,4,11,19,57.9,8,22,1,21,8,31,11,0,Ligue_1,2023_2024
Kévin Gameiro,FRA,"FW,MF",Strasbourg,36,1987,15.0,10,10,5,3,2,2,17,11.8,15,9,0,9,3,13,7,0,Ligue_1,2023_2024
Ignatius Ganago,CMR,"FW,MF",Nantes,24,1999,2.0,0,0,0,0,0,0,1,0.0,1,1,0,1,1,1,1,0,Ligue_1,2023_2024
Ulisses Garcia,SUI,DF,Marseille,27,1996,10.1,21,16,6,13,2,13,20,65.0,7,8,3,5,7,28,13,2,Ligue_1,2023_2024
Johan Gastien,FRA,MF,Clermont Foot,35,1988,25.1,43,22,18,21,4,23,81,28.4,58,31,9,22,36,79,24,4,Ligue_1,2023_2024
Yann Gboho,FRA,"MF,FW",Toulouse,22,2001,13.3,14,4,6,6,2,8,23,34.8,15,21,1,20,4,18,2,0,Ligue_1,2023_2024
Gelabert,ESP,"MF,FW",Toulouse,22,2000,8.4,14,8,5,6,3,7,20,35.0,13,8,2,6,5,19,8,0,Ligue_1,2023_2024
Denis Genreau,AUS,"MF,FW",Toulouse,24,1999,5.2,12,9,6,6,0,8,15,53.3,7,8,1,7,6,18,8,0,Ligue_1,2023_2024
Samuel Gigot,FRA,DF,Marseille,29,1993,19.2,33,22,16,13,4,13,19,68.4,6,28,18,10,25,58,93,1,Ligue_1,2023_2024
Aleksandr Golovin,RUS,"MF,FW",Monaco,27,1996,23.9,42,30,14,22,6,15,42,35.7,27,37,3,34,21,63,14,0,Ligue_1,2023_2024
Angel Gomes,ENG,MF,Lille,22,2000,28.6,26,13,4,15,7,14,32,43.8,18,23,6,17,18,44,28,1,Ligue_1,2023_2024
Maxime Gonalons,FRA,MF,Clermont Foot,34,1989,14.4,47,33,14,27,6,25,57,43.9,32,18,3,15,20,67,11,0,Ligue_1,2023_2024
Mathieu Gorgelin,FRA,GK,Le Havre,32,1990,1.0,0,0,0,0,0,0,0,,0,0,0,0,0,0,0,0,Ligue_1,2023_2024
Amine Gouiri,ALG,"FW,MF",Rennes,23,2000,23.0,20,10,4,11,5,8,19,42.1,11,18,1,17,14,34,12,0,Ligue_1,2023_2024
Jonathan Gradit,FRA,DF,Lens,30,1992,23.5,32,20,15,14,3,19,35,54.3,16,30,17,13,37,69,61,0,Ligue_1,2023_2024
Samuel Grandsir,FRA,"MF,FW",Le Havre,26,1996,6.7,16,12,5,9,2,8,18,44.4,10,4,0,4,3,19,3,1,Ligue_1,2023_2024
Adrian Grbić,AUT,FW,Lorient,26,1996,0.3,0,0,0,0,0,0,0,,0,0,0,0,0,0,0,0,Ligue_1,2023_2024
Gabriel Gudmundsson,SWE,"DF,FW",Lille,24,1999,14.1,22,16,7,13,2,12,20,60.0,8,14,3,11,15,37,25,0,Ligue_1,2023_2024
Axel Gueguin,FRA,"DF,FW",Montpellier,18,2005,1.5,9,5,6,2,1,2,6,33.3,4,2,0,2,2,11,6,0,Ligue_1,2023_2024
Mattéo Guendouzi,FRA,MF,Marseille,24,1999,0.2,0,0,0,0,0,0,0,,0,1,1,0,0,0,0,0,Ligue_1,2023_2024
Evann Guessand,CIV,FW,Nice,22,2001,17.3,16,7,2,7,7,6,7,85.7,1,12,1,11,12,28,7,0,Ligue_1,2023_2024
Pape Gueye,SEN,"MF,DF",Marseille,24,1999,8.5,33,21,11,19,3,13,19,68.4,6,17,3,14,13,46,12,0,Ligue_1,2023_2024
Morgan Guilavogui,GUI,"FW,MF",Lens,25,1998,6.3,21,10,4,12,5,5,11,45.5,6,11,2,9,4,25,7,0,Ligue_1,2023_2024
Frederic Guilbert,FRA,"DF,MF",Strasbourg,28,1994,27.7,87,50,49,30,8,47,72,65.3,25,39,10,29,71,158,99,1,Ligue_1,2023_2024
Jaouen Hadjam,ALG,DF,Nantes,20,2003,1.2,6,4,5,1,0,1,2,50.0,1,0,0,0,3,9,2,0,Ligue_1,2023_2024
Massadio Haïdara,MLI,DF,Lens,30,1992,8.2,9,8,5,3,1,4,6,66.7,2,7,2,5,11,20,32,3,Ligue_1,2023_2024
Oualid El Hajjam,MAR,"DF,MF",Le Havre,32,1991,4.4,8,7,5,2,1,2,9,22.2,7,5,1,4,6,14,10,0,Ligue_1,2023_2024
Achraf Hakimi,MAR,DF,Paris S-G,24,1998,21.5,29,19,14,9,6,17,34,50.0,17,28,4,24,12,41,28,2,Ligue_1,2023_2024
Amine Harit,MAR,"MF,FW",Marseille,26,1997,20.2,28,16,8,17,3,13,37,35.1,24,31,4,27,12,40,4,0,Ligue_1,2023_2024
Silvan Hefti,SUI,"DF,FW",Montpellier,25,1997,7.9,21,15,10,7,4,15,29,51.7,14,7,2,5,8,29,11,0,Ligue_1,2023_2024
Henrique,BRA,DF,Lyon,29,1994,6.7,10,6,6,4,0,6,11,54.5,5,8,2,6,10,20,3,0,Ligue_1,2023_2024
Luis Henrique,BRA,"FW,DF",Marseille,21,2001,8.7,8,7,4,1,3,4,7,57.1,3,9,0,9,8,16,3,0,Ligue_1,2023_2024
Christophe Hérelle,MTQ,DF,Metz,30,1992,18.0,32,15,24,7,1,13,23,56.5,10,16,9,7,18,50,68,2,Ligue_1,2023_2024
Lucas Hernández,FRA,DF,Paris S-G,27,1996,21.2,52,36,28,15,9,29,50,58.0,21,21,5,16,27,79,38,0,Ligue_1,2023_2024
Andrej Ilic,SRB,FW,Lille,23,2000,0.1,0,0,0,0,0,0,0,,0,0,0,0,0,0,0,0,Ligue_1,2023_2024
Bonke Innocent,NGA,MF,Lorient,27,1996,2.3,6,4,2,2,2,2,9,22.2,7,2,1,1,4,10,2,0,Ligue_1,2023_2024
Ismaily,BRA,DF,Lille,33,1990,27.4,72,47,34,25,13,31,60,51.7,29,33,6,27,32,104,77,0,Ligue_1,2023_2024
Yanis Issoufou,FRA,MF,Montpellier,16,2006,0.1,0,0,0,0,0,0,0,,0,0,0,0,0,0,0,0,Ligue_1,2023_2024
Junya Ito,JPN,"FW,MF",Reims,30,1993,30.2,33,15,11,14,8,10,36,27.8,26,23,1,22,14,47,7,0,Ligue_1,2023_2024
Jérémy Jacquet,FRA,MF,Rennes,18,2005,0.1,1,1,1,0,0,0,1,0.0,1,0,0,0,1,2,0,0,Ligue_1,2023_2024
Jérémy Jacquet,FRA,DF,Clermont Foot,18,2005,2.8,4,3,4,0,0,3,3,100.0,0,7,3,4,6,10,10,0,Ligue_1,2023_2024
Ismail Jakobs,SEN,DF,Monaco,23,1999,16.3,57,41,27,21,9,29,47,61.7,18,19,2,17,11,68,40,0,Ligue_1,2023_2024
Ablie Jallow,GAM,"MF,FW",Metz,24,1998,10.2,8,5,2,3,3,3,5,60.0,2,4,0,4,8,16,3,0,Ligue_1,2023_2024
Danley Jean-Jacques,HAI,MF,Metz,23,2000,29.8,54,28,24,21,9,19,56,33.9,37,48,7,41,44,98,44,0,Ligue_1,2023_2024
Jeffinho,BRA,"FW,MF",Lyon,23,1999,3.4,11,4,3,5,3,4,11,36.4,7,1,0,1,0,11,0,0,Ligue_1,2023_2024
Antoine Joujou,FRA,"FW,MF",Le Havre,20,2003,8.7,20,12,7,7,6,11,21,52.4,10,11,2,9,7,27,5,0,Ligue_1,2023_2024
Christopher Jullien,FRA,DF,Montpellier,30,1993,13.7,16,12,11,5,0,6,17,35.3,11,25,20,5,12,28,106,2,Ligue_1,2023_2024
Eli Junior Kroupi,FRA,"FW,MF",Lorient,17,2006,12.0,7,4,2,2,3,1,9,11.1,8,6,0,6,10,17,5,0,Ligue_1,2023_2024
Abdoul Kader Bamba,FRA,"FW,MF",Nantes,29,1994,6.8,10,7,2,5,3,5,15,33.3,10,4,0,4,4,14,4,1,Ligue_1,2023_2024
Yaya Kader Fofana,MLI,"MF,DF",Reims,19,2004,0.4,3,3,1,1,1,0,1,0.0,1,0,0,0,1,4,0,0,Ligue_1,2023_2024
Tino Kadewere,ZIM,"FW,MF",Lyon,27,1996,3.3,1,1,0,1,0,1,5,20.0,4,3,1,2,5,6,7,0,Ligue_1,2023_2024
Tino Kadewere,ZIM,"FW,MF",Nantes,27,1996,8.7,9,4,3,3,3,6,11,54.5,5,10,1,9,10,19,8,0,Ligue_1,2023_2024
Arnaud Kalimuendo,FRA,FW,Rennes,21,2002,23.8,5,4,2,2,1,2,5,40.0,3,13,2,11,4,9,4,0,Ligue_1,2023_2024
Gedeon Kalulu,COD,DF,Lorient,25,1997,10.8,23,17,13,8,2,12,22,54.5,10,18,2,16,5,28,30,0,Ligue_1,2023_2024
Waren Kamanzi,NOR,"DF,FW",Toulouse,22,2000,13.2,36,24,16,16,4,13,23,56.5,10,11,3,8,9,45,35,0,Ligue_1,2023_2024
Lee Kang-in,KOR,"FW,MF",Paris S-G,22,2001,16.3,26,13,7,9,10,15,36,41.7,21,7,0,7,6,32,3,0,Ligue_1,2023_2024
Yann Karamoh,FRA,"FW,MF",Montpellier,25,1998,3.2,1,0,0,0,1,1,2,50.0,1,3,0,3,0,1,0,0,Ligue_1,2023_2024
Ayman Kari,FRA,MF,Lorient,18,2004,9.9,18,14,9,9,0,12,19,63.2,7,19,2,17,6,24,9,1,Ligue_1,2023_2024
Panos Katseris,GRE,DF,Lorient,22,2001,11.6,26,20,16,8,2,16,25,64.0,9,20,4,16,8,34,18,0,Ligue_1,2023_2024
Kévin Keben Biakolo,CMR,DF,Toulouse,19,2004,5.8,4,2,4,0,0,3,6,50.0,3,7,0,7,8,12,17,0,Ligue_1,2023_2024
Yassine Kechta,MAR,MF,Le Havre,21,2002,20.5,46,24,24,19,3,31,73,42.5,42,20,3,17,23,69,16,1,Ligue_1,2023_2024
Thilo Kehrer,GER,DF,Monaco,26,1996,14.7,32,22,22,7,3,22,39,56.4,17,18,6,12,30,62,55,0,Ligue_1,2023_2024
Habib Keita,MLI,MF,Clermont Foot,21,2002,14.2,34,19,14,15,5,17,28,60.7,11,27,10,17,29,63,30,0,Ligue_1,2023_2024
Reda Khadra,GER,"FW,MF",Reims,22,2001,15.2,16,10,5,4,7,8,20,40.0,12,8,2,6,3,19,13,0,Ligue_1,2023_2024
Wahbi Khazri,TUN,FW,Montpellier,32,1991,12.6,24,17,8,12,4,14,35,40.0,21,10,0,10,3,27,7,0,Ligue_1,2023_2024
Abdukodir Khusanov,UZB,DF,Lens,19,2004,9.0,21,12,13,8,0,9,17,52.9,8,13,8,5,13,34,32,2,Ligue_1,2023_2024
Philipp Köhn,SUI,GK,Monaco,25,1998,22.0,1,1,1,0,0,1,1,100.0,0,0,0,0,1,2,5,3,Ligue_1,2023_2024
Randal Kolo Muani,FRA,"FW,MF",Paris S-G,24,1998,14.1,10,8,5,3,2,5,13,38.5,8,5,0,5,4,14,10,0,Ligue_1,2023_2024
Cheick Konaté,MLI,DF,Clermont Foot,19,2004,11.9,26,15,17,9,0,20,36,55.6,16,16,2,14,13,39,21,0,Ligue_1,2023_2024
Geoffrey Kondogbia,CTA,MF,Marseille,30,1993,16.3,48,31,18,25,5,13,32,40.6,19,21,4,17,30,78,25,0,Ligue_1,2023_2024
Abdoul Koné,FRA,DF,Reims,18,2005,2.1,7,7,5,2,0,4,11,36.4,7,2,0,2,2,9,9,0,Ligue_1,2023_2024
Amadou Koné,MLI,MF,Reims,18,2005,5.3,13,8,11,2,0,6,10,60.0,4,8,3,5,10,23,10,0,Ligue_1,2023_2024
Ibrahima Koné,MLI,FW,Lorient,24,1999,0.4,0,0,0,0,0,0,1,0.0,1,0,0,0,0,0,0,0,Ligue_1,2023_2024
N'Guessan Kouadio,CIV,"MF,FW",Metz,20,2003,1.2,3,1,0,3,0,0,3,0.0,3,3,0,3,1,4,0,0,Ligue_1,2023_2024
Koffi Kouao,CIV,DF,Metz,25,1998,9.6,20,13,12,7,1,11,17,64.7,6,9,6,3,13,33,38,1,Ligue_1,2023_2024
Therence Koudou,FRA,DF,Reims,18,2004,3.5,2,2,1,1,0,0,2,0.0,2,4,3,1,4,6,9,0,Ligue_1,2023_2024
Boubakar Kouyaté,MLI,DF,Montpellier,26,1997,21.4,49,30,39,8,2,28,51,54.9,23,31,20,11,29,78,123,1,Ligue_1,2023_2024
Sael Kumbedi,FRA,DF,Lyon,18,2005,10.3,30,20,14,12,4,9,22,40.9,13,12,3,9,14,44,18,2,Ligue_1,2023_2024
Layvin Kurzawa,FRA,DF,Paris S-G,30,1992,0.1,0,0,0,0,0,0,0,,0,0,0,0,0,0,0,0,Ligue_1,2023_2024
Daler Kuzyaev,RUS,MF,Le Havre,30,1993,23.2,34,19,11,13,10,15,43,34.9,28,18,5,13,22,56,18,1,Ligue_1,2023_2024
Grejohn Kyei,FRA,FW,Clermont Foot,27,1995,11.4,6,4,2,2,2,2,3,66.7,1,5,1,4,1,7,10,0,Ligue_1,2023_2024
Gaëtan Laborde,FRA,"FW,MF",Nice,29,1994,21.2,18,12,8,4,6,11,30,36.7,19,20,2,18,6,24,8,1,Ligue_1,2023_2024
Alexandre Lacazette,FRA,FW,Lyon,32,1991,25.5,19,12,8,9,2,5,17,29.4,12,22,3,19,8,27,9,0,Ligue_1,2023_2024
Alban Lafont,FRA,GK,Nantes,24,1999,27.7,0,0,0,0,0,0,2,0.0,2,0,0,0,0,0,14,0,Ligue_1,2023_2024
Kenny Lala,MAD,DF,Brest,31,1991,33.0,78,51,39,28,11,30,56,53.6,26,27,6,21,28,106,75,1,Ligue_1,2023_2024
Mathis Lambourde,FRA,FW,Rennes,17,2006,0.1,0,0,0,0,0,0,1,0.0,1,1,0,1,0,0,1,0,Ligue_1,2023_2024
Mohamed Lamine Bayo,GUI,FW,Le Havre,25,1998,15.4,13,5,2,5,6,2,10,20.0,8,8,1,7,2,15,11,0,Ligue_1,2023_2024
Didier Lamkel Zé,CMR,"FW,MF",Metz,26,1996,6.1,7,2,2,4,1,2,5,40.0,3,4,0,4,0,7,11,0,Ligue_1,2023_2024
Julien Laporte,FRA,DF,Lorient,29,1993,20.2,23,14,15,7,1,16,36,44.4,20,36,26,10,11,34,116,1,Ligue_1,2023_2024
Théo Le Bris,FRA,"DF,MF",Lorient,20,2002,16.8,35,22,25,7,3,19,40,47.5,21,24,3,21,12,47,42,0,Ligue_1,2023_2024
Julien Le Cardinal,FRA,DF,Brest,25,1997,5.3,19,11,11,7,1,8,12,66.7,4,6,3,3,13,32,26,0,Ligue_1,2023_2024
Julien Le Cardinal,FRA,DF,Lens,25,1997,0.6,6,2,4,2,0,4,9,44.4,5,2,1,1,0,6,0,0,Ligue_1,2023_2024
Jérémy Le Douaron,FRA,FW,Brest,25,1998,18.0,21,10,7,9,5,11,26,42.3,15,14,1,13,2,23,10,0,Ligue_1,2023_2024
Enzo Le Fée,FRA,MF,Rennes,23,2000,17.0,50,35,23,17,10,23,47,48.9,24,17,3,14,19,69,20,0,Ligue_1,2023_2024
Vincent Le Goff,FRA,"DF,MF",Lorient,33,1989,6.0,5,0,4,0,1,4,8,50.0,4,11,3,8,3,8,10,0,Ligue_1,2023_2024
Adrien Lebeau,FRA,"MF,FW",Brest,24,1999,0.6,0,0,0,0,0,0,3,0.0,3,2,1,1,0,0,1,0,Ligue_1,2023_2024
Jean-Louis Leca,FRA,GK,Lens,37,1985,1.0,0,0,0,0,0,0,0,,0,0,0,0,0,0,1,0,Ligue_1,2023_2024
Benjamin Lecomte,FRA,GK,Montpellier,32,1991,30.0,0,0,0,0,0,0,1,0.0,1,0,0,0,0,0,16,1,Ligue_1,2023_2024
Pierre Lees-Melou,FRA,MF,Brest,30,1993,28.0,96,67,51,41,4,49,129,38.0,80,61,11,50,43,139,64,3,Ligue_1,2023_2024
Johann Lepenant,FRA,MF,Lyon,20,2002,2.8,4,3,2,2,0,1,8,12.5,7,5,0,5,4,8,0,0,Ligue_1,2023_2024
Léo Leroy,FRA,MF,Montpellier,23,2000,5.5,19,10,8,8,3,6,21,28.6,15,12,3,9,7,26,8,0,Ligue_1,2023_2024
Gautier Lloris,FRA,DF,Le Havre,28,1995,30.9,50,28,40,9,1,28,42,66.7,14,50,30,20,32,82,142,1,Ligue_1,2023_2024
Abou Lô,SEN,"MF,DF",Metz,23,2000,2.2,3,1,2,1,0,1,4,25.0,3,5,2,3,4,7,8,0,Ligue_1,2023_2024
Bradley Locko,FRA,DF,Brest,21,2002,32.9,97,55,57,34,6,47,80,58.8,33,28,1,27,40,137,69,0,Ligue_1,2023_2024
Renan Lodi,BRA,DF,Marseille,25,1998,13.7,24,16,8,13,3,13,21,61.9,8,7,2,5,16,40,35,0,Ligue_1,2023_2024
Andy Logbo,FRA,FW,Le Havre,19,2004,2.8,0,0,0,0,0,0,3,0.0,3,7,3,4,0,0,2,0,Ligue_1,2023_2024
Anthony Lopes,POR,GK,Lyon,32,1990,31.0,0,0,0,0,0,0,0,,0,0,0,0,0,0,16,0,Ligue_1,2023_2024
Pau López,ESP,GK,Marseille,28,1994,32.7,0,0,0,0,0,0,2,0.0,2,0,0,0,0,0,10,1,Ligue_1,2023_2024
Jordan Lotomba,SUI,DF,Nice,24,1998,20.0,36,28,18,9,9,25,35,71.4,10,30,9,21,16,52,26,1,Ligue_1,2023_2024
Tom Louchet,FRA,"MF,DF",Nice,20,2003,4.5,14,5,6,6,2,7,11,63.6,4,7,3,4,3,17,9,0,Ligue_1,2023_2024
Imran Louza,MAR,MF,Lorient,24,1999,9.6,13,7,2,8,3,2,8,25.0,6,8,1,7,9,22,4,0,Ligue_1,2023_2024
Dejan Lovren,CRO,DF,Lyon,34,1989,8.0,9,7,6,3,0,3,7,42.9,4,6,5,1,12,21,37,0,Ligue_1,2023_2024
Joshua M'Bahia,CIV,MF,Clermont Foot,18,2005,0.2,0,0,0,0,0,0,0,,0,0,0,0,0,0,0,0,Ligue_1,2023_2024
Othmane Maamma,FRA,FW,Montpellier,17,2005,1.0,3,3,2,0,1,1,1,100.0,0,3,0,3,0,3,0,0,Ligue_1,2023_2024
Deiver Machado,COL,DF,Lens,29,1993,12.5,24,18,10,10,4,15,20,75.0,5,13,2,11,7,31,8,0,Ligue_1,2023_2024
Soungoutou Magassa,FRA,"DF,MF",Monaco,19,2003,15.0,56,26,22,32,2,26,48,54.2,22,21,4,17,21,77,36,2,Ligue_1,2023_2024
Hugo Magnetti,FRA,MF,Brest,25,1998,26.0,49,27,18,26,5,24,58,41.4,34,19,1,18,18,67,18,0,Ligue_1,2023_2024
Yohann Magnin,FRA,MF,Clermont Foot,26,1997,18.7,49,31,12,32,5,22,47,46.8,25,38,13,25,19,68,26,1,Ligue_1,2023_2024
Frank Magri,CMR,"FW,MF",Toulouse,23,1999,16.0,22,14,5,12,5,15,21,71.4,6,16,4,12,4,26,17,0,Ligue_1,2023_2024
Adel Mahamoud,COM,FW,Nantes,20,2003,0.1,0,0,0,0,0,0,1,0.0,1,0,0,0,0,0,0,0,Ligue_1,2023_2024
Habib Maïga,CIV,"MF,FW",Metz,27,1996,1.6,2,2,1,0,1,1,3,33.3,2,2,0,2,4,6,2,0,Ligue_1,2023_2024
Ainsley Maitland-Niles,ENG,"DF,MF",Lyon,25,1997,15.9,34,18,12,14,8,19,37,51.4,18,16,6,10,17,51,29,1,Ligue_1,2023_2024
Radosław Majecki,POL,GK,Monaco,23,1999,12.0,0,0,0,0,0,0,0,,0,1,0,1,0,0,5,1,Ligue_1,2023_2024
Lovro Majer,CRO,MF,Rennes,25,1998,0.2,0,0,0,0,0,0,0,,0,0,0,0,0,0,1,0,Ligue_1,2023_2024
Jean-Victor Makengo,FRA,"MF,FW",Lorient,25,1998,5.3,5,4,3,2,0,2,6,33.3,4,12,1,11,8,13,5,0,Ligue_1,2023_2024
Aaron Malouda,FRA,FW,Lille,17,2005,0.0,0,0,0,0,0,0,0,,0,0,0,0,0,0,0,0,Ligue_1,2023_2024
Hianga Mananga Mbock,FRA,"MF,FW",Brest,23,1999,0.1,1,0,0,0,1,1,2,50.0,1,0,0,0,1,2,0,0,Ligue_1,2023_2024
Steve Mandanda,FRA,GK,Rennes,38,1985,34.0,2,0,2,0,0,2,4,50.0,2,0,0,0,0,2,6,1,Ligue_1,2023_2024
Orel Mangala,BEL,MF,Lyon,25,1998,4.4,5,3,0,2,3,1,3,33.3,2,3,2,1,5,10,6,0,Ligue_1,2023_2024
Vito Mannone,ITA,GK,Lille,35,1988,1.0,0,0,0,0,0,0,0,,0,0,0,0,0,0,0,0,Ligue_1,2023_2024
Faitout Maouassa,FRA,"MF,DF",Lens,25,1998,0.8,1,1,1,0,0,1,1,100.0,0,1,0,1,0,1,3,0,Ligue_1,2023_2024
Guillermo Maripán,CHI,DF,Monaco,29,1994,19.6,22,8,15,6,1,10,27,37.0,17,26,13,13,30,52,106,4,Ligue_1,2023_2024
Marquinhos,BRA,"FW,MF",Nantes,20,2003,1.7,3,2,2,0,1,1,4,25.0,3,7,2,5,6,9,1,0,Ligue_1,2023_2024
Marquinhos,BRA,DF,Paris S-G,29,1994,17.1,19,11,10,7,2,11,17,64.7,6,29,19,10,17,36,58,1,Ligue_1,2023_2024
Jonas Martin,FRA,MF,Brest,33,1990,13.4,43,27,17,24,2,21,36,58.3,15,16,2,14,9,52,28,2,Ligue_1,2023_2024
Clinton Mata,ANG,DF,Lyon,30,1992,24.7,43,24,29,8,6,23,40,57.5,17,35,16,19,40,83,61,0,Ligue_1,2023_2024
Eliot Matazo,BEL,MF,Monaco,21,2002,1.1,3,1,0,3,0,2,4,50.0,2,1,1,0,3,6,0,0,Ligue_1,2023_2024
Nemanja Matić,SRB,MF,Rennes,34,1988,11.4,19,10,7,9,3,9,12,75.0,3,15,7,8,27,46,19,0,Ligue_1,2023_2024
Nemanja Matić,SRB,MF,Lyon,34,1988,13.9,17,11,8,7,2,9,19,47.4,10,17,6,11,16,33,17,1,Ligue_1,2023_2024
Chrislain Matsima,FRA,DF,Clermont Foot,21,2002,13.1,18,11,11,7,0,10,18,55.6,8,14,10,4,13,31,74,1,Ligue_1,2023_2024
Chrislain Matsima,FRA,DF,Monaco,21,2002,3.3,9,7,5,3,1,2,7,28.6,5,4,1,3,4,13,4,0,Ligue_1,2023_2024
Azor Matusiwa,NED,MF,Reims,25,1998,15.4,39,27,17,19,3,22,32,68.8,10,21,3,18,33,72,32,1,Ligue_1,2023_2024
Azor Matusiwa,NED,MF,Rennes,25,1998,8.8,7,3,3,4,0,4,7,57.1,3,9,2,7,11,18,17,0,Ligue_1,2023_2024
Aïman Maurer,MAR,"MF,FW",Clermont Foot,18,2004,0.6,1,1,1,0,0,1,3,33.3,2,0,0,0,0,1,0,0,Ligue_1,2023_2024
Christian Mawissa,FRA,DF,Toulouse,18,2005,12.4,22,15,14,4,4,9,23,39.1,14,22,11,11,22,44,41,1,Ligue_1,2023_2024
Noam Mayoka-Tika,BEL,MF,Marseille,19,2003,0.0,0,0,0,0,0,0,0,,0,0,0,0,0,0,0,0,Ligue_1,2023_2024
Senny Mayulu,FRA,"FW,MF",Paris S-G,17,2006,3.6,13,8,6,6,1,6,7,85.7,1,1,0,1,3,16,0,0,Ligue_1,2023_2024
Youssef Maziz,FRA,"FW,MF",Metz,25,1998,1.4,0,0,0,0,0,0,2,0.0,2,1,0,1,1,1,2,0,Ligue_1,2023_2024
Ethan Mbappé,FRA,"MF,DF",Paris S-G,16,2006,0.5,0,0,0,0,0,0,2,0.0,2,1,0,1,0,0,0,0,Ligue_1,2023_2024
Kylian Mbappé,FRA,FW,Paris S-G,24,1998,24.0,4,1,1,1,2,4,9,44.4,5,4,0,4,2,6,2,0,Ligue_1,2023_2024
Malick Mbaye,SEN,"MF,FW",Metz,19,2004,1.7,5,1,0,1,4,1,2,50.0,1,1,0,1,1,6,2,0,Ligue_1,2023_2024
Chancel Mbemba,COD,DF,Marseille,28,1994,24.5,33,21,25,7,1,17,30,56.7,13,21,13,8,13,46,95,1,Ligue_1,2023_2024
Nolan Mbemba,CGO,MF,Le Havre,28,1995,0.2,2,1,0,1,1,1,2,50.0,1,0,0,0,0,2,0,0,Ligue_1,2023_2024
Christ Mbondi,FRA,FW,Reims,18,2004,0.0,1,1,1,0,0,1,1,100.0,0,0,0,0,0,1,0,0,Ligue_1,2023_2024
Facundo Medina,ARG,DF,Lens,24,1999,30.2,64,38,25,31,8,44,69,63.8,25,38,13,25,24,88,59,2,Ligue_1,2023_2024
Bamo Meïté,CIV,DF,Marseille,21,2001,7.1,16,10,13,3,0,8,12,66.7,4,11,5,6,11,27,35,0,Ligue_1,2023_2024
Bamo Meïté,CIV,DF,Lorient,21,2001,1.6,2,1,2,0,0,0,1,0.0,1,3,2,1,3,5,9,0,Ligue_1,2023_2024
Birger Meling,NOR,DF,Rennes,28,1994,0.2,1,1,1,0,0,1,1,100.0,0,1,0,1,0,1,0,0,Ligue_1,2023_2024
Nuno Mendes,POR,DF,Paris S-G,21,2002,3.0,5,5,4,1,0,4,7,57.1,3,4,0,4,4,9,2,0,Ligue_1,2023_2024
Antoine Mendy,FRA,DF,Nice,19,2004,4.6,7,5,4,3,0,3,7,42.9,4,4,1,3,8,15,16,0,Ligue_1,2023_2024
Benjamin Mendy,FRA,DF,Lorient,29,1994,7.9,3,1,2,1,0,1,5,20.0,4,8,2,6,7,10,20,0,Ligue_1,2023_2024
Formose Mendy,SEN,DF,Lorient,22,2001,14.0,33,19,24,8,1,20,33,60.6,13,23,12,11,20,53,59,1,Ligue_1,2023_2024
Nampalys Mendy,SEN,MF,Lens,31,1992,11.7,29,18,10,13,6,16,20,80.0,4,11,4,7,14,43,14,1,Ligue_1,2023_2024
Quentin Merlin,FRA,DF,Marseille,21,2002,7.8,13,12,7,5,1,8,20,40.0,12,4,0,4,6,19,14,0,Ligue_1,2023_2024
Quentin Merlin,FRA,DF,Nantes,21,2002,14.3,29,20,15,12,2,16,25,64.0,9,22,1,21,18,47,22,0,Ligue_1,2023_2024
Bastien Meupiyou,FRA,DF,Nantes,17,2006,0.1,0,0,0,0,0,0,0,,0,0,0,0,0,0,1,0,Ligue_1,2023_2024
Lucas Michal,FRA,FW,Monaco,18,2005,0.1,0,0,0,0,0,0,0,,0,0,0,0,0,0,0,0,Ligue_1,2023_2024
Georges Mikautadze,GEO,FW,Metz,22,2000,19.4,4,3,1,2,1,0,9,0.0,9,11,0,11,8,12,3,0,Ligue_1,2023_2024
Takumi Minamino,JPN,MF,Monaco,28,1995,23.5,34,17,10,13,11,16,54,29.6,38,29,1,28,11,45,8,0,Ligue_1,2023_2024
Lucas Mincarelli,FRA,"DF,MF",Montpellier,19,2004,10.9,29,16,19,6,4,17,34,50.0,17,17,4,13,8,37,27,0,Ligue_1,2023_2024
Ignacio Miramon,ARG,MF,Lille,20,2003,0.4,1,0,0,1,0,0,1,0.0,1,1,0,1,0,1,0,0,Ligue_1,2023_2024
Terem Moffi,NGA,FW,Nice,24,1999,21.7,7,4,0,5,2,3,12,25.0,9,14,1,13,3,10,15,0,Ligue_1,2023_2024
Mostafa Mohamed,EGY,FW,Nantes,25,1997,22.2,21,14,7,11,3,6,28,21.4,22,21,5,16,12,33,29,0,Ligue_1,2023_2024
Dion Moise Sahi,CIV,"MF,FW",Strasbourg,21,2001,7.0,5,5,1,2,2,0,3,0.0,3,11,1,10,1,6,7,0,Ligue_1,2023_2024
Florent Mollet,FRA,"MF,FW",Nantes,31,1991,23.1,18,11,8,6,4,10,31,32.3,21,18,5,13,13,31,17,0,Ligue_1,2023_2024
Enzo Mongo,FRA,DF,Nantes,18,2005,0.1,1,1,1,0,0,1,2,50.0,1,1,1,0,1,2,0,0,Ligue_1,2023_2024
Diego Moreira,POR,"FW,MF",Lyon,18,2004,3.0,0,0,0,0,0,0,3,0.0,3,3,0,3,2,2,5,0,Ligue_1,2023_2024
Lebo Mothiba,RSA,FW,Strasbourg,27,1996,6.9,5,2,1,4,0,3,4,75.0,1,6,1,5,0,5,11,0,Ligue_1,2023_2024
Steve Mounié,BEN,FW,Brest,28,1994,19.7,8,7,0,3,5,3,11,27.3,8,13,3,10,2,10,18,0,Ligue_1,2023_2024
Samuel Moutoussamy,COD,MF,Nantes,26,1996,12.3,38,20,14,17,7,17,37,45.9,20,16,3,13,11,49,13,0,Ligue_1,2023_2024
Loris Mouyokolo,FRA,DF,Lorient,22,2001,1.0,4,1,4,0,0,1,1,100.0,0,1,0,1,0,4,3,0,Ligue_1,2023_2024
François Mughe,CMR,"MF,DF",Marseille,19,2004,2.0,0,0,0,0,0,0,3,0.0,3,2,0,2,1,1,1,0,Ligue_1,2023_2024
Nordi Mukiele,FRA,DF,Paris S-G,25,1997,8.8,12,8,6,5,1,8,15,53.3,7,17,4,13,14,26,28,0,Ligue_1,2023_2024
Marshall Munetsi,ZIM,MF,Reims,27,1996,24.1,61,39,18,34,9,33,61,54.1,28,21,7,14,14,75,33,0,Ligue_1,2023_2024
Yvon Mvogo,SUI,GK,Lorient,29,1994,34.0,0,0,0,0,0,0,1,0.0,1,0,0,0,0,0,15,3,Ligue_1,2023_2024
Joel Mvuka,NOR,"DF,FW",Lorient,20,2002,2.2,5,3,3,1,1,3,7,42.9,4,1,0,1,2,7,1,0,Ligue_1,2023_2024
Junior Mwanga,FRA,"MF,FW",Strasbourg,20,2003,16.1,40,20,23,12,5,12,24,50.0,12,20,5,15,18,58,19,0,Ligue_1,2023_2024
Kévin N'Doram,FRA,MF,Metz,27,1996,17.8,31,22,20,9,2,17,38,44.7,21,17,8,9,27,58,38,0,Ligue_1,2023_2024
Bilal Nadir,FRA,"MF,FW",Marseille,19,2003,1.3,4,3,2,2,0,1,2,50.0,1,0,0,0,2,6,2,0,Ligue_1,2023_2024
Mahamadou Nagida,CMR,DF,Rennes,18,2005,1.2,1,1,0,0,1,0,2,0.0,2,2,1,1,4,5,0,0,Ligue_1,2023_2024
Keito Nakamura,JPN,"FW,MF",Reims,23,2000,15.3,28,11,9,10,9,17,37,45.9,20,15,2,13,6,34,7,0,Ligue_1,2023_2024
Keylor Navas,CRC,GK,Paris S-G,36,1986,4.0,0,0,0,0,0,0,0,,0,0,0,0,0,0,2,0,Ligue_1,2023_2024
Youssouf Ndayishimiye,BDI,"MF,DF",Nice,24,1998,19.0,31,20,17,12,2,12,23,52.2,11,19,11,8,12,43,47,1,Ligue_1,2023_2024
Bassirou Ndiaye,SEN,FW,Lorient,21,2002,1.7,5,2,2,2,1,3,5,60.0,2,1,1,0,1,6,0,0,Ligue_1,2023_2024
Iliman Ndiaye,SEN,"FW,MF",Marseille,23,2000,18.0,21,18,5,11,5,11,29,37.9,18,14,2,12,6,27,6,0,Ligue_1,2023_2024
Massamba Ndiaye,SEN,GK,Clermont Foot,21,2001,4.0,0,0,0,0,0,0,0,,0,0,0,0,0,0,2,0,Ligue_1,2023_2024
Rassoul Ndiaye,SEN,"MF,FW",Le Havre,21,2001,5.8,25,17,8,16,1,12,24,50.0,12,2,1,1,4,29,5,0,Ligue_1,2023_2024
Cher Ndour,ITA,MF,Paris S-G,19,2004,0.3,2,2,0,2,0,1,2,50.0,1,0,0,0,0,2,0,0,Ligue_1,2023_2024
Joseph Nduquidi,FRA,"MF,DF",Metz,18,2004,8.3,11,4,6,3,2,1,9,11.1,8,11,3,8,11,22,15,1,Ligue_1,2023_2024
Loïc Nego,HUN,"DF,MF",Le Havre,32,1991,17.3,37,26,21,12,4,18,30,60.0,12,12,2,10,16,53,17,0,Ligue_1,2023_2024
Steve Ngoura,FRA,"FW,MF",Le Havre,18,2005,2.5,2,1,1,1,0,1,4,25.0,3,0,0,0,0,2,3,0,Ligue_1,2023_2024
Shamar Nicholson,JAM,FW,Clermont Foot,26,1997,16.5,6,2,0,4,2,1,4,25.0,3,6,2,4,0,6,15,0,Ligue_1,2023_2024
Rasmus Nicolaisen,DEN,DF,Toulouse,26,1997,32.5,50,30,39,11,0,26,44,59.1,18,44,33,11,42,92,158,1,Ligue_1,2023_2024
Arnaud Nordin,FRA,"FW,MF",Montpellier,25,1998,13.8,12,6,3,5,4,6,16,37.5,10,11,0,11,2,14,10,0,Ligue_1,2023_2024
Ernest Nuamah,GHA,"FW,MF",Lyon,19,2003,20.4,28,14,18,6,4,12,38,31.6,26,15,1,14,8,36,9,0,Ligue_1,2023_2024
Gerzino Nyamsi,FRA,DF,Strasbourg,26,1997,12.1,18,14,13,5,0,12,18,66.7,6,19,11,8,10,28,43,0,Ligue_1,2023_2024
Rabby Nzingoula,CGO,"MF,FW",Strasbourg,17,2005,1.5,3,3,0,3,0,3,4,75.0,1,4,0,4,5,8,0,0,Ligue_1,2023_2024
Jake O'Brien,IRL,DF,Lyon,22,2001,26.3,22,16,16,5,1,14,20,70.0,6,23,18,5,12,34,98,1,Ligue_1,2023_2024
Florent Ogier,FRA,DF,Clermont Foot,34,1989,10.5,19,9,13,6,0,11,18,61.1,7,25,19,6,9,28,35,3,Ligue_1,2023_2024
Joseph Okumu,KEN,DF,Reims,26,1997,19.4,44,28,28,14,2,24,38,63.2,14,27,19,8,35,79,112,2,Ligue_1,2023_2024
Warmed Omari,COM,DF,Rennes,23,2000,23.0,32,19,23,7,2,16,28,57.1,12,30,20,10,33,65,77,2,Ligue_1,2023_2024
Becir Omeragic,SUI,"DF,MF",Montpellier,21,2002,25.7,48,29,31,13,4,20,33,60.6,13,51,29,22,27,75,65,0,Ligue_1,2023_2024
Jean Onana,CMR,MF,Marseille,23,2000,6.3,23,14,6,14,3,13,25,52.0,12,10,2,8,11,34,11,1,Ligue_1,2023_2024
Royce Openda Owaga,GAB,FW,Lorient,21,2002,0.2,0,0,0,0,0,0,0,,0,0,0,0,0,0,0,0,Ligue_1,2023_2024
Christopher Operi,CIV,DF,Le Havre,26,1997,27.2,55,36,37,15,3,32,59,54.2,27,45,7,38,35,90,68,1,Ligue_1,2023_2024
Gift Orban,NGA,FW,Lyon,21,2002,5.3,4,3,0,1,3,1,4,25.0,3,2,0,2,1,5,2,1,Ligue_1,2023_2024
Kassoum Ouattara,FRA,"DF,FW",Monaco,18,2004,7.1,17,12,8,5,4,9,20,45.0,11,11,0,11,13,30,20,0,Ligue_1,2023_2024
Alexandre Oukidja,ALG,GK,Metz,35,1988,33.2,2,1,2,0,0,1,2,50.0,1,1,0,1,3,5,24,3,Ligue_1,2023_2024
Azzedine Ounahi,MAR,MF,Marseille,23,2000,13.4,25,11,9,14,2,11,32,34.4,21,6,1,5,11,36,8,0,Ligue_1,2023_2024
Adam Ounas,ALG,FW,Lille,26,1996,4.6,4,3,2,2,0,2,7,28.6,5,2,0,2,6,10,1,0,Ligue_1,2023_2024
Patrick Ouotro,CIV,FW,Strasbourg,17,2005,0.1,0,0,0,0,0,0,0,,0,0,0,0,0,0,0,0,Ligue_1,2023_2024
Pablo Pagis,FRA,MF,Lorient,20,2002,1.8,10,6,5,4,1,6,10,60.0,4,2,0,2,3,13,1,0,Ligue_1,2023_2024
Nicolas Pallois,FRA,DF,Nantes,35,1987,17.7,34,19,21,11,2,19,35,54.3,16,37,26,11,26,60,111,0,Ligue_1,2023_2024
Andy Pelmard,FRA,DF,Clermont Foot,23,2000,33.2,51,38,41,9,1,32,40,80.0,8,37,20,17,33,84,99,2,Ligue_1,2023_2024
Aurélien Pelon,FRA,DF,Lorient,19,2004,1.0,1,0,1,0,0,0,2,0.0,2,2,2,0,0,1,7,0,Ligue_1,2023_2024
Faris Pemi Moumbagna,CMR,FW,Marseille,23,2000,6.1,2,1,0,2,0,0,3,0.0,3,4,0,4,3,5,1,0,Ligue_1,2023_2024
Danilo Pereira,POR,DF,Paris S-G,31,1991,22.2,22,12,14,6,2,9,17,52.9,8,29,26,3,23,45,100,1,Ligue_1,2023_2024
Mathias Pereira Lage,POR,"FW,MF",Brest,26,1996,13.2,21,15,7,8,6,7,28,25.0,21,14,5,9,10,31,13,0,Ligue_1,2023_2024
Romain Perraud,FRA,"DF,FW",Nice,25,1997,4.1,7,6,5,1,1,4,11,36.4,7,4,0,4,6,13,15,1,Ligue_1,2023_2024
Lucas Perrin,FRA,DF,Strasbourg,24,1998,30.3,47,30,33,14,0,28,46,60.9,18,45,32,13,28,75,113,0,Ligue_1,2023_2024
Denis Petrić,SRB,GK,Nantes,35,1988,0.3,0,0,0,0,0,0,0,,0,0,0,0,0,0,0,0,Ligue_1,2023_2024
Ronaël Pierre-Gabriel,FRA,DF,Nantes,25,1998,6.6,15,9,12,2,1,5,7,71.4,2,13,4,9,8,23,25,0,Ligue_1,2023_2024
Julien Ponceau,FRA,MF,Lorient,22,2000,24.9,32,15,12,14,6,9,30,30.0,21,22,1,21,19,51,20,0,Ligue_1,2023_2024
Sanjin Prcić,BIH,MF,Strasbourg,29,1993,1.0,0,0,0,0,0,0,1,0.0,1,2,1,1,3,3,1,0,Ligue_1,2023_2024
Gonçalo Ramos,POR,FW,Paris S-G,22,2001,15.8,25,15,4,12,9,6,20,30.0,14,12,2,10,5,30,16,0,Ligue_1,2023_2024
Elba Rashani,KVX,"MF,FW",Clermont Foot,30,1993,13.1,30,18,4,17,9,11,24,45.8,13,17,3,14,12,42,15,0,Ligue_1,2023_2024
Guillaume Restes,FRA,GK,Toulouse,18,2005,34.0,0,0,0,0,0,0,3,0.0,3,0,0,0,0,0,19,1,Ligue_1,2023_2024
Alexsandro Ribeiro,BRA,DF,Lille,23,1999,24.7,32,22,24,8,0,16,31,51.6,15,25,15,10,35,67,116,5,Ligue_1,2023_2024
Amir Richardson,MAR,MF,Reims,21,2002,15.0,33,23,12,18,3,10,22,45.5,12,26,5,21,15,48,30,0,Ligue_1,2023_2024
Fabian Rieder,SUI,MF,Rennes,21,2002,4.1,13,7,2,9,2,6,11,54.5,5,3,1,2,5,18,2,0,Ligue_1,2023_2024
Rémy Riou,FRA,GK,Lyon,35,1987,3.0,0,0,0,0,0,0,1,0.0,1,0,0,0,0,0,1,1,Ligue_1,2023_2024
Valentin Rongier,FRA,MF,Marseille,28,1994,9.5,23,12,9,12,2,14,26,53.8,12,16,4,12,15,38,18,0,Ligue_1,2023_2024
Pablo Rosario,NED,"MF,DF",Nice,26,1997,22.3,36,25,15,16,5,23,34,67.6,11,27,13,14,29,65,39,0,Ligue_1,2023_2024
Valentin Rosier,FRA,"DF,MF",Nice,26,1996,0.6,1,0,1,0,0,0,0,,0,1,0,1,2,3,5,0,Ligue_1,2023_2024
Fabián Ruiz Peña,ESP,MF,Paris S-G,27,1996,13.3,34,23,17,14,3,23,42,54.8,19,8,2,6,11,45,21,2,Ligue_1,2023_2024
Emmanuel Sabbi,USA,"FW,MF",Le Havre,25,1997,17.6,38,19,15,15,8,16,39,41.0,23,26,2,24,19,57,7,0,Ligue_1,2023_2024
Falaye Sacko,MLI,DF,Montpellier,28,1995,15.4,28,16,13,10,5,21,32,65.6,11,19,7,12,24,52,37,0,Ligue_1,2023_2024
Modibo Sagnan,MLI,DF,Montpellier,24,1999,11.7,34,22,23,9,2,15,25,60.0,10,13,9,4,15,49,67,0,Ligue_1,2023_2024
Wesley Saïd,FRA,"FW,MF",Lens,28,1995,11.3,8,4,1,2,5,2,9,22.2,7,4,0,4,4,12,3,0,Ligue_1,2023_2024
Théo Sainte-Luce,FRA,DF,Montpellier,24,1998,3.8,17,7,10,6,1,11,19,57.9,8,9,4,5,3,20,15,0,Ligue_1,2023_2024
Mamadou Sakho,FRA,DF,Montpellier,33,1990,0.1,1,1,1,0,0,1,1,100.0,0,0,0,0,0,1,1,0,Ligue_1,2023_2024
Ibrahim Salah,MAR,"FW,MF",Rennes,21,2001,5.8,15,7,5,6,4,11,18,61.1,7,4,0,4,10,25,5,0,Ligue_1,2023_2024
Amine Salama,FRA,FW,Reims,23,2000,3.5,0,0,0,0,0,0,0,,0,1,0,1,1,1,1,0,Ligue_1,2023_2024
Mohammed Salisu,GHA,DF,Monaco,24,1999,11.5,27,12,11,13,3,17,26,65.4,9,21,12,9,22,49,44,0,Ligue_1,2023_2024
Yoann Salmier,GUF,DF,Le Havre,30,1992,17.4,22,10,13,6,3,13,20,65.0,7,21,15,6,21,43,57,0,Ligue_1,2023_2024
Mama Samba Baldé,GNB,"FW,MF",Lyon,27,1995,6.1,8,5,1,2,5,3,9,33.3,6,0,0,0,3,11,1,1,Ligue_1,2023_2024
Brice Samba,FRA,GK,Lens,29,1994,33.0,1,1,1,0,0,1,1,100.0,0,0,0,0,0,1,10,3,Ligue_1,2023_2024
Ibou Sané,SEN,"MF,FW",Metz,18,2005,1.4,6,4,2,1,3,2,2,100.0,0,3,0,3,1,7,2,0,Ligue_1,2023_2024
Sadibou Sané,SEN,DF,Metz,19,2004,9.4,19,12,16,2,1,6,7,85.7,1,14,9,5,8,27,64,0,Ligue_1,2023_2024
Arouna Sangante,SEN,DF,Le Havre,21,2002,29.9,53,33,27,23,3,24,40,60.0,16,35,18,17,66,119,93,2,Ligue_1,2023_2024
Morgan Sanson,FRA,MF,Nice,28,1994,21.8,26,19,12,7,7,12,31,38.7,19,34,5,29,20,46,16,0,Ligue_1,2023_2024
Baptiste Santamaria,FRA,MF,Rennes,28,1995,21.4,52,33,21,25,6,29,46,63.0,17,15,6,9,34,86,33,1,Ligue_1,2023_2024
Andrey Santos,BRA,MF,Strasbourg,19,2004,9.2,29,18,15,13,1,17,26,65.4,9,8,0,8,10,39,11,1,Ligue_1,2023_2024
Tiago Santos,POR,DF,Lille,21,2002,26.3,63,42,31,19,13,30,52,57.7,22,24,5,19,15,78,37,0,Ligue_1,2023_2024
Amin Sarr,SWE,"FW,MF",Lyon,22,2001,1.1,1,0,0,1,0,0,0,,0,1,0,1,0,1,1,0,Ligue_1,2023_2024
Ismaila Sarr,SEN,"FW,MF",Marseille,25,1998,16.1,14,8,2,10,2,6,17,35.3,11,21,6,15,13,27,11,0,Ligue_1,2023_2024
Mamadou Sarr,FRA,DF,Lyon,17,2005,0.1,0,0,0,0,0,0,0,,0,0,0,0,0,0,0,0,Ligue_1,2023_2024
Martin Satriano,URU,FW,Brest,22,2001,20.7,24,16,6,13,5,10,25,40.0,15,19,7,12,7,31,28,0,Ligue_1,2023_2024
Téji Savanier,FRA,MF,Montpellier,31,1991,30.7,37,20,16,15,6,14,63,22.2,49,36,8,28,33,70,28,1,Ligue_1,2023_2024
Niklas Schmidt,GER,MF,Toulouse,25,1998,14.1,36,21,13,19,4,16,33,48.5,17,14,7,7,4,40,13,0,Ligue_1,2023_2024
Jérémy Sebas,MTQ,"FW,MF",Strasbourg,20,2003,4.4,7,1,2,3,2,3,5,60.0,2,3,1,2,1,8,1,0,Ligue_1,2023_2024
Alidu Seidu,GHA,DF,Rennes,23,2000,6.6,21,9,17,3,1,14,19,73.7,5,11,3,8,10,31,13,0,Ligue_1,2023_2024
Alidu Seidu,GHA,DF,Clermont Foot,23,2000,12.6,32,24,17,15,0,24,31,77.4,7,15,7,8,25,57,37,0,Ligue_1,2023_2024
Matz Sels,BEL,GK,Strasbourg,31,1992,19.0,0,0,0,0,0,0,0,,0,2,0,2,0,0,13,1,Ligue_1,2023_2024
Marvin Senaya,TOG,"DF,MF",Strasbourg,22,2001,23.8,72,53,38,25,9,42,68,61.8,26,40,13,27,41,113,68,0,Ligue_1,2023_2024
Sofiane Sidi Ali,FRA,MF,Marseille,28,1995,0.2,2,0,0,2,0,1,2,50.0,1,1,0,1,2,4,0,0,Ligue_1,2023_2024
Vincent Sierro,SUI,MF,Toulouse,27,1995,25.1,41,24,15,20,6,27,77,35.1,50,37,13,24,27,68,33,0,Ligue_1,2023_2024
Caio Henrique Oliveira Silva,BRA,DF,Monaco,26,1997,6.9,13,7,3,7,3,6,9,66.7,3,8,2,6,6,19,9,0,Ligue_1,2023_2024
Moses Simon,NGA,"FW,MF",Nantes,28,1995,19.9,7,5,2,5,0,2,8,25.0,6,9,1,8,3,10,5,1,Ligue_1,2023_2024
Wilfried Singo,CIV,DF,Monaco,22,2000,24.3,34,25,18,14,2,17,26,65.4,9,27,14,13,51,85,81,2,Ligue_1,2023_2024
Ayanda Sishuba,BEL,"MF,FW",Lens,18,2005,0.7,3,1,0,2,1,1,2,50.0,1,1,0,1,0,3,0,0,Ligue_1,2023_2024
Ibrahima Sissoko,MLI,MF,Strasbourg,25,1997,18.2,47,33,13,25,9,23,30,76.7,7,21,8,13,19,66,30,0,Ligue_1,2023_2024
Moussa Sissoko,FRA,MF,Nantes,33,1989,20.2,27,16,13,8,6,12,25,48.0,13,8,2,6,12,39,31,0,Ligue_1,2023_2024
Milan Škriniar,SVK,DF,Paris S-G,28,1995,18.1,24,18,17,7,0,14,22,63.6,8,19,10,9,12,36,51,2,Ligue_1,2023_2024
Naatan Skyttä,FIN,"MF,FW",Toulouse,21,2002,1.3,4,4,2,1,1,1,1,100.0,0,0,0,0,0,4,0,0,Ligue_1,2023_2024
Eduard Sobol,UKR,DF,Strasbourg,28,1995,0.3,0,0,0,0,0,0,0,,0,0,0,0,0,0,1,0,Ligue_1,2023_2024
Emran Soglo,ENG,"MF,DF",Marseille,18,2005,1.2,2,1,0,2,0,1,3,33.3,2,6,0,6,1,3,3,0,Ligue_1,2023_2024
Carlos Soler,ESP,"MF,DF",Paris S-G,26,1997,12.1,15,10,9,2,4,6,21,28.6,15,10,3,7,5,20,11,1,Ligue_1,2023_2024
Florian Sotoca,FRA,"MF,FW",Lens,32,1990,28.9,33,22,9,21,3,17,38,44.7,21,41,4,37,20,53,34,0,Ligue_1,2023_2024
Issa Soumaré,SEN,"FW,MF",Le Havre,22,2000,2.6,2,0,2,0,0,0,4,0.0,4,0,0,0,0,2,2,0,Ligue_1,2023_2024
Saidou Sow,GUI,DF,Strasbourg,21,2002,8.0,20,12,17,3,0,9,13,69.2,4,7,4,3,12,32,36,3,Ligue_1,2023_2024
Stijn Spierings,NED,MF,Toulouse,27,1996,16.8,53,40,26,20,7,29,52,55.8,23,22,5,17,26,79,32,0,Ligue_1,2023_2024
Stijn Spierings,NED,MF,Lens,27,1996,1.3,1,0,0,1,0,1,1,100.0,0,2,1,1,2,3,1,0,Ligue_1,2023_2024
Benjamin Stambouli,FRA,MF,Reims,32,1990,3.2,9,7,3,5,1,6,11,54.5,5,3,1,2,2,11,8,0,Ligue_1,2023_2024
Gabriel Suazo,CHI,DF,Toulouse,25,1997,26.2,66,32,40,19,7,38,86,44.2,48,37,4,33,26,92,33,0,Ligue_1,2023_2024
Abakar Sylla,CIV,DF,Strasbourg,20,2002,19.9,54,23,30,19,5,29,40,72.5,11,40,11,29,26,80,70,2,Ligue_1,2023_2024
Dembo Sylla,GUI,DF,Lorient,20,2002,0.5,1,1,0,1,0,0,0,,0,0,0,0,1,2,2,0,Ligue_1,2023_2024
Issiaga Sylla,GUI,"DF,FW",Montpellier,29,1994,16.2,28,17,20,6,2,16,34,47.1,18,21,7,14,23,51,53,0,Ligue_1,2023_2024
Musa Al-Taamari,JOR,FW,Montpellier,26,1997,21.4,20,16,10,5,5,9,21,42.9,12,18,2,16,4,24,5,0,Ligue_1,2023_2024
Nicolás Tagliafico,ARG,DF,Lyon,30,1992,23.6,54,34,23,22,9,22,49,44.9,27,25,8,17,28,82,43,0,Ligue_1,2023_2024
Montassar Talbi,TUN,DF,Lorient,25,1998,24.5,38,22,23,13,2,19,32,59.4,13,39,23,16,32,70,114,0,Ligue_1,2023_2024
Oussama Targhalline,MAR,MF,Le Havre,21,2002,11.4,23,11,16,7,0,15,25,60.0,10,9,3,6,20,43,14,2,Ligue_1,2023_2024
Enzo Tchato,CMR,DF,Montpellier,20,2002,12.5,26,17,18,4,4,11,25,44.0,14,20,7,13,11,37,25,0,Ligue_1,2023_2024
Arnau Tenas,ESP,GK,Paris S-G,22,2001,5.9,0,0,0,0,0,0,0,,0,0,0,0,0,0,0,0,Ligue_1,2023_2024
Martin Terrier,FRA,"FW,MF",Rennes,26,1997,17.0,14,9,3,8,3,6,14,42.9,8,21,4,17,9,23,17,0,Ligue_1,2023_2024
Benjamin Tetteh,GHA,"FW,MF",Metz,26,1997,3.1,6,6,1,5,0,4,7,57.1,3,0,0,0,0,6,1,0,Ligue_1,2023_2024
Teddy Teuma,MLT,MF,Reims,29,1993,23.5,54,36,19,21,14,25,62,40.3,37,33,4,29,20,74,6,0,Ligue_1,2023_2024
Arthur Theate,BEL,DF,Rennes,23,2000,25.5,30,17,19,6,5,24,37,64.9,13,40,23,17,31,61,90,2,Ligue_1,2023_2024
Adrien Thomasson,FRA,MF,Lens,29,1993,13.3,25,14,4,16,5,11,34,32.4,23,14,0,14,9,34,10,1,Ligue_1,2023_2024
Khéphren Thuram,FRA,MF,Nice,22,2001,23.4,42,29,13,23,6,20,40,50.0,20,21,10,11,18,60,37,0,Ligue_1,2023_2024
Cheikh Tidiane Sabaly,SEN,"FW,MF",Metz,24,1999,15.3,40,20,23,12,5,16,40,40.0,24,19,2,17,10,50,14,0,Ligue_1,2023_2024
Jean-Clair Todibo,FRA,DF,Nice,23,1999,29.5,58,28,35,17,6,34,56,60.7,22,34,15,19,38,96,97,1,Ligue_1,2023_2024
Corentin Tolisso,FRA,MF,Lyon,28,1994,19.3,33,21,13,11,9,14,33,42.4,19,26,9,17,10,43,18,0,Ligue_1,2023_2024
Abdoulaye Touré,GUI,MF,Le Havre,29,1994,25.4,47,28,22,22,3,30,60,50.0,30,30,8,22,25,72,33,0,Ligue_1,2023_2024
Souleymane Touré,FRA,DF,Lorient,20,2003,22.8,25,12,16,9,0,8,14,57.1,6,38,20,18,36,61,101,2,Ligue_1,2023_2024
Bénie Traoré,CIV,"FW,MF",Nantes,20,2002,5.6,8,4,2,5,1,3,7,42.9,4,3,0,3,1,9,1,0,Ligue_1,2023_2024
Daouda Traoré,FRA,MF,Nice,17,2006,0.2,0,0,0,0,0,0,0,,0,0,0,0,0,0,0,0,Ligue_1,2023_2024
Ismaël Traoré,CIV,DF,Metz,36,1986,24.7,19,12,13,6,0,8,21,38.1,13,33,20,13,30,49,86,0,Ligue_1,2023_2024
Adrien Truffert,FRA,DF,Rennes,21,2001,23.8,39,21,23,10,6,25,40,62.5,15,31,5,26,19,58,49,0,Ligue_1,2023_2024
Matthieu Udol,FRA,DF,Metz,27,1996,30.0,55,37,38,12,5,38,56,67.9,18,62,16,46,50,105,108,0,Ligue_1,2023_2024
Manuel Ugarte Ribeiro,URU,MF,Paris S-G,22,2001,21.5,98,57,39,43,16,43,89,48.3,46,27,6,21,40,138,25,2,Ligue_1,2023_2024
Samuel Umtiti,FRA,DF,Lille,29,1993,2.1,1,1,0,1,0,1,4,25.0,3,0,0,0,2,3,4,0,Ligue_1,2023_2024
Kévin Van Den Kerkhof,ALG,"FW,MF",Metz,27,1996,21.3,31,24,11,13,7,13,32,40.6,19,15,2,13,11,42,32,1,Ligue_1,2023_2024
Vanderson,BRA,DF,Monaco,22,2001,18.2,60,41,20,30,10,32,70,45.7,38,29,2,27,35,95,37,1,Ligue_1,2023_2024
Jordan Veretout,FRA,MF,Marseille,30,1993,24.3,38,22,19,13,6,18,39,46.2,21,20,4,16,13,51,25,0,Ligue_1,2023_2024
Alan Virginius,FRA,FW,Lille,20,2003,0.8,1,1,1,0,0,0,1,0.0,1,0,0,0,0,1,0,0,Ligue_1,2023_2024
Alan Virginius,FRA,FW,Clermont Foot,20,2003,10.4,9,5,4,4,1,4,11,36.4,7,7,0,7,3,12,7,0,Ligue_1,2023_2024
Vitinha,POR,FW,Marseille,23,2000,10.3,14,8,3,5,6,3,12,25.0,9,11,2,9,5,19,8,0,Ligue_1,2023_2024
Vitinha,POR,MF,Paris S-G,23,2000,23.6,39,24,12,16,11,16,48,33.3,32,29,11,18,23,62,30,2,Ligue_1,2023_2024
Elye Wahi,FRA,FW,Montpellier,20,2003,0.2,0,0,0,0,0,0,0,,0,0,0,0,0,0,0,0,Ligue_1,2023_2024
Elye Wahi,FRA,FW,Lens,20,2003,18.8,6,4,1,3,2,2,10,20.0,8,5,1,4,3,9,3,0,Ligue_1,2023_2024
Mateusz Wieteska,POL,DF,Clermont Foot,26,1997,1.9,4,1,3,1,0,3,5,60.0,2,4,2,2,5,9,8,0,Ligue_1,2023_2024
Josh Wilson-Esbrand,ENG,"DF,MF",Reims,20,2002,5.1,5,4,2,3,0,2,8,25.0,6,5,2,3,6,11,7,0,Ligue_1,2023_2024
Christopher Wooh,CMR,DF,Rennes,21,2001,15.4,18,12,12,6,0,8,15,53.3,7,19,9,10,18,36,51,0,Ligue_1,2023_2024
Yusuf Yazıcı,TUR,"MF,FW",Lille,26,1997,14.6,19,11,6,9,4,4,15,26.7,11,10,1,9,5,24,5,0,Ligue_1,2023_2024
Kelvin Yeboah,ITA,FW,Montpellier,23,2000,3.1,4,2,2,2,0,1,3,33.3,2,3,2,1,1,5,3,0,Ligue_1,2023_2024
Bertuğ Yıldırım,TUR,FW,Rennes,21,2002,5.2,7,5,2,3,2,3,8,37.5,5,8,0,8,0,7,4,0,Ligue_1,2023_2024
Darlin Yongwa,CMR,DF,Lorient,22,2000,12.9,30,23,17,11,2,14,25,56.0,11,14,2,12,15,45,36,0,Ligue_1,2023_2024
Leny Yoro,FRA,DF,Lille,17,2005,29.7,36,25,27,7,2,17,31,54.8,14,20,14,6,36,72,97,1,Ligue_1,2023_2024
Etienne Youte Kinkoue,FRA,DF,Le Havre,21,2002,21.6,15,9,13,2,0,7,11,63.6,4,21,16,5,44,59,104,0,Ligue_1,2023_2024
Yoram Zague,FRA,DF,Paris S-G,17,2006,4.1,18,8,11,4,3,11,24,45.8,13,3,0,3,4,22,9,1,Ligue_1,2023_2024
Warren Zaïre-Emery,FRA,"MF,DF",Paris S-G,17,2006,21.8,51,28,18,24,9,28,51,54.9,23,32,8,24,15,66,22,2,Ligue_1,2023_2024
Denis Zakaria,SUI,"MF,DF",Monaco,26,1996,23.7,38,27,11,20,7,12,30,40.0,18,39,13,26,47,85,41,0,Ligue_1,2023_2024
Mehdi Zeffane,ALG,"DF,MF",Clermont Foot,31,1992,13.7,31,20,17,11,3,17,34,50.0,17,14,3,11,16,47,34,0,Ligue_1,2023_2024
Nathan Zeze,FRA,DF,Nantes,18,2005,11.4,11,6,9,2,0,7,14,50.0,7,12,3,9,12,23,47,1,Ligue_1,2023_2024
Edon Zhegrova,KVX,FW,Lille,24,1999,25.4,32,18,9,15,8,14,36,38.9,22,17,1,16,8,40,8,0,Ligue_1,2023_2024
Luc Zogbé,CIV,DF,Brest,18,2005,0.1,0,0,0,0,0,0,1,0.0,1,1,1,0,1,1,0,0,Ligue_1,2023_2024
Paxten Aaronson,USA,"MF,DF",Eint Frankfurt,18,2003,1.9,6,5,2,2,2,2,3,66.7,1,2,1,1,0,6,2,0,Bundesliga,2022_2023
Sargis Adamyan,ARM,"FW,MF",Köln,29,1993,7.2,14,7,5,3,6,7,17,41.2,10,12,0,12,4,18,5,0,Bundesliga,2022_2023
Karim Adeyemi,GER,"FW,MF",Dortmund,20,2002,15.4,16,11,6,6,4,8,30,26.7,22,18,1,17,7,23,3,0,Bundesliga,2022_2023
Amine Adli,MAR,"FW,MF",Leverkusen,22,2000,15.9,18,10,4,6,8,5,17,29.4,12,28,2,26,6,24,7,0,Bundesliga,2022_2023
Felix Agu,GER,"DF,FW",Werder Bremen,22,1999,0.5,1,0,0,1,0,0,0,,0,1,1,0,0,1,0,0,Bundesliga,2022_2023
Naouirou Ahamada,FRA,MF,Stuttgart,20,2002,15.5,17,11,7,7,3,8,20,40.0,12,16,5,11,8,25,7,0,Bundesliga,2022_2023
Ludovic Ajorque,FRA,"FW,MF",Mainz 05,28,1994,13.5,6,5,1,4,1,1,9,11.1,8,8,2,6,1,7,8,0,Bundesliga,2022_2023
Kevin Akpoguma,NGA,DF,Hoffenheim,27,1995,21.7,75,44,45,27,3,32,45,71.1,13,45,16,29,24,99,70,1,Bundesliga,2022_2023
Lucas Alario,ARG,"FW,MF",Eint Frankfurt,29,1992,3.7,3,2,1,0,2,0,1,0.0,1,0,0,0,2,5,13,0,Bundesliga,2022_2023
Faride Alidou,GER,"DF,MF",Eint Frankfurt,21,2001,2.0,8,5,3,4,1,3,9,33.3,6,3,0,3,1,9,3,0,Bundesliga,2022_2023
Éder Álvarez Balanta,COL,"MF,FW",Schalke 04,29,1993,2.6,5,4,2,3,0,2,6,33.3,4,0,0,0,3,8,4,0,Bundesliga,2022_2023
Lukáš Ambros,CZE,MF,Wolfsburg,18,2004,0.2,1,0,1,0,0,1,4,25.0,3,1,0,1,0,1,2,1,Bundesliga,2022_2023
Nadiem Amiri,GER,"MF,FW",Leverkusen,25,1996,10.9,15,6,5,8,2,9,20,45.0,11,12,1,11,6,21,10,2,Bundesliga,2022_2023
Robert Andrich,GER,MF,Leverkusen,27,1994,26.7,61,38,30,27,4,26,45,57.8,19,27,9,18,42,103,55,2,Bundesliga,2022_2023
Angeliño,ESP,DF,Hoffenheim,25,1997,29.1,40,24,19,18,3,23,37,62.2,14,32,6,26,25,65,67,0,Bundesliga,2022_2023
Waldemar Anton,GER,DF,Stuttgart,26,1996,32.6,49,27,27,19,3,27,51,52.9,24,44,16,28,38,87,123,2,Bundesliga,2022_2023
Christopher Antwi-Adjei,GHA,"FW,MF",Bochum,28,1994,22.0,23,15,7,8,8,10,29,34.5,19,17,0,17,5,28,16,0,Bundesliga,2022_2023
Charles Aránguiz,CHI,MF,Leverkusen,33,1989,5.5,17,7,7,10,0,12,20,60.0,8,4,0,4,7,24,4,0,Bundesliga,2022_2023
Maximilian Arnold,GER,MF,Wolfsburg,28,1994,30.7,62,31,25,28,9,28,54,51.9,26,34,11,23,26,88,65,2,Bundesliga,2022_2023
Takuma Asano,JPN,"FW,MF",Bochum,27,1994,19.0,14,9,4,4,6,7,16,43.8,9,17,1,16,8,22,8,0,Bundesliga,2022_2023
Fisnik Asllani,KVX,FW,Hoffenheim,19,2002,1.9,0,0,0,0,0,0,4,0.0,4,2,0,2,3,3,3,0,Bundesliga,2022_2023
Mehmet Aydin,GER,"DF,FW",Schalke 04,20,2002,6.3,25,18,14,9,2,11,24,45.8,13,11,0,11,10,35,15,0,Bundesliga,2022_2023
Ayman Azhil,MAR,MF,Leverkusen,21,2001,0.0,0,0,0,0,0,0,0,,0,0,0,0,0,0,0,0,Bundesliga,2022_2023
Sardar Azmoun,IRN,"FW,MF",Leverkusen,27,1995,10.3,6,3,1,4,1,1,7,14.3,6,4,0,4,2,8,14,0,Bundesliga,2022_2023
Sanoussy Ba,GER,DF,RB Leipzig,18,2004,0.0,0,0,0,0,0,0,0,,0,0,0,0,0,0,0,0,Bundesliga,2022_2023
Mitchel Bakker,NED,"DF,MF",Leverkusen,22,2000,18.4,16,8,9,7,0,6,15,40.0,9,20,2,18,15,31,20,2,Bundesliga,2022_2023
Ridle Baku,GER,"DF,FW",Wolfsburg,24,1998,28.7,50,26,29,17,4,32,58,55.2,26,44,6,38,21,71,59,0,Bundesliga,2022_2023
Aymen Barkok,MAR,MF,Mainz 05,24,1998,6.5,18,8,10,5,3,5,10,50.0,5,7,0,7,3,21,9,0,Bundesliga,2022_2023
Leandro Barreiro Martins,LUX,MF,Mainz 05,22,2000,23.8,60,38,19,28,13,22,49,44.9,27,38,13,25,41,101,39,1,Bundesliga,2022_2023
Gil Bastião Dias,POR,FW,Stuttgart,25,1996,4.4,8,6,3,4,1,3,12,25.0,9,7,0,7,2,10,3,0,Bundesliga,2022_2023
Maximilian Bauer,GER,DF,Augsburg,22,2000,20.5,31,17,18,12,1,17,34,50.0,17,25,9,16,23,54,79,1,Bundesliga,2022_2023
Oliver Baumann,GER,GK,Hoffenheim,32,1990,34.0,0,0,0,0,0,0,0,,0,0,0,0,0,0,15,1,Bundesliga,2022_2023
Timo Baumgartl,GER,DF,Union Berlin,26,1996,6.2,11,6,5,4,2,5,18,27.8,13,12,4,8,2,13,14,0,Bundesliga,2022_2023
Julian Baumgartlinger,AUT,MF,Augsburg,34,1988,6.2,15,4,5,6,4,6,19,31.6,13,4,2,2,4,19,15,0,Bundesliga,2022_2023
Christoph Baumgartner,AUT,"MF,FW",Hoffenheim,22,1999,28.5,36,19,12,17,7,9,52,17.3,43,57,5,52,15,51,19,1,Bundesliga,2022_2023
Noah Joel Sarenren Bazee,NGA,"MF,FW",Augsburg,25,1996,0.2,0,0,0,0,0,0,1,0.0,1,1,0,1,0,0,0,0,Bundesliga,2022_2023
Ihlas Bebou,TOG,"FW,DF",Hoffenheim,28,1994,15.7,19,16,8,7,4,11,17,64.7,6,9,2,7,7,26,15,0,Bundesliga,2022_2023
Sheraldo Becker,SUR,FW,Union Berlin,27,1995,28.4,15,5,1,7,7,2,11,18.2,9,13,1,12,3,18,7,1,Bundesliga,2022_2023
Kevin Behrens,GER,FW,Union Berlin,31,1991,17.1,11,7,4,4,3,4,18,22.2,14,18,3,15,5,16,25,0,Bundesliga,2022_2023
Stefan Bell,GER,DF,Mainz 05,30,1991,26.6,43,28,32,10,1,22,44,50.0,22,42,15,27,44,87,133,0,Bundesliga,2022_2023
Karim Bellarabi,GER,"FW,MF",Leverkusen,32,1990,0.9,2,0,1,1,0,2,3,66.7,1,0,0,0,0,2,0,0,Bundesliga,2022_2023
Jude Bellingham,ENG,MF,Dortmund,19,2003,29.9,76,42,28,34,14,34,51,66.7,17,51,4,47,35,111,30,0,Bundesliga,2022_2023
Ramy Bensebaini,ALG,DF,Gladbach,27,1995,27.6,34,21,21,10,3,26,39,66.7,13,44,14,30,36,70,98,1,Bundesliga,2022_2023
Mergim Berisha,GER,FW,Augsburg,24,1998,18.7,11,6,4,3,4,4,14,28.6,10,16,1,15,0,11,19,0,Bundesliga,2022_2023
Ermin Bičakčić,BIH,DF,Hoffenheim,32,1990,2.9,8,4,6,1,1,2,6,33.3,4,4,3,1,5,13,14,0,Bundesliga,2022_2023
Tom Bischof,GER,"MF,FW",Hoffenheim,17,2005,3.5,15,10,8,3,4,7,10,70.0,3,5,1,4,1,16,1,0,Bundesliga,2022_2023
Leonardo Bittencourt,GER,"MF,DF",Werder Bremen,28,1993,18.1,53,28,20,25,8,25,62,40.3,37,13,0,13,10,63,15,0,Bundesliga,2022_2023
Janis Blaswich,GER,GK,RB Leipzig,31,1991,26.0,0,0,0,0,0,0,0,,0,0,0,0,0,0,10,0,Bundesliga,2022_2023
Daley Blind,NED,"DF,MF",Bayern Munich,32,1990,1.5,2,0,2,0,0,0,1,0.0,1,4,2,2,2,4,6,0,Bundesliga,2022_2023
Kevin-Prince Boateng,GHA,MF,Hertha BSC,35,1987,5.2,8,6,4,2,2,3,9,33.3,6,11,3,8,3,11,5,0,Bundesliga,2022_2023
Jean-Paul Boëtius,NED,MF,Hertha BSC,28,1994,11.7,30,16,19,9,2,8,25,32.0,17,25,5,20,14,44,10,0,Bundesliga,2022_2023
Yvandro Borges Sanches,LUX,"FW,MF",Gladbach,18,2004,0.3,2,2,0,2,0,2,2,100.0,0,0,0,0,0,2,0,0,Bundesliga,2022_2023
Sebastiaan Bornauw,BEL,DF,Wolfsburg,23,1999,21.4,29,17,17,10,2,16,22,72.7,6,27,12,15,31,60,83,1,Bundesliga,2022_2023
Rafael Borré,COL,"MF,FW",Eint Frankfurt,26,1995,12.0,25,15,4,13,8,4,17,23.5,13,10,2,8,2,27,9,0,Bundesliga,2022_2023
Julian Brandt,GER,"MF,FW",Dortmund,26,1996,26.6,29,20,6,14,9,12,43,27.9,31,23,0,23,15,44,9,1,Bundesliga,2022_2023
Fabian Bredlow,GER,GK,Stuttgart,27,1995,15.0,1,1,1,0,0,1,1,100.0,0,0,0,0,0,1,4,2,Bundesliga,2022_2023
Josip Brekalo,CRO,"MF,FW",Wolfsburg,24,1998,3.0,2,1,2,0,0,0,4,0.0,4,0,0,0,2,4,2,0,Bundesliga,2022_2023
John Brooks,USA,DF,Hoffenheim,29,1993,15.0,18,12,10,8,0,13,18,72.2,5,17,12,5,10,28,105,0,Bundesliga,2022_2023
Moritz Broschinski,GER,"FW,MF",Bochum,21,2000,2.4,0,0,0,0,0,0,5,0.0,5,1,0,1,0,0,6,0,Bundesliga,2022_2023
Cédric Brunner,SUI,DF,Schalke 04,28,1994,25.7,39,27,26,11,2,30,45,66.7,15,24,7,17,43,82,79,0,Bundesliga,2022_2023
Jacob Bruun Larsen,DEN,FW,Hoffenheim,23,1998,3.6,4,3,0,1,3,3,4,75.0,1,3,1,2,1,5,0,0,Bundesliga,2022_2023
Lee Buchanan,ENG,"DF,FW",Werder Bremen,21,2001,5.2,14,10,2,11,1,6,12,50.0,6,5,0,5,12,26,21,0,Bundesliga,2022_2023
Marius Bülter,GER,"FW,MF",Schalke 04,29,1993,28.9,22,11,8,7,7,12,32,37.5,20,34,1,33,10,32,20,0,Bundesliga,2022_2023
Delano Burgzorg,SUR,"FW,MF",Mainz 05,23,1998,2.7,3,3,1,1,1,2,3,66.7,1,2,0,2,0,3,2,0,Bundesliga,2022_2023
Jonathan Burkardt,GER,"MF,FW",Mainz 05,22,2000,5.9,3,1,0,1,2,1,4,25.0,3,6,1,5,1,4,1,0,Bundesliga,2022_2023
Oliver Burke,SCO,"FW,MF",Werder Bremen,25,1997,3.0,1,0,0,0,1,0,0,,0,2,0,2,0,1,0,0,Bundesliga,2022_2023
Aurélio Buta,POR,DF,Eint Frankfurt,25,1997,14.6,33,19,15,13,5,15,27,55.6,12,18,1,17,9,42,34,0,Bundesliga,2022_2023
Anthony Caci,FRA,DF,Mainz 05,25,1997,22.6,58,33,32,20,6,28,42,66.7,14,28,4,24,54,112,40,0,Bundesliga,2022_2023
Kerim Calhanoglu,GER,DF,Schalke 04,19,2002,0.7,2,1,2,0,0,2,2,100.0,0,1,0,1,0,2,3,0,Bundesliga,2022_2023
Daniel Caligiuri,ITA,"DF,MF",Augsburg,34,1988,3.2,8,5,5,3,0,4,5,80.0,1,3,2,1,3,11,2,0,Bundesliga,2022_2023
Emre Can,GER,MF,Dortmund,28,1994,21.1,57,28,25,27,5,22,43,51.2,21,16,6,10,25,82,39,1,Bundesliga,2022_2023
João Cancelo,POR,"DF,FW",Bayern Munich,28,1994,11.2,23,14,9,10,4,10,23,43.5,13,14,2,12,15,38,22,0,Bundesliga,2022_2023
Irvin Cardona,FRA,"MF,FW",Augsburg,24,1997,3.5,1,1,1,0,0,1,5,20.0,4,3,0,3,4,5,8,0,Bundesliga,2022_2023
Koen Casteels,BEL,GK,Wolfsburg,30,1992,34.0,0,0,0,0,0,0,0,,0,0,0,0,1,1,10,1,Bundesliga,2022_2023
Julian Chabot,GER,DF,Köln,24,1998,20.0,36,23,19,14,3,20,35,57.1,15,30,18,12,41,77,105,0,Bundesliga,2022_2023
Timothy Chandler,USA,DF,Eint Frankfurt,32,1990,1.0,2,2,2,0,0,2,2,100.0,0,1,0,1,0,2,3,0,Bundesliga,2022_2023
Fabio Chiarodia,ITA,DF,Werder Bremen,17,2005,0.7,0,0,0,0,0,0,0,,0,1,0,1,2,2,4,0,Bundesliga,2022_2023
Oliver Christensen,DEN,GK,Hertha BSC,23,1999,33.0,1,0,1,0,0,0,2,0.0,2,0,0,0,0,1,22,2,Bundesliga,2022_2023
Darko Churlinov,MKD,FW,Stuttgart,22,2000,0.3,3,2,2,1,0,2,3,66.7,1,1,0,1,0,3,0,0,Bundesliga,2022_2023
Tolga Ciğerci,TUR,MF,Hertha BSC,30,1992,7.5,16,13,6,9,1,10,16,62.5,6,6,2,4,8,24,5,0,Bundesliga,2022_2023
David Čolina,CRO,"DF,FW",Augsburg,22,2000,1.8,4,1,1,1,2,2,2,100.0,0,8,0,8,4,8,3,0,Bundesliga,2022_2023
Kingsley Coman,FRA,"FW,MF",Bayern Munich,26,1996,15.7,11,8,3,5,3,7,17,41.2,10,19,1,18,2,13,7,0,Bundesliga,2022_2023
Danny da Costa,GER,DF,Mainz 05,29,1993,13.7,20,16,7,8,5,12,20,60.0,8,22,3,19,9,29,26,0,Bundesliga,2022_2023
Soumaïla Coulibaly,FRA,DF,Dortmund,18,2003,0.5,0,0,0,0,0,0,0,,0,0,0,0,0,0,0,1,Bundesliga,2022_2023
Tanguy Coulibaly,FRA,"FW,DF",Stuttgart,21,2001,3.6,12,9,9,1,2,5,12,41.7,7,10,0,10,3,15,0,0,Bundesliga,2022_2023
Nicolas Cozza,FRA,DF,Wolfsburg,23,1999,1.1,3,3,1,2,0,2,3,66.7,1,3,1,2,0,3,0,0,Bundesliga,2022_2023
Moanes Dabbur,ISR,FW,Hoffenheim,30,1992,10.4,11,8,4,5,2,3,9,33.3,6,8,0,8,5,16,0,0,Bundesliga,2022_2023
Finn Dahmen,GER,GK,Mainz 05,24,1998,8.0,0,0,0,0,0,0,0,,0,0,0,0,0,0,3,0,Bundesliga,2022_2023
Mahmoud Dahoud,GER,MF,Dortmund,26,1996,3.7,11,9,3,4,4,7,7,100.0,0,6,2,4,7,18,3,0,Bundesliga,2022_2023
Muhammed Damar,GER,MF,Hoffenheim,18,2004,1.8,6,3,1,2,3,1,2,50.0,1,3,0,3,0,6,0,0,Bundesliga,2022_2023
Márton Dárdai,HUN,"DF,MF",Hertha BSC,20,2002,10.5,17,8,9,8,0,9,18,50.0,9,14,9,5,11,28,45,1,Bundesliga,2022_2023
Vladimír Darida,CZE,MF,Hertha BSC,31,1990,0.3,1,1,0,1,0,0,0,,0,1,0,1,0,1,0,0,Bundesliga,2022_2023
Alphonso Davies,CAN,DF,Bayern Munich,21,2000,22.7,45,28,25,13,7,18,39,46.2,21,28,4,24,24,69,24,4,Bundesliga,2022_2023
Thomas Delaney,DEN,MF,Hoffenheim,30,1991,3.3,6,3,3,2,1,3,8,37.5,5,5,0,5,1,7,4,0,Bundesliga,2022_2023
Kerem Demirbay,GER,MF,Leverkusen,29,1993,17.2,36,18,16,17,3,18,34,52.9,16,26,6,20,16,52,11,0,Bundesliga,2022_2023
Ermedin Demirović,BIH,"FW,MF",Augsburg,24,1998,26.3,31,14,9,12,10,9,22,40.9,13,31,4,27,14,45,37,0,Bundesliga,2022_2023
Sepp van den Berg,NED,DF,Schalke 04,20,2001,7.7,5,4,2,2,1,1,4,25.0,3,8,5,3,13,18,33,2,Bundesliga,2022_2023
Moussa Diaby,FRA,"FW,MF",Leverkusen,23,1999,30.0,14,8,4,8,2,7,14,50.0,7,8,0,8,5,19,3,0,Bundesliga,2022_2023
Abdou Diallo,SEN,"DF,MF",RB Leipzig,26,1996,5.3,6,5,5,1,0,1,3,33.3,2,8,5,3,8,14,22,0,Bundesliga,2022_2023
Justin Diehl,GER,"MF,FW",Köln,17,2004,0.2,0,0,0,0,0,0,0,,0,0,0,0,0,0,0,0,Bundesliga,2022_2023
Florian Dietz,GER,FW,Köln,23,1998,4.4,2,1,0,2,0,1,4,25.0,3,4,1,3,0,2,2,0,Bundesliga,2022_2023
Junior Dina Ebimbe,FRA,"DF,MF",Eint Frankfurt,21,2000,11.8,30,19,16,14,0,16,33,48.5,17,18,5,13,11,41,20,0,Bundesliga,2022_2023
Eren Dinkçi,GER,"FW,MF",Werder Bremen,20,2001,2.6,5,5,2,1,2,2,6,33.3,4,2,0,2,0,5,2,0,Bundesliga,2022_2023
Ritsu Doan,JPN,"MF,FW",Freiburg,24,1998,26.9,61,29,19,29,13,25,55,45.5,30,40,1,39,14,75,12,0,Bundesliga,2022_2023
Danilho Doekhi,NED,DF,Union Berlin,24,1998,24.6,38,23,21,17,0,14,26,53.8,12,27,12,15,29,67,93,0,Bundesliga,2022_2023
Kasper Dolberg,DEN,"FW,MF",Hoffenheim,24,1997,4.5,7,5,1,4,2,4,6,66.7,2,6,2,4,0,7,5,0,Bundesliga,2022_2023
Niklas Dorsch,GER,MF,Augsburg,24,1998,5.4,21,12,8,11,2,9,16,56.3,7,9,3,6,6,27,9,0,Bundesliga,2022_2023
Dion Drena Beljo,CRO,FW,Augsburg,20,2002,12.5,7,6,3,2,2,2,13,15.4,11,15,2,13,1,8,14,0,Bundesliga,2022_2023
Dominick Drexler,GER,"MF,FW",Schalke 04,32,1990,15.2,25,17,12,10,3,9,22,40.9,13,18,2,16,8,33,12,0,Bundesliga,2022_2023
Marvin Ducksch,GER,FW,Werder Bremen,28,1994,31.7,8,3,2,4,2,3,16,18.8,13,13,2,11,9,17,41,1,Bundesliga,2022_2023
Ondrej Duda,SVK,MF,Köln,27,1994,7.7,9,8,2,5,2,4,11,36.4,7,7,1,6,2,11,3,0,Bundesliga,2022_2023
Julien Duranville,BEL,MF,Dortmund,16,2006,0.3,1,1,0,1,0,1,1,100.0,0,0,0,0,0,1,0,0,Bundesliga,2022_2023
Maximilian Eggestein,GER,MF,Freiburg,25,1996,27.2,51,29,21,24,6,17,35,48.6,18,37,8,29,36,87,27,0,Bundesliga,2022_2023
Lilian Egloff,GER,"MF,FW",Stuttgart,19,2002,2.7,12,10,4,5,3,4,6,66.7,2,2,0,2,1,13,1,0,Bundesliga,2022_2023
Kingsley Ehizibue,NED,DF,Köln,27,1995,0.7,0,0,0,0,0,0,0,,0,1,0,1,2,2,1,0,Bundesliga,2022_2023
Julian Eitschberger,GER,FW,Hertha BSC,18,2004,0.0,0,0,0,0,0,0,0,,0,0,0,0,0,0,0,0,Bundesliga,2022_2023
Chidera Ejuke,NGA,"FW,MF",Hertha BSC,24,1998,9.9,5,4,1,4,0,1,5,20.0,4,4,0,4,4,9,1,0,Bundesliga,2022_2023
Nico Elvedi,SUI,DF,Gladbach,25,1996,31.4,46,24,32,12,2,27,41,65.9,14,31,16,15,35,81,149,3,Bundesliga,2022_2023
Wataru Endo,JPN,MF,Stuttgart,29,1993,32.5,70,37,30,31,9,38,85,44.7,47,44,6,38,26,96,63,0,Bundesliga,2022_2023
Arne Engels,BEL,MF,Augsburg,18,2003,16.0,20,9,9,10,1,8,19,42.1,11,17,5,12,15,35,12,1,Bundesliga,2022_2023
Tjark Ernst,GER,GK,Hertha BSC,19,2003,1.0,0,0,0,0,0,0,0,,0,0,0,0,0,0,1,0,Bundesliga,2022_2023
Kimberly Ezekwem,GER,DF,Freiburg,21,2001,0.1,0,0,0,0,0,0,0,,0,1,0,1,0,0,0,0,Bundesliga,2022_2023
Ralf Fährmann,GER,GK,Schalke 04,33,1988,11.4,1,0,1,0,0,1,1,100.0,0,0,0,0,0,1,10,2,Bundesliga,2022_2023
Ohis Felix Uduokhai,GER,DF,Augsburg,24,1997,16.1,30,20,14,13,3,15,29,51.7,14,27,14,13,29,59,61,1,Bundesliga,2022_2023
Edimilson Fernandes,SUI,DF,Mainz 05,26,1996,27.1,35,25,26,5,4,18,34,52.9,16,37,16,21,54,89,87,2,Bundesliga,2022_2023
Kilian Fischer,GER,"DF,FW",Wolfsburg,21,2000,5.6,9,6,3,4,2,6,11,54.5,5,6,0,6,5,14,18,0,Bundesliga,2022_2023
Mark Flekken,NED,GK,Freiburg,29,1993,34.0,0,0,0,0,0,0,1,0.0,1,1,0,1,0,0,9,5,Bundesliga,2022_2023
Florian Flick,GER,MF,Schalke 04,22,2000,5.7,12,3,7,5,0,4,14,28.6,10,9,3,6,4,16,18,0,Bundesliga,2022_2023
Emil Forsberg,SWE,"MF,FW",RB Leipzig,30,1991,16.5,16,11,1,8,7,6,20,30.0,14,25,2,23,3,19,7,0,Bundesliga,2022_2023
Philipp Förster,GER,MF,Bochum,27,1995,14.5,31,19,11,15,5,12,40,30.0,28,22,0,22,6,37,6,0,Bundesliga,2022_2023
Timothy Fosu-Mensah,NED,DF,Leverkusen,24,1998,2.1,7,5,3,3,1,4,4,100.0,0,2,0,2,0,7,1,0,Bundesliga,2022_2023
Raphael Framberger,GER,"DF,FW",Augsburg,26,1995,2.0,10,6,6,4,0,3,5,60.0,2,2,1,1,2,12,5,0,Bundesliga,2022_2023
Bartol Franjić,CRO,MF,Wolfsburg,22,2000,2.5,4,2,2,2,0,0,2,0.0,2,4,1,3,5,9,4,0,Bundesliga,2022_2023
Oscar Fraulo,DEN,"FW,MF",Gladbach,18,2003,0.1,0,0,0,0,0,0,0,,0,0,0,0,0,0,0,0,Bundesliga,2022_2023
Michael Frey,SUI,FW,Schalke 04,28,1994,9.6,13,5,2,8,3,4,13,30.8,9,6,0,6,2,15,1,0,Bundesliga,2022_2023
Marco Friedl,AUT,DF,Werder Bremen,24,1998,28.8,62,46,40,22,0,41,68,60.3,27,46,17,29,58,120,127,1,Bundesliga,2022_2023
Marvin Friedrich,GER,DF,Gladbach,26,1995,13.9,17,11,13,3,1,10,13,76.9,3,14,6,8,11,28,52,0,Bundesliga,2022_2023
Jeremie Frimpong,NED,"DF,MF",Leverkusen,21,2000,30.1,53,27,22,26,5,23,44,52.3,21,24,3,21,16,69,40,0,Bundesliga,2022_2023
Chris Führich,GER,"FW,MF",Stuttgart,24,1998,20.9,36,14,15,14,7,24,44,54.5,20,29,2,27,7,43,13,0,Bundesliga,2022_2023
Angelo Fulgini,FRA,MF,Mainz 05,25,1996,5.8,6,5,2,3,1,5,12,41.7,7,5,0,5,5,11,7,0,Bundesliga,2022_2023
Niclas Füllkrug,GER,FW,Werder Bremen,29,1993,27.5,9,4,0,6,3,3,13,23.1,10,13,4,9,1,10,24,0,Bundesliga,2022_2023
Cristian Gamboa,CRC,DF,Bochum,32,1989,16.4,42,24,27,14,1,21,31,67.7,10,20,7,13,16,58,34,1,Bundesliga,2022_2023
Silvère Ganvoula M'Boussy,CGO,"FW,MF",Bochum,26,1996,2.7,2,2,0,1,1,0,0,,0,0,0,0,0,2,3,0,Bundesliga,2022_2023
Dario Gebuhr,GER,DF,Eint Frankfurt,19,2003,0.2,0,0,0,0,0,0,1,0.0,1,0,0,0,0,0,0,0,Bundesliga,2022_2023
Dennis Geiger,GER,MF,Hoffenheim,24,1998,21.7,45,25,15,28,2,22,35,62.9,13,27,3,24,24,69,18,2,Bundesliga,2022_2023
Yannick Gerhardt,GER,MF,Wolfsburg,28,1994,20.7,29,15,10,11,8,12,30,40.0,18,26,5,21,7,36,24,0,Bundesliga,2022_2023
Niko Gießelmann,GER,DF,Union Berlin,30,1991,14.5,21,11,9,9,3,13,31,41.9,18,17,5,12,9,30,28,0,Bundesliga,2022_2023
Rafał Gikiewicz,POL,GK,Augsburg,34,1987,23.0,2,2,2,0,0,2,3,66.7,1,0,0,0,0,2,15,5,Bundesliga,2022_2023
Matthias Ginter,GER,DF,Freiburg,28,1994,34.0,43,20,29,12,2,26,40,65.0,14,40,24,16,35,78,153,3,Bundesliga,2022_2023
Jamie Gittens,ENG,"FW,MF",Dortmund,17,2004,5.9,8,4,2,5,1,2,7,28.6,5,1,0,1,1,9,2,0,Bundesliga,2022_2023
Serge Gnabry,GER,"FW,MF",Bayern Munich,27,1995,21.6,35,23,11,14,10,17,43,39.5,26,24,1,23,11,46,5,1,Bundesliga,2022_2023
Jacek Góralski,POL,MF,Bochum,29,1992,1.6,6,3,3,3,0,4,6,66.7,2,4,0,4,3,9,5,0,Bundesliga,2022_2023
Leon Goretzka,GER,MF,Bayern Munich,27,1995,19.2,43,24,21,16,6,27,48,56.3,21,40,3,37,30,73,32,0,Bundesliga,2022_2023
Mario Götze,GER,MF,Eint Frankfurt,30,1992,30.4,42,25,13,22,7,14,47,29.8,33,25,0,25,13,55,12,0,Bundesliga,2022_2023
Jeffrey Gouweleeuw,NED,DF,Augsburg,31,1991,31.1,42,27,19,17,6,24,49,49.0,25,41,23,18,50,92,141,2,Bundesliga,2022_2023
Ryan Gravenberch,NED,MF,Bayern Munich,20,2002,6.4,17,8,4,10,3,7,13,53.8,6,9,1,8,9,26,10,0,Bundesliga,2022_2023
Michael Gregoritsch,AUT,FW,Freiburg,28,1994,23.9,19,12,6,9,4,3,21,14.3,18,23,4,19,5,24,10,0,Bundesliga,2022_2023
Leo Greiml,AUT,DF,Schalke 04,21,2001,4.0,10,5,4,5,1,5,12,41.7,7,7,3,4,3,13,16,0,Bundesliga,2022_2023
Vincenzo Grifo,ITA,"MF,FW",Freiburg,29,1993,26.8,29,16,6,15,8,13,31,41.9,18,18,1,17,19,48,19,0,Bundesliga,2022_2023
Lennart Grill,GER,GK,Union Berlin,23,1999,5.0,0,0,0,0,0,0,1,0.0,1,0,0,0,0,0,1,1,Bundesliga,2022_2023
Christian Groß,GER,MF,Werder Bremen,33,1989,21.0,56,25,20,34,2,29,60,48.3,31,20,5,15,23,79,38,1,Bundesliga,2022_2023
Brajan Gruda,GER,MF,Mainz 05,18,2004,0.0,0,0,0,0,0,0,0,,0,0,0,0,0,0,0,0,Bundesliga,2022_2023
Ilia Gruev,BUL,MF,Werder Bremen,22,2000,17.6,44,27,16,25,3,18,31,58.1,13,23,6,17,22,66,21,1,Bundesliga,2022_2023
Carlos Gruezo,ECU,MF,Augsburg,27,1995,10.7,21,12,12,9,0,9,16,56.3,7,13,4,9,10,31,15,0,Bundesliga,2022_2023
Raphaël Guerreiro,POR,"DF,MF",Dortmund,28,1993,25.4,36,20,13,15,8,21,34,61.8,13,21,2,19,36,72,23,0,Bundesliga,2022_2023
Josuha Guilavogui,FRA,"DF,MF",Wolfsburg,31,1990,13.1,18,11,7,10,1,6,17,35.3,11,19,13,6,23,41,52,0,Bundesliga,2022_2023
Serhou Guirassy,GUI,FW,Stuttgart,26,1996,18.3,4,1,2,2,0,1,2,50.0,1,7,2,5,0,4,14,0,Bundesliga,2022_2023
Péter Gulácsi,HUN,GK,RB Leipzig,32,1990,6.0,0,0,0,0,0,0,0,,0,0,0,0,0,0,2,0,Bundesliga,2022_2023
Manuel Gulde,GER,DF,Freiburg,31,1991,7.1,14,8,10,4,0,2,4,50.0,2,5,1,4,19,33,25,0,Bundesliga,2022_2023
Robert Gumny,POL,DF,Augsburg,24,1998,22.4,34,24,13,15,6,11,27,40.7,16,21,7,14,26,60,62,1,Bundesliga,2022_2023
Christian Günter,GER,"DF,MF",Freiburg,29,1993,30.5,29,21,18,9,2,13,43,30.2,30,22,4,18,16,45,41,0,Bundesliga,2022_2023
Joško Gvardiol,CRO,DF,RB Leipzig,20,2002,24.1,23,17,15,8,0,9,22,40.9,13,34,17,17,34,57,76,1,Bundesliga,2022_2023
Janik Haberer,GER,MF,Union Berlin,28,1994,24.3,29,17,8,18,3,17,48,35.4,31,35,2,33,14,43,25,0,Bundesliga,2022_2023
Alexander Hack,GER,DF,Mainz 05,28,1993,12.6,30,18,21,9,0,19,33,57.6,14,18,5,13,24,54,45,1,Bundesliga,2022_2023
André Hahn,GER,"FW,MF",Augsburg,31,1990,4.3,9,5,4,4,1,8,12,66.7,4,9,2,7,4,13,14,0,Bundesliga,2022_2023
Amadou Haidara,MLI,MF,RB Leipzig,24,1998,15.9,25,11,15,10,0,13,34,38.2,21,26,6,20,26,51,20,0,Bundesliga,2022_2023
Sébastien Haller,CIV,FW,Dortmund,28,1994,13.6,5,4,2,1,2,0,4,0.0,4,8,0,8,1,6,10,0,Bundesliga,2022_2023
Marcel Halstenberg,GER,DF,RB Leipzig,30,1991,17.3,40,21,20,15,5,23,41,56.1,18,22,1,21,21,61,29,0,Bundesliga,2022_2023
Andreas Hanche-Olsen,NOR,DF,Mainz 05,25,1997,16.6,35,23,24,7,4,22,39,56.4,17,16,8,8,33,68,77,2,Bundesliga,2022_2023
Genki Haraguchi,JPN,MF,Stuttgart,31,1991,8.3,16,7,7,7,2,4,16,25.0,12,13,2,11,8,24,6,0,Bundesliga,2022_2023
Genki Haraguchi,JPN,MF,Union Berlin,31,1991,5.5,12,8,1,10,1,3,9,33.3,6,7,1,6,3,15,9,0,Bundesliga,2022_2023
Makoto Hasebe,JPN,DF,Eint Frankfurt,38,1984,14.5,18,12,16,2,0,7,22,31.8,15,22,9,13,17,35,45,0,Bundesliga,2022_2023
Thorgan Hazard,BEL,"FW,DF",Dortmund,29,1993,5.2,17,6,5,11,1,12,17,70.6,5,6,0,6,5,22,5,0,Bundesliga,2022_2023
Jonas Hector,GER,DF,Köln,32,1990,31.4,112,66,59,43,10,66,113,58.4,47,61,9,52,39,151,74,1,Bundesliga,2022_2023
Dominique Heintz,GER,DF,Bochum,28,1993,8.8,13,9,5,7,1,6,17,35.3,11,11,7,4,12,25,34,0,Bundesliga,2022_2023
Benjamin Henrichs,GER,"DF,MF",RB Leipzig,25,1997,24.3,73,46,41,29,3,43,66,65.2,23,48,4,44,35,108,46,0,Bundesliga,2022_2023
Lucas Hernández,FRA,DF,Bayern Munich,26,1996,5.3,6,4,3,3,0,5,6,83.3,1,2,1,1,5,11,7,0,Bundesliga,2022_2023
Patrick Herrmann,GER,"FW,MF",Gladbach,31,1991,1.8,6,2,4,1,1,2,4,50.0,2,2,0,2,2,8,1,0,Bundesliga,2022_2023
Piero Hincapié,ECU,"DF,MF",Leverkusen,20,2002,27.3,51,34,28,20,3,25,38,65.8,13,41,20,21,31,82,83,1,Bundesliga,2022_2023
Adam Hložek,CZE,"FW,MF",Leverkusen,20,2002,14.3,9,4,4,3,2,3,9,33.3,6,9,2,7,6,15,9,0,Bundesliga,2022_2023
Nicolas Höfler,GER,MF,Freiburg,32,1990,31.3,66,35,28,35,3,27,61,44.3,34,40,13,27,58,124,49,0,Bundesliga,2022_2023
Jonas Hofmann,GER,"FW,MF",Gladbach,30,1992,29.8,31,16,17,8,6,15,52,28.8,37,36,2,34,16,47,21,0,Bundesliga,2022_2023
Philipp Hofmann,GER,FW,Bochum,29,1993,29.2,18,11,0,13,5,5,12,41.7,7,20,8,12,6,24,48,0,Bundesliga,2022_2023
Lucas Höler,GER,"FW,MF",Freiburg,28,1994,16.7,19,14,5,7,7,6,22,27.3,16,22,5,17,10,29,17,0,Bundesliga,2022_2023
Gerrit Holtmann,PHI,"FW,MF",Bochum,27,1995,10.5,14,7,6,7,1,12,21,57.1,9,15,1,14,2,16,4,0,Bundesliga,2022_2023
Jannes Horn,GER,"DF,FW",Bochum,25,1997,0.7,2,1,1,1,0,1,1,100.0,0,1,0,1,3,5,2,0,Bundesliga,2022_2023
Lukáš Hrádecký,FIN,GK,Leverkusen,32,1989,33.0,0,0,0,0,0,0,0,,0,0,0,0,0,0,3,3,Bundesliga,2022_2023
Timo Hübers,GER,DF,Köln,26,1996,28.4,43,28,35,8,0,24,52,46.2,28,27,13,14,58,101,153,0,Bundesliga,2022_2023
Callum Hudson-Odoi,ENG,"FW,MF",Leverkusen,21,2000,6.7,5,3,4,0,1,1,1,100.0,0,0,0,0,2,7,4,0,Bundesliga,2022_2023
Mats Hummels,GER,DF,Dortmund,33,1988,22.4,62,34,38,22,2,32,55,58.2,23,30,16,14,33,95,100,1,Bundesliga,2022_2023
Denis Huseinbasic,BIH,"MF,FW",Köln,21,2001,8.8,23,9,8,11,4,10,25,40.0,15,16,2,14,4,27,5,0,Bundesliga,2022_2023
Iago,BRA,"DF,MF",Augsburg,25,1997,17.8,34,16,20,10,4,11,29,37.9,18,18,5,13,17,51,53,0,Bundesliga,2022_2023
Arijon Ibrahimović,GER,MF,Bayern Munich,16,2005,0.2,1,1,1,0,0,0,0,,0,0,0,0,0,1,0,0,Bundesliga,2022_2023
Marcus Ingvartsen,DEN,"FW,MF",Mainz 05,26,1996,14.6,4,1,0,2,2,1,10,10.0,9,9,1,8,4,8,10,0,Bundesliga,2022_2023
Ko Itakura,JPN,DF,Gladbach,25,1997,22.0,29,17,18,7,4,16,30,53.3,14,41,25,16,27,56,95,0,Bundesliga,2022_2023
Hiroki Ito,JPN,DF,Stuttgart,23,1999,28.5,40,29,24,14,2,18,35,51.4,17,38,17,21,40,80,94,0,Bundesliga,2022_2023
Andreas Ivan,ROU,MF,Schalke 04,27,1995,0.5,0,0,0,0,0,0,1,0.0,1,0,0,0,0,0,1,0,Bundesliga,2022_2023
Lee Jae-sung,KOR,MF,Mainz 05,29,1992,21.0,38,17,9,21,8,16,36,44.4,20,29,5,24,17,55,21,0,Bundesliga,2022_2023
Paul Jaeckel,GER,DF,Union Berlin,24,1998,13.3,24,18,11,11,2,17,35,48.6,18,11,5,6,19,43,44,1,Bundesliga,2022_2023
Kristijan Jakić,CRO,"DF,MF",Eint Frankfurt,25,1997,16.2,33,21,19,12,2,22,41,53.7,19,32,10,22,14,47,49,1,Bundesliga,2022_2023
Saidy Janko,GAM,DF,Bochum,26,1995,12.6,23,15,13,8,2,12,20,60.0,8,24,10,14,11,34,33,1,Bundesliga,2022_2023
Tony Jantschke,GER,"DF,MF",Gladbach,32,1990,1.1,2,1,1,1,0,1,1,100.0,0,5,3,2,0,2,5,0,Bundesliga,2022_2023
Fredrik Jensen,FIN,"FW,MF",Augsburg,24,1997,10.3,15,10,8,3,4,5,10,50.0,5,12,5,7,4,19,12,0,Bundesliga,2022_2023
Moritz Jenz,GER,DF,Schalke 04,23,1999,10.5,14,11,8,5,1,5,8,62.5,3,16,10,6,8,22,53,1,Bundesliga,2022_2023
Stevan Jovetić,MNE,"FW,MF",Hertha BSC,32,1989,9.9,3,2,2,1,0,1,11,9.1,10,2,1,1,2,5,10,0,Bundesliga,2022_2023
Anthony Jung,GER,"DF,FW",Werder Bremen,30,1991,29.1,46,27,19,20,7,31,58,53.4,27,30,6,24,22,68,63,0,Bundesliga,2022_2023
Josip Juranović,CRO,DF,Union Berlin,26,1995,10.4,9,7,5,2,2,7,18,38.9,11,9,3,6,6,15,22,1,Bundesliga,2022_2023
Ozan Kabak,TUR,DF,Hoffenheim,22,2000,26.5,51,34,27,21,3,17,30,56.7,13,35,23,12,45,96,83,0,Bundesliga,2022_2023
Pavel Kadeřábek,CZE,DF,Hoffenheim,30,1992,18.5,26,20,10,9,7,15,23,65.2,8,12,2,10,14,40,37,1,Bundesliga,2022_2023
Florian Kainz,AUT,"MF,FW",Köln,29,1992,26.0,21,10,7,12,2,8,26,30.8,18,27,6,21,32,53,30,1,Bundesliga,2022_2023
Sasa Kalajdzic,AUT,FW,Stuttgart,25,1997,2.6,3,2,0,1,2,1,3,33.3,2,1,0,1,0,3,0,0,Bundesliga,2022_2023
Daichi Kamada,JPN,MF,Eint Frankfurt,25,1996,25.2,51,31,10,37,4,31,57,54.4,26,31,2,29,16,67,17,1,Bundesliga,2022_2023
Jakub Kamiński,POL,"FW,DF",Wolfsburg,20,2002,22.9,36,25,15,13,8,20,40,50.0,20,37,2,35,8,44,15,0,Bundesliga,2022_2023
Marcin Kamiński,POL,DF,Schalke 04,30,1992,7.0,6,4,4,0,2,2,4,50.0,2,8,7,1,9,15,28,0,Bundesliga,2022_2023
Kevin Kampl,SVN,MF,RB Leipzig,31,1990,15.2,21,11,6,14,1,6,27,22.2,21,26,9,17,22,43,11,0,Bundesliga,2022_2023
Wilfried Kanga,CIV,FW,Hertha BSC,24,1998,15.7,5,4,2,1,2,2,4,50.0,2,14,3,11,2,7,13,0,Bundesliga,2022_2023
Kenan Karaman,TUR,FW,Schalke 04,28,1994,10.8,11,8,3,5,3,3,12,25.0,9,9,1,8,3,14,9,0,Bundesliga,2022_2023
Atakan Karazor,GER,MF,Stuttgart,25,1996,21.8,49,30,18,25,6,24,47,51.1,23,39,11,28,31,80,44,0,Bundesliga,2022_2023
Thomas Kastanaras,GRE,"FW,DF",Stuttgart,19,2003,0.8,0,0,0,0,0,0,0,,0,1,0,1,0,0,0,0,Bundesliga,2022_2023
Silas Katompa,COD,"FW,MF",Stuttgart,23,1998,22.1,25,17,5,14,6,6,20,30.0,14,17,2,15,8,33,1,0,Bundesliga,2022_2023
Yannik Keitel,GER,MF,Freiburg,22,2000,7.6,11,7,4,6,1,3,5,60.0,2,6,3,3,13,24,8,0,Bundesliga,2022_2023
Marc-Oliver Kempf,GER,DF,Hertha BSC,27,1995,30.1,44,27,29,14,1,16,22,72.7,6,42,32,10,51,95,143,0,Bundesliga,2022_2023
Jonjoe Kenny,ENG,DF,Hertha BSC,25,1997,24.9,46,34,27,16,3,24,42,57.1,18,38,9,29,46,92,74,0,Bundesliga,2022_2023
Rani Khedira,GER,MF,Union Berlin,28,1994,32.0,60,33,21,32,7,25,50,50.0,25,33,10,23,40,100,33,0,Bundesliga,2022_2023
Luca Kilian,GER,DF,Köln,22,1999,12.5,22,16,14,7,1,12,21,57.1,9,16,8,8,11,33,48,0,Bundesliga,2022_2023
Joshua Kimmich,GER,MF,Bayern Munich,27,1995,31.2,78,49,24,46,8,38,72,52.8,34,36,7,29,41,119,39,2,Bundesliga,2022_2023
Pascal Klemens,GER,DF,Hertha BSC,17,2005,1.0,0,0,0,0,0,0,1,0.0,1,1,0,1,1,1,3,0,Bundesliga,2022_2023
Lukas Klostermann,GER,DF,RB Leipzig,26,1996,10.1,16,8,7,9,0,8,15,53.3,7,6,3,3,13,29,31,0,Bundesliga,2022_2023
Ansgar Knauff,GER,DF,Eint Frankfurt,20,2002,14.3,36,25,22,11,3,15,34,44.1,19,19,1,18,15,51,26,0,Bundesliga,2022_2023
Robin Knoche,GER,DF,Union Berlin,30,1992,31.9,45,29,29,12,4,24,47,51.1,23,35,18,17,38,83,140,0,Bundesliga,2022_2023
Gregor Kobel,SUI,GK,Dortmund,24,1997,27.0,0,0,0,0,0,0,1,0.0,1,1,0,1,0,0,7,2,Bundesliga,2022_2023
Dominik Kohr,GER,MF,Mainz 05,28,1994,25.5,59,33,23,31,5,29,61,47.5,32,46,9,37,34,93,26,1,Bundesliga,2022_2023
Randal Kolo Muani,FRA,FW,Eint Frankfurt,23,1998,29.2,14,10,3,3,8,1,9,11.1,8,19,2,17,3,17,13,0,Bundesliga,2022_2023
Timothée Kolodziejczak,FRA,DF,Schalke 04,30,1991,0.3,0,0,0,0,0,0,1,0.0,1,0,0,0,1,1,1,0,Bundesliga,2022_2023
Manu Koné,FRA,MF,Gladbach,21,2001,29.0,74,39,37,33,4,24,47,51.1,23,44,12,32,32,106,21,0,Bundesliga,2022_2023
Odilon Kossounou,CIV,DF,Leverkusen,21,2001,16.9,21,14,12,7,2,8,16,50.0,8,26,11,15,24,45,58,1,Bundesliga,2022_2023
Filip Kostić,SRB,"DF,MF",Eint Frankfurt,29,1992,0.8,2,0,1,1,0,0,0,,0,0,0,0,1,3,0,0,Bundesliga,2022_2023
Tomáš Koubek,CZE,GK,Augsburg,29,1992,11.0,0,0,0,0,0,0,0,,0,0,0,0,0,0,7,0,Bundesliga,2022_2023
Soichiro Kozuki,JPN,"FW,MF",Schalke 04,21,2000,4.2,6,4,3,3,0,4,6,66.7,2,5,0,5,3,9,3,0,Bundesliga,2022_2023
Alex Král,CZE,MF,Schalke 04,24,1998,26.2,34,24,10,22,2,17,37,45.9,20,31,6,25,17,51,53,0,Bundesliga,2022_2023
Andrej Kramarić,CRO,"MF,FW",Hoffenheim,31,1991,26.5,5,2,2,1,2,1,11,9.1,10,14,2,12,6,11,13,0,Bundesliga,2022_2023
Christoph Kramer,GER,MF,Gladbach,31,1991,24.7,44,33,24,15,5,22,55,40.0,33,34,2,32,17,61,40,0,Bundesliga,2022_2023
Tom Krauß,GER,MF,Schalke 04,21,2001,27.9,112,68,39,62,11,51,100,51.0,49,39,6,33,36,148,35,0,Bundesliga,2022_2023
Max Kruse,GER,"MF,FW",Wolfsburg,34,1988,3.0,1,1,0,1,0,0,1,0.0,1,2,1,1,0,1,1,0,Bundesliga,2022_2023
Lukas Kübler,GER,DF,Freiburg,29,1992,18.2,37,25,24,9,4,18,30,60.0,12,25,11,14,29,66,50,0,Bundesliga,2022_2023
Pierre Kunde,CMR,"MF,FW",Bochum,27,1995,4.2,12,6,3,8,1,6,14,42.9,8,7,1,6,7,19,9,0,Bundesliga,2022_2023
Alou Kuol,AUS,FW,Stuttgart,21,2000,0.1,0,0,0,0,0,0,0,,0,0,0,0,0,0,0,0,Bundesliga,2022_2023
Daniel Kyereh,GHA,"MF,FW",Freiburg,26,1996,6.2,6,4,2,4,0,3,6,50.0,3,4,0,4,2,8,6,0,Bundesliga,2022_2023
Maxence Lacroix,FRA,DF,Wolfsburg,22,2000,18.1,22,13,15,7,0,8,16,50.0,8,22,11,11,26,48,85,0,Bundesliga,2022_2023
Aïssa Laïdouni,TUN,MF,Union Berlin,25,1996,9.7,14,7,6,8,0,5,17,29.4,12,22,4,18,9,23,3,0,Bundesliga,2022_2023
Konrad Laimer,AUT,MF,RB Leipzig,25,1997,16.3,60,31,23,30,7,30,54,55.6,24,31,4,27,18,78,8,0,Bundesliga,2022_2023
Stefan Lainer,AUT,DF,Gladbach,29,1992,9.1,16,8,10,5,1,10,23,43.5,13,8,1,7,14,30,34,1,Bundesliga,2022_2023
Vassilis Lambropoulos,GRE,DF,Bochum,32,1990,7.0,10,8,7,3,0,6,9,66.7,3,5,3,2,13,23,41,0,Bundesliga,2022_2023
Jordan Larsson,SWE,"FW,MF",Schalke 04,25,1997,5.1,8,5,1,7,0,2,9,22.2,7,9,0,9,4,12,3,0,Bundesliga,2022_2023
Danny Latza,GER,MF,Schalke 04,32,1989,9.5,17,13,8,8,1,5,17,29.4,12,16,1,15,5,22,15,0,Bundesliga,2022_2023
Diogo Leite,POR,DF,Union Berlin,23,1999,25.0,35,20,21,14,0,21,34,61.8,13,23,14,9,26,61,99,1,Bundesliga,2022_2023
Maxim Leitsch,GER,DF,Mainz 05,24,1998,7.4,9,7,6,3,0,4,5,80.0,1,7,4,3,18,27,26,1,Bundesliga,2022_2023
Tim Lemperle,GER,"FW,MF",Köln,20,2002,1.5,6,4,3,1,2,3,5,60.0,2,5,0,5,1,7,4,0,Bundesliga,2022_2023
Christopher Lenz,GER,DF,Eint Frankfurt,27,1994,14.3,29,21,17,7,5,16,37,43.2,21,16,3,13,21,50,34,0,Bundesliga,2022_2023
Jamie Leweling,GER,"FW,MF",Union Berlin,21,2001,2.9,5,3,2,2,1,3,5,60.0,2,3,0,3,1,6,0,0,Bundesliga,2022_2023
Philipp Lienhart,AUT,DF,Freiburg,26,1996,27.8,29,18,19,10,0,13,27,48.1,14,29,15,14,35,64,97,0,Bundesliga,2022_2023
Matthijs de Ligt,NED,DF,Bayern Munich,22,1999,26.7,32,23,15,16,1,15,24,62.5,9,31,20,11,23,55,85,0,Bundesliga,2022_2023
Dimitris Limnios,GRE,FW,Köln,24,1998,0.4,0,0,0,0,0,0,0,,0,0,0,0,1,1,0,0,Bundesliga,2022_2023
Jesper Lindstrøm,DEN,"MF,FW",Eint Frankfurt,22,2000,18.7,26,11,15,7,4,7,22,31.8,15,25,3,22,9,35,9,0,Bundesliga,2022_2023
Dejan Ljubicic,AUT,"MF,FW",Köln,24,1997,19.0,25,14,7,14,4,13,40,32.5,27,20,1,19,8,33,8,1,Bundesliga,2022_2023
Anthony Losilla,FRA,MF,Bochum,36,1986,30.2,76,49,32,34,10,38,77,49.4,39,39,12,27,37,113,67,0,Bundesliga,2022_2023
Dodi Lukebakio,BEL,"FW,MF",Hertha BSC,24,1997,26.6,18,11,7,8,3,6,27,22.2,21,23,5,18,13,31,17,0,Bundesliga,2022_2023
Andrey Lunyov,RUS,GK,Leverkusen,30,1991,1.0,0,0,0,0,0,0,0,,0,0,0,0,0,0,0,0,Bundesliga,2022_2023
Arne Maier,GER,MF,Augsburg,23,1999,21.8,31,22,17,11,3,10,18,55.6,8,21,0,21,15,46,22,0,Bundesliga,2022_2023
Linton Maina,GER,"FW,MF",Köln,23,1999,24.9,18,12,5,11,2,7,30,23.3,23,19,0,19,5,23,9,0,Bundesliga,2022_2023
Donyell Malen,NED,FW,Dortmund,23,1999,19.0,13,5,3,4,6,5,12,41.7,7,14,1,13,4,17,11,0,Bundesliga,2022_2023
Sadio Mané,SEN,"FW,MF",Bayern Munich,30,1992,15.8,11,5,3,3,5,1,9,11.1,8,15,2,13,0,11,4,0,Bundesliga,2022_2023
Myziane Maolida,COM,"FW,MF",Hertha BSC,23,1999,1.1,1,1,1,0,0,1,2,50.0,1,0,0,0,0,1,1,0,Bundesliga,2022_2023
Omar Marmoush,EGY,FW,Wolfsburg,23,1999,16.4,16,10,8,2,6,4,16,25.0,12,21,1,20,7,23,4,0,Bundesliga,2022_2023
Eric Martel,GER,MF,Köln,20,2002,22.4,66,41,29,30,7,30,60,50.0,30,29,9,20,33,99,49,0,Bundesliga,2022_2023
Aarón Martín,ESP,DF,Mainz 05,25,1997,20.5,42,27,25,11,6,21,40,52.5,19,22,1,21,15,57,31,0,Bundesliga,2022_2023
Erhan Mašović,SRB,"DF,MF",Bochum,23,1998,24.2,50,31,28,21,1,30,51,58.8,21,30,14,16,27,77,79,0,Bundesliga,2022_2023
Henning Matriciani,GER,DF,Schalke 04,22,2000,20.7,43,23,28,12,3,26,60,43.3,34,28,11,17,23,66,57,1,Bundesliga,2022_2023
Konstantinos Mavropanos,GRE,DF,Stuttgart,24,1997,25.4,50,27,32,15,3,28,38,73.7,10,39,18,21,63,113,99,0,Bundesliga,2022_2023
Philipp Max,GER,DF,Eint Frankfurt,28,1993,7.7,12,9,4,7,1,5,16,31.3,11,10,2,8,3,15,11,0,Bundesliga,2022_2023
Eric Maxim Choupo-Moting,CMR,FW,Bayern Munich,33,1989,12.4,10,7,2,6,2,1,2,50.0,1,8,0,8,0,10,5,0,Bundesliga,2022_2023
Keke Maximilian Topp,GER,FW,Schalke 04,18,2004,0.2,0,0,0,0,0,0,0,,0,0,0,0,1,1,0,0,Bundesliga,2022_2023
Ibrahim Maza,GER,"MF,FW",Hertha BSC,16,2005,0.8,1,1,1,0,0,0,1,0.0,1,2,0,2,0,1,1,0,Bundesliga,2022_2023
Noussair Mazraoui,MAR,DF,Bayern Munich,24,1997,11.9,29,21,9,9,11,15,24,62.5,9,13,2,11,10,39,25,0,Bundesliga,2022_2023
Noah Mbamba,BEL,MF,Leverkusen,17,2005,0.0,0,0,0,0,0,0,0,,0,0,0,0,0,0,0,0,Bundesliga,2022_2023
Jean-Manuel Mbom,GER,MF,Werder Bremen,22,2000,0.1,0,0,0,0,0,0,1,0.0,1,0,0,0,0,0,0,0,Bundesliga,2022_2023
Nathanael Mbuku,FRA,"MF,FW",Augsburg,20,2002,0.4,1,0,0,1,0,0,0,,0,0,0,0,0,1,0,0,Bundesliga,2022_2023
Thomas Meunier,BEL,DF,Dortmund,30,1991,6.5,16,7,8,5,3,10,17,58.8,7,7,2,5,9,25,16,0,Bundesliga,2022_2023
Alexander Meyer,GER,GK,Dortmund,31,1991,7.0,0,0,0,0,0,0,1,0.0,1,0,0,0,0,0,1,0,Bundesliga,2022_2023
Sven Michel,GER,"FW,MF",Union Berlin,32,1990,5.5,9,5,1,5,3,4,8,50.0,4,5,1,4,0,9,4,0,Bundesliga,2022_2023
Enzo Millot,FRA,MF,Stuttgart,20,2002,9.9,23,16,9,10,4,12,19,63.2,7,20,3,17,12,35,7,0,Bundesliga,2022_2023
Maximilian Mittelstädt,GER,"DF,MF",Hertha BSC,25,1997,9.4,39,20,31,6,2,17,39,43.6,22,13,2,11,26,65,27,0,Bundesliga,2022_2023
Anthony Modeste,FRA,FW,Dortmund,34,1988,9.0,4,4,2,0,2,2,5,40.0,3,7,0,7,2,6,22,0,Bundesliga,2022_2023
Tobias Mohr,GER,"DF,MF",Schalke 04,26,1995,9.3,8,5,3,5,0,2,7,28.6,5,14,5,9,8,16,19,0,Bundesliga,2022_2023
Clinton Mola,ENG,DF,Stuttgart,21,2001,0.2,3,1,2,1,0,1,1,100.0,0,1,1,0,1,4,2,0,Bundesliga,2022_2023
Florent Mollet,FRA,MF,Schalke 04,30,1991,4.6,4,1,0,4,0,2,7,28.6,5,7,1,6,1,5,1,0,Bundesliga,2022_2023
Youssoufa Moukoko,GER,FW,Dortmund,17,2004,12.7,13,7,3,6,4,3,6,50.0,3,9,0,9,2,15,1,0,Bundesliga,2022_2023
Florian Müller,GER,GK,Stuttgart,24,1997,19.0,0,0,0,0,0,0,0,,0,0,0,0,0,0,7,4,Bundesliga,2022_2023
Thomas Müller,GER,"FW,MF",Bayern Munich,32,1989,18.5,21,12,5,9,7,6,16,37.5,10,19,3,16,4,25,16,0,Bundesliga,2022_2023
Jamal Musiala,GER,"MF,FW",Bayern Munich,19,2003,24.4,34,23,9,16,9,13,35,37.1,22,30,3,27,19,53,3,0,Bundesliga,2022_2023
Marlon Mustapha,AUT,"FW,MF",Mainz 05,21,2001,0.8,2,2,0,2,0,0,0,,0,4,0,4,0,2,0,0,Bundesliga,2022_2023
Obite N'Dicka,CIV,DF,Eint Frankfurt,22,1999,29.9,25,18,10,11,4,18,32,56.3,14,47,19,28,31,56,150,0,Bundesliga,2022_2023
Nathan N'Goumou,FRA,FW,Gladbach,22,2000,7.7,11,5,5,5,1,7,13,53.8,6,9,0,9,1,12,4,0,Bundesliga,2022_2023
Stanley N'Soki,FRA,DF,Hoffenheim,23,1999,14.3,22,13,14,7,1,12,22,54.5,10,22,5,17,24,46,34,0,Bundesliga,2022_2023
Nikolas Nartey,DEN,"DF,MF",Stuttgart,22,2000,5.3,11,6,7,3,1,5,9,55.6,4,9,0,9,4,15,12,0,Bundesliga,2022_2023
Luca Netz,GER,DF,Gladbach,19,2003,7.8,25,13,19,3,3,19,32,59.4,13,5,1,4,6,31,27,0,Bundesliga,2022_2023
Manuel Neuer,GER,GK,Bayern Munich,36,1986,12.0,0,0,0,0,0,0,0,,0,0,0,0,0,0,4,1,Bundesliga,2022_2023
Florian Neuhaus,GER,MF,Gladbach,25,1997,15.6,19,9,9,5,5,8,27,29.6,19,20,3,17,12,31,5,0,Bundesliga,2022_2023
Jessic Ngankam,GER,"FW,MF",Hertha BSC,22,2000,9.2,14,9,7,4,3,6,14,42.9,8,6,1,5,1,15,4,0,Bundesliga,2022_2023
Florian Niederlechner,GER,"FW,MF",Augsburg,31,1990,10.1,10,5,5,4,1,4,7,57.1,3,16,2,14,1,11,9,0,Bundesliga,2022_2023
Florian Niederlechner,GER,FW,Hertha BSC,31,1990,8.7,9,7,2,4,3,2,8,25.0,6,7,0,7,3,12,10,0,Bundesliga,2022_2023
Justin Njinmah,GER,FW,Dortmund,21,2000,0.2,0,0,0,0,0,0,0,,0,0,0,0,0,0,0,0,Bundesliga,2022_2023
Christopher Nkunku,FRA,"FW,MF",RB Leipzig,24,1997,21.1,6,4,2,1,3,1,6,16.7,5,8,3,5,8,14,11,0,Bundesliga,2022_2023
Felix Nmecha,GER,MF,Wolfsburg,21,2000,20.4,41,24,11,23,7,16,34,47.1,18,26,10,16,25,66,31,0,Bundesliga,2022_2023
Lukas Nmecha,GER,FW,Wolfsburg,23,1998,10.0,5,3,0,2,3,3,3,100.0,0,5,1,4,3,8,4,0,Bundesliga,2022_2023
Hugo Novoa,ESP,"DF,FW",RB Leipzig,19,2003,2.0,8,2,1,3,4,4,7,57.1,3,4,0,4,1,9,0,0,Bundesliga,2022_2023
Ørjan Nyland,NOR,GK,RB Leipzig,31,1990,2.0,0,0,0,0,0,0,0,,0,0,0,0,0,0,0,0,Bundesliga,2022_2023
Tim Oermann,GER,DF,Bochum,18,2003,2.2,2,1,2,0,0,1,1,100.0,0,3,2,1,1,3,8,1,Bundesliga,2022_2023
Finn Ole Becker,GER,MF,Hoffenheim,22,2000,5.7,10,2,4,6,0,4,7,57.1,3,4,0,4,5,15,8,0,Bundesliga,2022_2023
Mathias Olesen,LUX,MF,Köln,21,2001,5.3,10,5,4,4,2,5,8,62.5,3,6,1,5,2,12,3,0,Bundesliga,2022_2023
Dani Olmo,ESP,"MF,FW",RB Leipzig,24,1998,14.2,15,9,1,10,4,6,14,42.9,8,15,0,15,6,21,6,0,Bundesliga,2022_2023
Jan Olschowsky,GER,GK,Gladbach,20,2001,4.0,0,0,0,0,0,0,1,0.0,1,1,0,1,0,0,1,0,Bundesliga,2022_2023
Jonas Omlin,SUI,GK,Gladbach,28,1994,14.3,1,1,1,0,0,1,3,33.3,2,1,0,1,0,1,9,1,Bundesliga,2022_2023
Karim Onisiwo,AUT,"FW,MF",Mainz 05,30,1992,28.2,19,12,3,10,6,4,21,19.0,17,19,0,19,2,21,7,0,Bundesliga,2022_2023
Willi Orban,HUN,DF,RB Leipzig,29,1992,32.8,51,30,33,18,0,26,43,60.5,17,42,24,18,39,90,129,1,Bundesliga,2022_2023
Ivan Ordets,UKR,DF,Bochum,30,1992,27.2,31,19,21,9,1,16,28,57.1,12,34,17,17,57,88,139,0,Bundesliga,2022_2023
Jordi Osei-Tutu,ENG,"DF,FW",Bochum,23,1998,8.3,23,18,13,5,5,12,23,52.2,11,12,5,7,10,33,8,0,Bundesliga,2022_2023
Patrick Osterhage,GER,MF,Bochum,22,2000,11.4,20,17,8,10,2,11,16,68.8,5,17,6,11,12,32,25,0,Bundesliga,2022_2023
Paulo Otávio,BRA,DF,Wolfsburg,27,1994,22.7,72,46,46,17,9,44,66,66.7,22,42,6,36,30,102,70,1,Bundesliga,2022_2023
Thomas Ouwejan,NED,DF,Schalke 04,25,1996,10.0,20,8,13,5,2,6,10,60.0,4,17,4,13,13,33,27,0,Bundesliga,2022_2023
Reece Oxford,ENG,DF,Augsburg,23,1998,1.0,1,1,1,0,0,0,0,,0,4,3,1,1,2,5,0,Bundesliga,2022_2023
Salih Özcan,TUR,MF,Dortmund,24,1998,17.5,31,18,10,16,5,16,39,41.0,23,24,2,22,28,59,19,1,Bundesliga,2022_2023
Levin Öztunalı,GER,MF,Union Berlin,26,1996,0.1,0,0,0,0,0,0,1,0.0,1,0,0,0,0,0,0,0,Bundesliga,2022_2023
Exequiel Palacios,ARG,MF,Leverkusen,23,1998,18.4,59,36,20,33,6,29,48,60.4,19,29,2,27,33,92,28,0,Bundesliga,2022_2023
Miloš Pantović,SRB,MF,Union Berlin,26,1996,2.3,4,2,4,0,0,3,5,60.0,2,3,0,3,0,4,5,0,Bundesliga,2022_2023
Antonios Papadopoulos,GER,DF,Dortmund,22,1999,0.1,0,0,0,0,0,0,0,,0,0,0,0,1,1,0,0,Bundesliga,2022_2023
Kevin Paredes,USA,"FW,MF",Wolfsburg,19,2003,5.9,13,9,6,3,4,9,12,75.0,3,7,0,7,6,19,8,0,Bundesliga,2022_2023
Marco Pašalić,CRO,MF,Dortmund,21,2000,0.1,0,0,0,0,0,0,0,,0,0,0,0,0,0,0,0,Bundesliga,2022_2023
Felix Passlack,GER,DF,Dortmund,24,1998,0.7,4,3,0,4,0,1,1,100.0,0,1,1,0,0,4,1,0,Bundesliga,2022_2023
Paulinho,BRA,FW,Leverkusen,22,2000,0.9,0,0,0,0,0,0,0,,0,1,0,1,0,0,2,0,Bundesliga,2022_2023
Benjamin Pavard,FRA,DF,Bayern Munich,26,1996,27.0,70,41,36,26,8,36,48,75.0,12,35,16,19,44,114,83,0,Bundesliga,2022_2023
Jiří Pavlenka,CZE,GK,Werder Bremen,30,1992,32.3,1,0,1,0,0,1,5,20.0,4,1,0,1,3,4,21,1,Bundesliga,2022_2023
Kristian Pedersen,DEN,DF,Köln,27,1994,3.1,5,4,4,1,0,0,2,0.0,2,3,0,3,6,11,17,0,Bundesliga,2022_2023
Mads Pedersen,DEN,"DF,MF",Augsburg,25,1996,20.4,44,23,31,11,2,22,33,66.7,11,32,9,23,20,64,41,1,Bundesliga,2022_2023
Jordan Pefok,USA,FW,Union Berlin,26,1996,15.1,15,7,3,4,8,2,17,11.8,15,17,5,12,4,19,15,0,Bundesliga,2022_2023
Dženan Pejčinović,GER,FW,Wolfsburg,17,2005,0.1,0,0,0,0,0,0,0,,0,0,0,0,0,0,0,0,Bundesliga,2022_2023
Peter Pekarík,SVK,DF,Hertha BSC,35,1986,2.3,4,3,4,0,0,4,6,66.7,2,6,2,4,4,8,7,0,Bundesliga,2022_2023
Luca Pellegrini,ITA,DF,Eint Frankfurt,23,1999,6.2,13,8,10,3,0,8,8,100.0,0,8,2,6,7,20,11,1,Bundesliga,2022_2023
Ricardo Pepi,USA,FW,Augsburg,19,2003,1.1,1,1,1,0,0,1,1,100.0,0,1,0,1,0,1,1,0,Bundesliga,2022_2023
Juan Perea,COL,FW,Stuttgart,22,2000,4.6,5,4,0,2,3,2,4,50.0,2,2,1,1,1,6,3,0,Bundesliga,2022_2023
Nils Petersen,GER,FW,Freiburg,33,1988,3.1,6,4,0,3,3,2,5,40.0,3,11,2,9,1,7,6,0,Bundesliga,2022_2023
Lukas Petkov,BUL,"MF,FW",Augsburg,21,2000,1.6,5,1,4,1,0,2,3,66.7,1,4,1,3,1,6,0,0,Bundesliga,2022_2023
Luca Pfeiffer,GER,FW,Stuttgart,25,1996,7.8,1,1,1,0,0,0,1,0.0,1,4,0,4,1,2,5,0,Bundesliga,2022_2023
Maximilian Philipp,GER,FW,Wolfsburg,28,1994,1.3,2,1,1,1,0,1,1,100.0,0,1,0,1,0,2,0,0,Bundesliga,2022_2023
Maximilian Philipp,GER,"FW,MF",Werder Bremen,28,1994,4.9,6,5,3,2,1,1,9,11.1,8,7,1,6,3,9,4,0,Bundesliga,2022_2023
Amos Pieper,GER,DF,Werder Bremen,24,1998,21.7,46,28,25,19,2,24,40,60.0,16,23,11,12,30,76,94,1,Bundesliga,2022_2023
Marvin Plattenhardt,GER,DF,Hertha BSC,30,1992,26.7,43,33,24,15,4,29,47,61.7,18,25,11,14,15,58,82,0,Bundesliga,2022_2023
Alassane Pléa,FRA,FW,Gladbach,29,1993,19.7,16,8,5,7,4,8,26,30.8,18,23,3,20,12,28,14,0,Bundesliga,2022_2023
Joel Pohjanpalo,FIN,"FW,MF",Leverkusen,27,1994,0.0,0,0,0,0,0,0,0,,0,0,0,0,0,0,0,0,Bundesliga,2022_2023
Sebastian Polter,GER,FW,Schalke 04,31,1991,7.0,4,3,0,4,0,1,4,25.0,3,4,0,4,1,5,6,0,Bundesliga,2022_2023
Stefan Posch,AUT,DF,Hoffenheim,25,1997,0.2,0,0,0,0,0,0,0,,0,0,0,0,0,0,0,0,Bundesliga,2022_2023
Yussuf Poulsen,DEN,FW,RB Leipzig,28,1994,4.6,6,4,1,4,1,2,5,40.0,3,3,1,2,0,6,5,0,Bundesliga,2022_2023
Grischa Prömel,GER,MF,Hoffenheim,27,1995,16.2,27,19,14,11,2,9,25,36.0,16,22,4,18,8,35,23,0,Bundesliga,2022_2023
Tymoteusz Puchacz,POL,DF,Union Berlin,23,1999,0.6,1,0,1,0,0,0,0,,0,0,0,0,0,1,1,0,Bundesliga,2022_2023
Eduardo Quaresma,POR,DF,Hoffenheim,20,2002,1.0,5,3,3,2,0,1,3,33.3,2,3,2,1,0,5,3,0,Bundesliga,2022_2023
Joshua Quarshie,GER,MF,Hoffenheim,18,2004,0.0,0,0,0,0,0,0,0,,0,0,0,0,0,0,0,0,Bundesliga,2022_2023
Diant Ramaj,GER,GK,Eint Frankfurt,20,2001,1.0,0,0,0,0,0,0,0,,0,0,0,0,0,0,1,0,Bundesliga,2022_2023
Nicolai Rapp,GER,"MF,DF",Werder Bremen,25,1996,0.8,3,1,3,0,0,0,3,0.0,3,0,0,0,0,3,1,0,Bundesliga,2022_2023
David Raum,GER,"DF,MF",RB Leipzig,24,1998,18.7,39,25,23,12,4,17,29,58.6,12,24,6,18,16,55,26,1,Bundesliga,2022_2023
Rocco Reitz,GER,MF,Gladbach,20,2002,0.0,0,0,0,0,0,0,0,,0,0,0,0,0,0,0,0,Bundesliga,2022_2023
Marco Reus,GER,"MF,FW",Dortmund,33,1989,15.0,30,17,12,14,4,7,24,29.2,17,12,4,8,8,38,8,0,Bundesliga,2022_2023
Elvis Rexhbeçaj,KVX,MF,Augsburg,24,1997,28.0,51,30,18,24,9,29,59,49.2,30,39,12,27,17,68,40,0,Bundesliga,2022_2023
Gio Reyna,USA,"FW,MF",Dortmund,19,2002,6.9,14,7,2,5,7,5,10,50.0,5,8,2,6,3,17,5,0,Bundesliga,2022_2023
Marco Richter,GER,"MF,FW",Hertha BSC,24,1997,20.4,43,23,18,17,8,19,48,39.6,29,29,2,27,24,67,25,0,Bundesliga,2022_2023
Manuel Riemann,GER,GK,Bochum,33,1988,34.0,3,2,3,0,0,3,5,60.0,2,1,0,1,5,8,23,7,Bundesliga,2022_2023
Sebastian Rode,GER,MF,Eint Frankfurt,31,1990,15.7,38,24,7,28,3,14,45,31.1,31,18,2,16,16,54,12,0,Bundesliga,2022_2023
Agustín Rogel,URU,DF,Hertha BSC,24,1997,15.8,18,9,13,5,0,11,17,64.7,6,15,8,7,11,29,74,1,Bundesliga,2022_2023
Merlin Röhl,GER,"MF,FW",Freiburg,20,2002,0.6,1,0,1,0,0,0,0,,0,0,0,0,0,1,1,0,Bundesliga,2022_2023
Tony Rölke,GER,FW,Hertha BSC,19,2003,0.2,0,0,0,0,0,0,0,,0,1,0,1,0,0,1,0,Bundesliga,2022_2023
Tom Rothe,GER,DF,Dortmund,17,2004,0.3,1,1,0,1,0,1,1,100.0,0,0,0,0,1,2,2,0,Bundesliga,2022_2023
Jérôme Roussillon,FRA,"MF,DF",Wolfsburg,29,1993,0.2,0,0,0,0,0,0,0,,0,0,0,0,0,0,0,0,Bundesliga,2022_2023
Jérôme Roussillon,FRA,DF,Union Berlin,29,1993,10.6,16,9,6,8,2,8,12,66.7,4,7,2,5,4,20,22,0,Bundesliga,2022_2023
Sebastian Rudy,GER,MF,Hoffenheim,32,1990,8.8,26,12,10,16,0,13,27,48.1,14,27,7,20,11,37,13,0,Bundesliga,2022_2023
Georginio Rutter,FRA,FW,Hoffenheim,20,2002,11.2,7,4,1,4,2,1,3,33.3,2,10,2,8,5,12,6,0,Bundesliga,2022_2023
Julian Ryerson,NOR,DF,Union Berlin,24,1997,11.5,28,17,17,10,1,15,25,60.0,10,15,3,12,12,40,19,0,Bundesliga,2022_2023
Julian Ryerson,NOR,DF,Dortmund,24,1997,15.7,27,15,17,7,3,19,37,51.4,18,13,2,11,8,35,28,0,Bundesliga,2022_2023
Frederik Rønnow,DEN,GK,Union Berlin,29,1992,29.0,0,0,0,0,0,0,5,0.0,5,0,0,0,0,0,9,1,Bundesliga,2022_2023
Marcel Sabitzer,AUT,MF,Bayern Munich,28,1994,7.0,27,14,11,10,6,10,17,58.8,7,3,0,3,10,37,9,0,Bundesliga,2022_2023
Dikeni-Rafid Salifou,TOG,MF,Werder Bremen,19,2003,0.0,0,0,0,0,0,0,0,,0,0,0,0,0,0,0,0,Bundesliga,2022_2023
Roland Sallai,HUN,"MF,FW",Freiburg,25,1997,11.1,11,8,4,3,4,4,10,40.0,6,7,1,6,2,13,11,0,Bundesliga,2022_2023
Diadie Samassékou,MLI,"MF,FW",Hoffenheim,26,1996,0.4,1,0,0,1,0,0,1,0.0,1,0,0,0,0,1,0,0,Bundesliga,2022_2023
Leroy Sané,GER,"MF,FW",Bayern Munich,26,1996,22.3,38,30,11,19,8,18,36,50.0,18,11,1,10,3,41,1,2,Bundesliga,2022_2023
Sidi Sané,GER,FW,Schalke 04,19,2003,0.3,1,1,1,0,0,1,1,100.0,0,0,0,0,0,1,0,0,Bundesliga,2022_2023
Bouna Sarr,SEN,FW,Bayern Munich,30,1992,0.0,0,0,0,0,0,0,0,,0,0,0,0,0,0,0,0,Bundesliga,2022_2023
Joe Scally,USA,DF,Gladbach,19,2002,24.5,31,20,25,5,1,24,31,77.4,7,17,6,11,8,39,61,0,Bundesliga,2022_2023
Kevin Schade,GER,"FW,MF",Freiburg,20,2001,2.0,6,4,3,2,1,3,5,60.0,2,0,0,0,0,6,2,0,Bundesliga,2022_2023
András Schäfer,HUN,MF,Union Berlin,23,1999,9.6,21,9,7,12,2,6,14,42.9,8,12,2,10,4,25,11,0,Bundesliga,2022_2023
Derry Scherhant,GER,"FW,MF",Hertha BSC,19,2002,3.2,7,6,3,3,1,4,8,50.0,4,3,0,3,0,7,5,0,Bundesliga,2022_2023
Patrik Schick,CZE,FW,Leverkusen,26,1996,10.5,0,0,0,0,0,0,1,0.0,1,4,1,3,1,1,7,0,Bundesliga,2022_2023
Kingsley Schindler,GHA,"DF,MF",Köln,29,1993,12.1,23,12,13,8,2,18,28,64.3,10,14,2,12,15,38,24,0,Bundesliga,2022_2023
Xaver Schlager,AUT,MF,RB Leipzig,24,1997,16.7,41,24,13,26,2,20,43,46.5,23,19,2,17,17,58,23,0,Bundesliga,2022_2023
Keven Schlotterbeck,GER,DF,Freiburg,25,1997,0.2,0,0,0,0,0,0,0,,0,1,1,0,2,2,2,0,Bundesliga,2022_2023
Keven Schlotterbeck,GER,DF,Bochum,25,1997,8.2,17,9,12,5,0,9,11,81.8,2,11,5,6,14,31,49,0,Bundesliga,2022_2023
Nico Schlotterbeck,GER,DF,Dortmund,22,1999,25.0,59,34,34,24,1,37,53,69.8,16,38,21,17,32,91,71,1,Bundesliga,2022_2023
Jonathan Schmid,FRA,DF,Freiburg,32,1990,0.5,1,1,1,0,0,0,0,,0,1,0,1,1,2,1,1,Bundesliga,2022_2023
Romano Schmid,AUT,"MF,FW",Werder Bremen,22,2000,16.9,24,15,5,13,6,10,22,45.5,12,21,3,18,7,31,12,0,Bundesliga,2022_2023
Kenneth Schmidt,GER,DF,Freiburg,20,2002,2.8,6,3,4,2,0,5,6,83.3,1,4,2,2,0,6,2,0,Bundesliga,2022_2023
Niklas Schmidt,GER,MF,Werder Bremen,24,1998,12.1,25,10,12,11,2,13,28,46.4,15,10,0,10,5,30,12,0,Bundesliga,2022_2023
Benno Schmitz,GER,DF,Köln,27,1994,26.9,64,42,31,28,5,42,82,51.2,40,34,4,30,26,90,57,0,Bundesliga,2022_2023
Marvin Schwäbe,GER,GK,Köln,27,1995,34.0,1,0,1,0,0,1,1,100.0,0,0,0,0,2,3,8,2,Bundesliga,2022_2023
Alexander Schwolow,GER,GK,Schalke 04,30,1992,22.6,0,0,0,0,0,0,2,0.0,2,0,0,0,1,1,6,3,Bundesliga,2022_2023
Paul Seguin,GER,MF,Union Berlin,27,1995,7.7,17,8,9,4,4,8,18,44.4,10,6,0,6,6,23,7,0,Bundesliga,2022_2023
Davie Selke,GER,FW,Hertha BSC,27,1995,3.1,2,1,1,1,0,0,1,0.0,1,3,1,2,1,3,5,0,Bundesliga,2022_2023
Davie Selke,GER,FW,Köln,27,1995,9.7,0,0,0,0,0,0,4,0.0,4,4,1,3,0,0,11,0,Bundesliga,2022_2023
Suat Serdar,GER,MF,Hertha BSC,25,1997,22.5,51,23,14,30,7,20,41,48.8,21,48,12,36,29,80,24,0,Bundesliga,2022_2023
Eniss Shabani,ALB,MF,Mainz 05,19,2003,0.1,0,0,0,0,0,0,0,,0,0,0,0,0,0,0,0,Bundesliga,2022_2023
Kiliann Sildillia,FRA,"DF,MF",Freiburg,20,2002,22.0,33,20,10,19,4,18,30,60.0,12,24,9,15,21,54,47,1,Bundesliga,2022_2023
André Silva,POR,FW,RB Leipzig,26,1995,19.3,12,6,2,5,5,3,8,37.5,5,11,1,10,3,15,3,0,Bundesliga,2022_2023
Mohamed Simakan,FRA,DF,RB Leipzig,22,2000,16.2,21,14,12,5,4,14,21,66.7,7,21,4,17,16,37,55,0,Bundesliga,2022_2023
Daley Sinkgraven,NED,"DF,MF",Leverkusen,27,1995,3.8,10,7,7,3,0,7,9,77.8,2,8,4,4,5,15,7,0,Bundesliga,2022_2023
Tobias Sippel,GER,GK,Gladbach,34,1988,5.7,0,0,0,0,0,0,0,,0,0,0,0,0,0,1,1,Bundesliga,2022_2023
Hugo Siquet,BEL,DF,Freiburg,20,2002,0.2,2,2,2,0,0,2,2,100.0,0,1,0,1,0,2,0,0,Bundesliga,2022_2023
Tim Skarke,GER,"DF,MF",Union Berlin,25,1996,0.6,1,1,0,0,1,0,0,,0,1,0,1,0,1,0,0,Bundesliga,2022_2023
Tim Skarke,GER,"FW,MF",Schalke 04,25,1996,4.9,13,7,3,8,2,8,11,72.7,3,5,0,5,0,13,4,0,Bundesliga,2022_2023
Ellyes Skhiri,TUN,MF,Köln,27,1995,31.7,79,44,29,42,8,26,66,39.4,40,52,12,40,56,135,48,0,Bundesliga,2022_2023
Robert Skov,DEN,DF,Hoffenheim,26,1996,15.0,22,11,14,7,1,10,26,38.5,16,22,8,14,8,30,20,2,Bundesliga,2022_2023
Hrvoje Smolčić,CRO,DF,Eint Frankfurt,21,2000,5.2,8,7,6,2,0,5,10,50.0,5,11,4,7,6,14,38,0,Bundesliga,2022_2023
Danilo Soares,BRA,DF,Bochum,30,1991,19.6,72,46,42,23,7,43,72,59.7,29,29,6,23,30,102,56,1,Bundesliga,2022_2023
Nikola Soldo,CRO,DF,Köln,21,2001,6.6,15,9,8,7,0,7,11,63.6,4,7,6,1,7,22,28,0,Bundesliga,2022_2023
Yann Sommer,SUI,GK,Gladbach,33,1988,10.0,1,0,1,0,0,1,1,100.0,0,0,0,0,0,1,8,0,Bundesliga,2022_2023
Yann Sommer,SUI,GK,Bayern Munich,33,1988,19.0,0,0,0,0,0,0,0,,0,0,0,0,1,1,5,1,Bundesliga,2022_2023
Borna Sosa,CRO,DF,Stuttgart,24,1998,21.7,27,21,18,8,1,21,32,65.6,11,20,5,15,19,46,37,0,Bundesliga,2022_2023
Djibril Sow,SUI,MF,Eint Frankfurt,25,1997,29.4,41,25,13,25,3,22,44,50.0,22,22,4,18,28,69,23,0,Bundesliga,2022_2023
Anton Stach,GER,MF,Mainz 05,23,1998,23.0,27,21,10,15,2,16,38,42.1,22,28,2,26,41,68,25,0,Bundesliga,2022_2023
Kostas Stafylidis,GRE,"DF,MF",Bochum,28,1993,11.6,27,16,13,8,6,10,24,41.7,14,21,8,13,20,47,31,1,Bundesliga,2022_2023
Jens Stage,DEN,MF,Werder Bremen,25,1996,20.6,34,17,15,18,1,10,37,27.0,27,34,11,23,16,50,37,0,Bundesliga,2022_2023
Veit Stange,GER,MF,Hertha BSC,18,2004,0.1,1,1,1,0,0,1,1,100.0,0,0,0,0,0,1,0,0,Bundesliga,2022_2023
Josip Stanišić,CRO,DF,Bayern Munich,22,2000,6.4,19,11,14,2,3,12,17,70.6,5,9,1,8,7,26,11,3,Bundesliga,2022_2023
Niklas Stark,GER,DF,Werder Bremen,27,1995,23.1,56,36,29,24,3,27,42,64.3,15,24,13,11,37,93,110,0,Bundesliga,2022_2023
Pascal Stenzel,GER,DF,Stuttgart,26,1996,3.7,12,8,8,4,0,5,9,55.6,4,9,2,7,5,17,6,0,Bundesliga,2022_2023
Angelo Stiller,GER,MF,Hoffenheim,21,2001,7.8,26,12,9,13,4,8,12,66.7,4,12,2,10,10,36,14,0,Bundesliga,2022_2023
Lars Stindl,GER,"FW,MF",Gladbach,33,1988,19.3,24,14,4,17,3,10,28,35.7,18,24,5,19,11,35,19,0,Bundesliga,2022_2023
Kevin Stöger,AUT,MF,Bochum,28,1993,28.9,84,45,38,32,14,31,94,33.0,63,27,4,23,26,110,21,1,Bundesliga,2022_2023
Niklas Süle,GER,DF,Dortmund,26,1995,23.5,25,19,18,3,4,14,23,60.9,9,28,19,9,17,42,53,0,Bundesliga,2022_2023
Ivan Šunjić,CRO,MF,Hertha BSC,25,1996,11.0,38,20,16,21,1,16,24,66.7,8,17,5,12,13,51,19,1,Bundesliga,2022_2023
Mattias Svanberg,SWE,"MF,FW",Wolfsburg,23,1999,20.4,25,16,8,16,1,10,30,33.3,20,27,5,22,21,46,25,1,Bundesliga,2022_2023
Dominik Szoboszlai,HUN,"MF,FW",RB Leipzig,21,2000,27.2,45,28,12,20,13,17,42,40.5,25,43,2,41,17,62,27,0,Bundesliga,2022_2023
Alexander Sørloth,NOR,FW,RB Leipzig,26,1995,0.1,0,0,0,0,0,0,0,,0,0,0,0,0,0,0,0,Bundesliga,2022_2023
Jonathan Tah,GER,DF,Leverkusen,26,1996,27.6,25,12,21,4,0,12,18,66.7,6,30,18,12,40,65,118,0,Bundesliga,2022_2023
Edmond Tapsoba,BFA,DF,Leverkusen,23,1999,31.9,51,30,35,12,4,30,42,71.4,12,40,17,23,36,87,109,1,Bundesliga,2022_2023
Niklas Tauer,GER,"DF,MF",Mainz 05,21,2001,1.0,2,1,2,0,0,1,3,33.3,2,2,1,1,2,4,4,0,Bundesliga,2022_2023
Mathys Tel,FRA,FW,Bayern Munich,17,2005,4.6,2,2,0,1,1,1,1,100.0,0,5,1,4,0,2,2,0,Bundesliga,2022_2023
Semir Telalovic,GER,"MF,FW",Gladbach,22,1999,0.1,0,0,0,0,0,0,0,,0,0,0,0,0,0,0,0,Bundesliga,2022_2023
Simon Terodde,GER,FW,Schalke 04,34,1988,20.3,15,8,4,7,4,3,14,21.4,11,6,2,4,6,21,9,0,Bundesliga,2022_2023
Malick Thiaw,GER,DF,Schalke 04,20,2001,3.0,3,1,2,1,0,1,2,50.0,1,4,3,1,9,12,24,1,Bundesliga,2022_2023
Jan Thielmann,GER,FW,Köln,20,2002,9.7,9,8,3,4,2,2,11,18.2,9,16,3,13,9,18,7,0,Bundesliga,2022_2023
Morten Thorsby,NOR,MF,Union Berlin,26,1996,9.3,22,10,9,11,2,13,21,61.9,8,11,5,6,3,25,20,0,Bundesliga,2022_2023
Marcus Thuram,FRA,FW,Gladbach,24,1997,27.9,14,7,3,6,5,6,13,46.2,7,20,3,17,6,20,22,0,Bundesliga,2022_2023
Steffen Tigges,GER,FW,Köln,24,1998,17.7,12,7,1,8,3,4,14,28.6,10,13,2,11,8,20,17,0,Bundesliga,2022_2023
Umut Tohumcu,GER,"MF,DF",Hoffenheim,17,2004,3.0,10,5,4,5,1,3,9,33.3,6,4,0,4,2,12,8,0,Bundesliga,2022_2023
Tiago Tomás,POR,"FW,MF",Stuttgart,20,2002,14.3,10,4,2,4,4,8,13,61.5,5,9,2,7,1,11,5,0,Bundesliga,2022_2023
Almamy Touré,MLI,DF,Eint Frankfurt,26,1996,4.4,13,7,7,5,1,5,9,55.6,4,9,2,7,10,23,8,0,Bundesliga,2022_2023
Lucas Tousart,FRA,MF,Hertha BSC,25,1997,32.7,73,38,35,28,10,27,60,45.0,33,42,6,36,48,121,75,1,Bundesliga,2022_2023
Kevin Trapp,GER,GK,Eint Frankfurt,32,1990,33.0,1,1,1,0,0,0,2,0.0,2,2,0,2,0,1,10,0,Bundesliga,2022_2023
Christopher Trimmel,AUT,DF,Union Berlin,35,1987,20.1,31,16,16,12,3,20,31,64.5,11,14,1,13,25,56,48,0,Bundesliga,2022_2023
Tuta,BRA,DF,Eint Frankfurt,23,1999,30.2,53,35,27,19,7,33,57,57.9,24,47,14,33,49,102,134,2,Bundesliga,2022_2023
Sven Ulreich,GER,GK,Bayern Munich,33,1988,3.0,1,1,1,0,0,1,1,100.0,0,0,0,0,0,1,0,1,Bundesliga,2022_2023
Lauren Ulrich,GER,MF,Stuttgart,17,2005,0.1,1,1,0,0,1,0,0,,0,0,0,0,0,1,0,0,Bundesliga,2022_2023
Dayot Upamecano,FRA,DF,Bayern Munich,23,1998,26.1,65,37,43,22,0,28,45,62.2,17,26,6,20,27,92,71,4,Bundesliga,2022_2023
Filip Uremović,CRO,DF,Hertha BSC,25,1997,19.2,38,23,29,8,1,14,22,63.6,8,18,13,5,36,74,88,2,Bundesliga,2022_2023
Jere Uronen,FIN,DF,Schalke 04,28,1994,7.5,14,10,6,6,2,6,10,60.0,4,5,2,3,8,22,13,0,Bundesliga,2022_2023
Mark Uth,GER,"MF,FW",Köln,30,1991,0.5,0,0,0,0,0,0,0,,0,0,0,0,0,0,0,0,Bundesliga,2022_2023
Josha Vagnoman,GER,DF,Stuttgart,21,2000,16.4,26,15,12,11,3,15,27,55.6,12,20,2,18,8,34,29,1,Bundesliga,2022_2023
Ruben Vargas,SUI,"MF,FW",Augsburg,23,1998,12.6,15,7,6,7,2,5,11,45.5,6,8,2,6,6,21,16,1,Bundesliga,2022_2023
Renato Veiga,POR,DF,Augsburg,19,2003,7.1,9,6,4,3,2,7,9,77.8,2,20,6,14,7,16,29,1,Bundesliga,2022_2023
Miloš Veljković,SRB,DF,Werder Bremen,26,1995,25.2,30,19,17,13,0,18,29,62.1,11,32,16,16,33,63,103,0,Bundesliga,2022_2023
Micky van de Ven,NED,DF,Wolfsburg,21,2001,33.0,45,30,26,18,1,28,39,71.8,11,42,24,18,26,71,108,2,Bundesliga,2022_2023
Gabriel Vidovic,CRO,FW,Bayern Munich,18,2003,0.2,0,0,0,0,0,0,0,,0,0,0,0,0,0,0,0,Bundesliga,2022_2023
Kevin Vogt,GER,DF,Hoffenheim,30,1991,19.7,15,10,10,5,0,9,22,40.9,13,18,11,7,26,41,67,0,Bundesliga,2022_2023
Aster Vranckx,BEL,MF,Wolfsburg,19,2002,0.1,0,0,0,0,0,0,0,,0,0,0,0,0,0,1,0,Bundesliga,2022_2023
Robert Wagner,GER,MF,Freiburg,19,2003,0.4,0,0,0,0,0,0,0,,0,2,0,2,0,0,2,0,Bundesliga,2022_2023
Luca Waldschmidt,GER,"FW,MF",Wolfsburg,26,1996,5.8,5,2,2,1,2,2,10,20.0,8,6,0,6,3,8,5,0,Bundesliga,2022_2023
Paul Wanner,GER,MF,Bayern Munich,16,2005,0.3,3,1,1,2,0,1,1,100.0,0,0,0,0,0,3,1,0,Bundesliga,2022_2023
Julian Weigl,GER,MF,Gladbach,26,1995,21.0,43,16,21,21,1,23,41,56.1,18,23,2,21,18,61,32,0,Bundesliga,2022_2023
Nelson Weiper,GER,"FW,DF",Mainz 05,17,2005,1.1,2,0,0,0,2,1,3,33.3,2,2,0,2,0,2,1,0,Bundesliga,2022_2023
Mitchell Weiser,GER,"DF,FW",Werder Bremen,28,1994,28.0,71,43,38,24,9,38,75,50.7,37,50,7,43,28,99,38,1,Bundesliga,2022_2023
Noah Weißhaupt,GER,"MF,DF",Freiburg,20,2001,4.7,11,6,3,7,1,2,7,28.6,5,4,0,4,6,17,8,0,Bundesliga,2022_2023
Marcel Wenig,GER,MF,Eint Frankfurt,18,2004,0.0,0,0,0,0,0,0,0,,0,0,0,0,0,0,0,0,Bundesliga,2022_2023
Timo Werner,GER,"FW,MF",RB Leipzig,26,1996,21.5,10,5,4,3,3,4,12,33.3,8,12,0,12,7,17,5,0,Bundesliga,2022_2023
Silvan Widmer,SUI,DF,Mainz 05,29,1993,18.8,26,17,15,10,1,20,39,51.3,19,22,8,14,31,57,28,0,Bundesliga,2022_2023
Patrick Wimmer,AUT,"FW,MF",Wolfsburg,21,2001,18.3,39,26,18,11,10,12,38,31.6,26,27,2,25,15,54,15,0,Bundesliga,2022_2023
Jonas Wind,DEN,FW,Wolfsburg,23,1999,14.3,14,6,2,7,5,5,10,50.0,5,14,4,10,1,15,10,0,Bundesliga,2022_2023
Frederik Winther,DEN,DF,Augsburg,21,2001,1.0,2,2,1,1,0,0,2,0.0,2,1,1,0,0,2,7,0,Bundesliga,2022_2023
Florian Wirtz,GER,"FW,MF",Leverkusen,19,2003,12.1,18,10,9,7,2,8,16,50.0,8,15,1,14,1,19,6,0,Bundesliga,2022_2023
Hannes Wolf,AUT,FW,Gladbach,23,1999,5.0,11,8,4,5,2,5,13,38.5,8,3,0,3,3,14,9,0,Bundesliga,2022_2023
Marius Wolf,GER,DF,Dortmund,27,1995,17.4,25,18,9,12,4,16,29,55.2,13,40,10,30,18,43,22,1,Bundesliga,2022_2023
Jeong Woo-yeong,KOR,"MF,FW",Freiburg,22,1999,7.3,7,3,4,2,1,2,5,40.0,3,7,1,6,1,8,7,0,Bundesliga,2022_2023
Kelvin Yeboah,ITA,"FW,MF",Augsburg,22,2000,3.9,6,4,2,4,0,2,5,40.0,3,7,0,7,1,7,2,0,Bundesliga,2022_2023
Maya Yoshida,JPN,DF,Schalke 04,33,1988,28.4,34,22,19,13,2,18,29,62.1,11,40,29,11,46,80,132,2,Bundesliga,2022_2023
Dan-Axel Zagadou,FRA,DF,Stuttgart,23,1999,14.1,14,9,10,4,0,5,14,35.7,9,19,16,3,21,35,81,1,Bundesliga,2022_2023
Rodrigo Zalazar,URU,"MF,FW",Schalke 04,22,1999,14.7,16,8,5,9,2,9,24,37.5,15,16,1,15,7,23,13,0,Bundesliga,2022_2023
Aaron Zehnter,GER,DF,Augsburg,17,2004,0.0,0,0,0,0,0,0,1,0.0,1,0,0,0,1,1,0,0,Bundesliga,2022_2023
Robin Zentner,GER,GK,Mainz 05,27,1994,26.0,0,0,0,0,0,0,4,0.0,4,0,0,0,0,0,17,1,Bundesliga,2022_2023
Michael Zetterer,GER,GK,Werder Bremen,27,1995,1.7,0,0,0,0,0,0,0,,0,0,0,0,0,0,1,0,Bundesliga,2022_2023
Simon Zoller,GER,FW,Bochum,31,1991,16.2,11,4,2,8,1,4,12,33.3,8,14,1,13,6,17,21,0,Bundesliga,2022_2023
Brenden Aaronson,USA,"MF,FW",Union Berlin,22,2000,14.1,32,18,13,13,6,16,32,50.0,16,26,1,25,2,34,4,0,Bundesliga,2023_2024
Paxten Aaronson,USA,MF,Eint Frankfurt,19,2003,1.1,2,2,1,1,0,1,1,100.0,0,2,0,2,0,2,0,0,Bundesliga,2023_2024
Junior Adamu,AUT,"FW,MF",Freiburg,22,2001,1.2,5,1,1,2,2,1,2,50.0,1,1,0,1,0,5,2,0,Bundesliga,2023_2024
Sargis Adamyan,ARM,"FW,MF",Köln,30,1993,8.9,14,9,2,9,3,6,11,54.5,5,16,1,15,5,19,7,0,Bundesliga,2023_2024
Karim Adeyemi,GER,"FW,MF",Dortmund,21,2002,10.1,16,14,9,4,3,8,20,40.0,12,11,0,11,3,19,5,0,Bundesliga,2023_2024
Amine Adli,MAR,"MF,FW",Leverkusen,23,2000,10.0,16,7,2,10,4,7,17,41.2,10,10,2,8,6,22,5,0,Bundesliga,2023_2024
Felix Agu,GER,"DF,MF",Werder Bremen,23,1999,17.9,45,29,28,13,4,29,41,70.7,12,27,7,20,13,58,41,0,Bundesliga,2023_2024
Ludovic Ajorque,FRA,FW,Mainz 05,29,1994,15.1,3,2,1,2,0,2,11,18.2,9,6,2,4,4,7,11,0,Bundesliga,2023_2024
Kevin Akpoguma,NGA,DF,Hoffenheim,28,1995,12.2,35,18,22,12,1,26,35,74.3,9,28,8,20,18,53,32,0,Bundesliga,2023_2024
Faride Alidou,GER,"FW,MF",Köln,22,2001,14.2,10,4,3,6,1,4,18,22.2,14,23,2,21,8,18,15,1,Bundesliga,2023_2024
Skelly Alvero,FRA,MF,Werder Bremen,21,2002,1.4,6,4,1,5,0,3,3,100.0,0,3,1,2,1,7,1,0,Bundesliga,2023_2024
Nadiem Amiri,GER,MF,Mainz 05,26,1996,14.6,22,14,8,10,4,13,19,68.4,6,16,2,14,14,36,18,0,Bundesliga,2023_2024
Nadiem Amiri,GER,MF,Leverkusen,26,1996,1.0,4,2,0,3,1,0,3,0.0,3,0,0,0,0,4,1,0,Bundesliga,2023_2024
Kofi Amoako,GER,MF,Wolfsburg,18,2005,0.0,0,0,0,0,0,0,0,,0,0,0,0,0,0,0,0,Bundesliga,2023_2024
Robert Andrich,GER,"MF,DF",Leverkusen,28,1994,18.8,30,18,8,14,8,13,24,54.2,11,15,4,11,20,50,17,0,Bundesliga,2023_2024
Waldemar Anton,GER,DF,Stuttgart,27,1996,32.1,39,25,21,16,2,23,42,54.8,19,33,20,13,40,79,150,1,Bundesliga,2023_2024
Christopher Antwi-Adjei,GHA,"FW,MF",Bochum,29,1994,13.5,21,12,10,6,5,12,22,54.5,10,13,2,11,2,23,11,1,Bundesliga,2023_2024
Asaf Arania,ISR,MF,Darmstadt 98,17,2005,0.1,0,0,0,0,0,0,0,,0,0,0,0,0,0,0,0,Bundesliga,2023_2024
Maximilian Arnold,GER,MF,Wolfsburg,29,1994,27.8,51,31,15,27,9,28,57,49.1,29,23,4,19,24,75,60,0,Bundesliga,2023_2024
Arthur,BRA,DF,Leverkusen,20,2003,2.0,4,3,2,0,2,2,2,100.0,0,1,1,0,0,4,7,0,Bundesliga,2023_2024
Takuma Asano,JPN,"FW,MF",Bochum,28,1994,22.1,17,6,2,9,6,7,23,30.4,16,17,3,14,4,21,11,0,Bundesliga,2023_2024
Jonathan Asp Jensen,DEN,FW,Bayern Munich,17,2006,0.0,0,0,0,0,0,0,0,,0,0,0,0,0,0,1,0,Bundesliga,2023_2024
Noah Atubolu,GER,GK,Freiburg,21,2002,34.0,0,0,0,0,0,0,1,0.0,1,0,0,0,0,0,8,1,Bundesliga,2023_2024
Matthias Bader,GER,"DF,MF",Darmstadt 98,26,1997,20.0,51,25,32,11,8,33,65,50.8,32,22,4,18,25,76,20,0,Bundesliga,2023_2024
Ridle Baku,GER,"DF,MF",Wolfsburg,25,1998,22.4,37,20,24,7,6,21,46,45.7,25,27,1,26,21,58,45,1,Bundesliga,2023_2024
Samuel Bamba,GER,FW,Dortmund,19,2004,0.5,1,1,1,0,0,1,2,50.0,1,0,0,0,0,1,1,0,Bundesliga,2023_2024
Aymen Barkok,MAR,"MF,FW",Mainz 05,25,1998,3.6,9,5,2,6,1,3,6,50.0,3,7,0,7,2,11,1,0,Bundesliga,2023_2024
Leandro Barreiro Martins,LUX,MF,Mainz 05,23,2000,29.0,65,40,19,37,9,30,50,60.0,20,45,16,29,36,101,53,0,Bundesliga,2023_2024
Daniel Batz,GER,GK,Mainz 05,32,1991,4.0,0,0,0,0,0,0,0,,0,0,0,0,0,0,3,0,Bundesliga,2023_2024
Maximilian Bauer,GER,DF,Augsburg,23,2000,9.0,19,12,13,4,2,9,17,52.9,8,14,8,6,11,30,30,1,Bundesliga,2023_2024
Elias Baum,GER,"DF,MF",Eint Frankfurt,17,2005,0.3,1,0,0,0,1,0,0,,0,3,2,1,0,1,1,0,Bundesliga,2023_2024
Oliver Baumann,GER,GK,Hoffenheim,33,1990,34.0,1,1,1,0,0,1,2,50.0,1,0,0,0,0,1,19,2,Bundesliga,2023_2024
Christoph Baumgartner,AUT,"MF,FW",RB Leipzig,23,1999,12.9,26,13,10,12,4,14,38,36.8,24,20,1,19,5,31,14,0,Bundesliga,2023_2024
Ihlas Bebou,TOG,"FW,DF",Hoffenheim,29,1994,18.2,22,12,10,8,4,8,16,50.0,8,13,2,11,14,36,15,0,Bundesliga,2023_2024
Adrian Beck,GER,"MF,FW",Heidenheim,26,1997,10.8,22,13,8,12,2,9,24,37.5,15,17,0,17,4,26,15,0,Bundesliga,2023_2024
Sheraldo Becker,SUR,"FW,MF",Union Berlin,28,1995,7.2,3,3,0,2,1,0,2,0.0,2,2,0,2,0,3,2,0,Bundesliga,2023_2024
Chris Bedia,CIV,"FW,MF",Union Berlin,27,1996,1.6,2,1,0,2,0,0,1,0.0,1,3,0,3,0,2,2,0,Bundesliga,2023_2024
Donny van de Beek,NED,"MF,FW",Eint Frankfurt,26,1997,4.0,8,3,3,3,2,3,7,42.9,4,5,1,4,3,11,1,0,Bundesliga,2023_2024
Kevin Behrens,GER,FW,Wolfsburg,32,1991,6.8,2,1,0,1,1,0,2,0.0,2,9,0,9,3,5,6,0,Bundesliga,2023_2024
Kevin Behrens,GER,FW,Union Berlin,32,1991,14.0,13,10,3,7,3,1,4,25.0,3,7,2,5,6,19,19,0,Bundesliga,2023_2024
Maximilian Beier,GER,"FW,MF",Hoffenheim,20,2002,26.9,20,12,5,11,4,4,19,21.1,15,21,1,20,9,29,12,0,Bundesliga,2023_2024
Stefan Bell,GER,DF,Mainz 05,31,1991,7.4,8,8,7,1,0,4,8,50.0,4,7,5,2,6,14,30,0,Bundesliga,2023_2024
Ramy Bensebaini,ALG,DF,Dortmund,28,1995,11.5,34,21,21,11,2,24,34,70.6,10,22,7,15,16,50,37,0,Bundesliga,2023_2024
Mergim Berisha,GER,FW,Hoffenheim,25,1998,1.6,0,0,0,0,0,0,0,,0,2,1,1,0,0,0,0,Bundesliga,2023_2024
Mergim Berisha,GER,FW,Augsburg,25,1998,1.4,0,0,0,0,0,0,0,,0,1,0,1,0,0,3,0,Bundesliga,2023_2024
Bernardo,BRA,DF,Bochum,28,1995,32.5,99,58,56,35,8,45,69,65.2,24,66,30,36,55,154,120,1,Bundesliga,2023_2024
Matúš Bero,SVK,"MF,FW",Bochum,27,1995,18.5,32,22,13,12,7,13,32,40.6,19,24,3,21,12,44,26,0,Bundesliga,2023_2024
Jan-Niklas Beste,GER,"FW,MF",Heidenheim,24,1999,28.9,77,49,35,24,18,28,55,50.9,27,48,1,47,18,95,31,0,Bundesliga,2023_2024
Pep Biel,ESP,"MF,FW",Augsburg,26,1996,3.2,4,3,0,2,2,1,3,33.3,2,2,1,1,2,6,2,0,Bundesliga,2023_2024
Tom Bischof,GER,"MF,FW",Hoffenheim,18,2005,2.0,8,4,6,1,1,2,9,22.2,7,3,0,3,1,9,2,0,Bundesliga,2023_2024
Leonardo Bittencourt,GER,MF,Werder Bremen,29,1993,17.5,42,18,20,17,5,15,39,38.5,24,18,1,17,13,55,6,0,Bundesliga,2023_2024
Hendry Blank,GER,DF,Dortmund,18,2004,0.5,1,0,1,0,0,1,1,100.0,0,1,0,1,0,1,4,0,Bundesliga,2023_2024
Janis Blaswich,GER,GK,RB Leipzig,32,1991,21.0,1,1,1,0,0,0,0,,0,0,0,0,0,1,7,3,Bundesliga,2023_2024
Sacha Boey,FRA,DF,Bayern Munich,22,2000,1.2,2,0,2,0,0,1,2,50.0,1,1,0,1,1,3,2,0,Bundesliga,2023_2024
Victor Boniface,NGA,FW,Leverkusen,22,2000,17.2,6,4,0,1,5,1,4,25.0,3,6,1,5,0,6,13,0,Bundesliga,2023_2024
Leonardo Bonucci,ITA,DF,Union Berlin,36,1987,5.1,6,5,2,4,0,4,4,100.0,0,5,3,2,7,13,16,0,Bundesliga,2023_2024
Yvandro Borges Sanches,LUX,"MF,FW",Gladbach,19,2004,0.2,0,0,0,0,0,0,0,,0,0,0,0,0,0,0,0,Bundesliga,2023_2024
Sebastiaan Bornauw,BEL,DF,Wolfsburg,24,1999,15.9,26,12,19,7,0,13,19,68.4,6,21,12,9,18,44,81,0,Bundesliga,2023_2024
Rafael Borré,COL,FW,Werder Bremen,27,1995,11.0,10,7,2,4,4,5,16,31.3,11,8,2,6,2,12,10,0,Bundesliga,2023_2024
Julian Brandt,GER,"MF,FW",Dortmund,27,1996,24.7,17,14,8,8,1,10,27,37.0,17,20,3,17,8,25,18,0,Bundesliga,2023_2024
Fabian Bredlow,GER,GK,Stuttgart,28,1995,4.0,0,0,0,0,0,0,1,0.0,1,0,0,0,0,0,3,0,Bundesliga,2023_2024
Tim Breithaupt,GER,MF,Augsburg,21,2002,7.0,20,11,11,9,0,13,21,61.9,8,15,3,12,8,28,10,0,Bundesliga,2023_2024
Maximilian Breunig,GER,FW,Freiburg,22,2000,0.1,0,0,0,0,0,0,0,,0,1,0,1,0,0,0,0,Bundesliga,2023_2024
Bennit Bröger,GER,FW,Wolfsburg,17,2006,0.1,0,0,0,0,0,0,0,,0,0,0,0,0,0,0,0,Bundesliga,2023_2024
John Brooks,USA,DF,Hoffenheim,30,1993,17.1,28,15,17,10,1,15,30,50.0,15,29,17,12,27,55,109,1,Bundesliga,2023_2024
Moritz Broschinski,GER,FW,Bochum,22,2000,13.9,11,7,2,5,4,2,8,25.0,6,11,2,9,0,11,6,0,Bundesliga,2023_2024
Alexander Brunst,GER,GK,Darmstadt 98,28,1995,3.0,0,0,0,0,0,0,2,0.0,2,0,0,0,0,0,2,1,Bundesliga,2023_2024
Marius Bülter,GER,"DF,FW",Hoffenheim,30,1993,15.0,18,11,9,5,4,12,23,52.2,11,17,3,14,10,28,20,0,Bundesliga,2023_2024
Jonathan Burkardt,GER,"FW,MF",Mainz 05,23,2000,17.1,12,8,2,6,4,4,11,36.4,7,16,3,13,3,15,2,0,Bundesliga,2023_2024
Oliver Burke,SCO,FW,Werder Bremen,26,1997,0.4,0,0,0,0,0,0,2,0.0,2,0,0,0,0,0,0,0,Bundesliga,2023_2024
Marnon Busch,GER,DF,Heidenheim,28,1994,6.6,11,9,6,3,2,7,12,58.3,5,9,2,7,10,21,12,0,Bundesliga,2023_2024
Aurélio Buta,POR,"DF,MF",Eint Frankfurt,26,1997,19.4,40,25,19,16,5,21,38,55.3,17,24,5,19,15,55,36,0,Bundesliga,2023_2024
Anthony Caci,FRA,DF,Mainz 05,26,1997,27.6,56,23,30,25,1,27,44,61.4,17,43,7,36,32,88,45,0,Bundesliga,2023_2024
Emre Can,GER,"MF,DF",Dortmund,29,1994,21.7,63,45,37,23,3,28,48,58.3,20,30,7,23,22,85,41,2,Bundesliga,2023_2024
Irvin Cardona,FRA,"MF,DF",Augsburg,25,1997,0.6,1,1,0,0,1,1,3,33.3,2,1,0,1,0,1,1,0,Bundesliga,2023_2024
Rasmus Carstensen,DEN,"DF,FW",Köln,22,2000,18.4,47,22,23,20,4,31,56,55.4,25,38,9,29,20,67,50,2,Bundesliga,2023_2024
Fabio Carvalho,POR,MF,RB Leipzig,20,2002,1.8,3,1,0,2,1,1,3,33.3,2,8,0,8,0,3,1,0,Bundesliga,2023_2024
Koen Casteels,BEL,GK,Wolfsburg,31,1992,25.0,2,1,2,0,0,2,3,66.7,1,0,0,0,0,2,16,5,Bundesliga,2023_2024
Václav Černý,CZE,"FW,MF",Wolfsburg,25,1997,10.2,8,3,3,4,1,2,14,14.3,12,13,0,13,8,16,6,0,Bundesliga,2023_2024
Julian Chabot,GER,DF,Köln,25,1998,30.0,59,42,40,17,2,35,59,59.3,24,66,43,23,45,104,145,0,Bundesliga,2023_2024
El Chadaille Bitshiabu,FRA,"DF,MF",RB Leipzig,18,2005,0.4,1,0,1,0,0,0,0,,0,0,0,0,1,2,4,0,Bundesliga,2023_2024
Fares Chaïbi,ALG,"MF,FW",Eint Frankfurt,20,2002,21.2,27,17,7,12,8,8,18,44.4,10,37,1,36,5,32,19,0,Bundesliga,2023_2024
Timothy Chandler,USA,"MF,DF",Eint Frankfurt,33,1990,0.2,0,0,0,0,0,0,0,,0,0,0,0,0,0,0,0,Bundesliga,2023_2024
Fabio Chiarodia,ITA,DF,Gladbach,18,2005,1.7,8,5,5,1,2,5,7,71.4,2,2,1,1,3,11,9,0,Bundesliga,2023_2024
Jacob Christensen,DEN,MF,Köln,22,2001,2.4,10,6,7,3,0,4,7,57.1,3,8,2,6,4,14,4,0,Bundesliga,2023_2024
Nnamdi Collins,GER,DF,Eint Frankfurt,19,2004,1.0,0,0,0,0,0,0,0,,0,0,0,0,2,2,4,0,Bundesliga,2023_2024
Kingsley Coman,FRA,FW,Bayern Munich,27,1996,12.4,12,7,5,3,4,9,17,52.9,8,15,1,14,2,14,5,0,Bundesliga,2023_2024
Bambasé Conté,GER,"MF,FW",Hoffenheim,20,2003,0.5,3,3,2,0,1,1,1,100.0,0,0,0,0,0,3,0,0,Bundesliga,2023_2024
Danny da Costa,GER,DF,Mainz 05,30,1993,9.2,18,9,9,7,2,9,19,47.4,10,17,4,13,16,34,24,0,Bundesliga,2023_2024
Nicolas Cozza,FRA,DF,Wolfsburg,24,1999,3.1,8,6,4,4,0,2,7,28.6,5,3,0,3,4,12,6,0,Bundesliga,2023_2024
Tomáš Čvančara,CZE,FW,Gladbach,22,2000,10.0,4,3,0,2,2,1,3,33.3,2,5,1,4,2,6,8,0,Bundesliga,2023_2024
Finn Dahmen,GER,GK,Augsburg,25,1998,31.0,1,0,1,0,0,1,3,33.3,2,0,0,0,0,1,17,5,Bundesliga,2023_2024
Mahmoud Dahoud,GER,MF,Stuttgart,27,1996,2.5,5,1,1,4,0,3,7,42.9,4,4,0,4,0,5,1,0,Bundesliga,2023_2024
Lukas Daschner,GER,"MF,FW",Bochum,24,1998,6.0,9,4,2,3,4,4,9,44.4,5,7,0,7,2,11,2,0,Bundesliga,2023_2024
David Datro Fofana,CIV,"FW,MF",Union Berlin,20,2002,7.6,10,7,3,5,2,4,9,44.4,5,4,0,4,0,10,5,0,Bundesliga,2023_2024
Alphonso Davies,CAN,DF,Bayern Munich,22,2000,22.9,47,24,29,13,5,30,53,56.6,23,30,4,26,26,73,49,1,Bundesliga,2023_2024
Olivier Deman,BEL,DF,Werder Bremen,23,2000,15.2,28,15,21,4,3,18,38,47.4,20,24,8,16,14,42,49,1,Bundesliga,2023_2024
Ermedin Demirović,BIH,"FW,MF",Augsburg,25,1998,31.9,24,14,5,16,3,12,40,30.0,28,28,2,26,11,35,26,0,Bundesliga,2023_2024
Sepp van den Berg,NED,DF,Mainz 05,21,2001,31.5,38,23,20,15,3,15,26,57.7,11,66,36,30,43,81,159,2,Bundesliga,2023_2024
Samuele Di Benedetto,GER,MF,Stuttgart,18,2005,0.1,0,0,0,0,0,0,0,,0,0,0,0,1,1,0,0,Bundesliga,2023_2024
Justin Diehl,GER,"FW,MF",Köln,18,2004,1.9,0,0,0,0,0,0,0,,0,1,1,0,0,0,0,1,Bundesliga,2023_2024
Eric Dier,ENG,DF,Bayern Munich,29,1994,13.0,11,8,5,5,1,5,6,83.3,1,20,12,8,10,21,48,1,Bundesliga,2023_2024
Florian Dietz,GER,"FW,MF",Köln,24,1998,0.8,0,0,0,0,0,0,0,,0,1,0,1,0,0,0,0,Bundesliga,2023_2024
Junior Dina Ebimbe,FRA,"MF,DF",Eint Frankfurt,22,2000,21.7,44,29,15,17,12,18,41,43.9,23,28,7,21,9,53,39,1,Bundesliga,2023_2024
Eren Dinkçi,GER,"FW,MF",Heidenheim,21,2001,29.4,32,18,16,13,3,19,48,39.6,29,40,4,36,12,44,21,0,Bundesliga,2023_2024
Ritsu Doan,JPN,"DF,MF",Freiburg,25,1998,25.0,50,27,21,19,10,21,36,58.3,15,30,3,27,9,59,29,0,Bundesliga,2023_2024
Danilho Doekhi,NED,DF,Union Berlin,25,1998,24.0,34,23,18,16,0,15,21,71.4,6,46,25,21,38,72,111,1,Bundesliga,2023_2024
Niklas Dorsch,GER,MF,Augsburg,25,1998,15.4,35,24,13,21,1,13,33,39.4,20,15,9,6,16,51,27,0,Bundesliga,2023_2024
Nikola Dovedan,AUT,"MF,FW",Heidenheim,29,1994,7.3,14,9,2,10,2,5,25,20.0,20,9,0,9,1,15,3,0,Bundesliga,2023_2024
Damion Downs,USA,"FW,MF",Köln,19,2004,2.0,1,1,1,0,0,1,2,50.0,1,1,0,1,0,1,1,0,Bundesliga,2023_2024
Dion Drena Beljo,CRO,"FW,MF",Augsburg,21,2002,6.5,0,0,0,0,0,0,2,0.0,2,8,1,7,1,1,4,0,Bundesliga,2023_2024
Tim Drexler,GER,DF,Hoffenheim,18,2005,6.4,16,9,12,4,0,8,17,47.1,9,12,8,4,8,24,14,0,Bundesliga,2023_2024
Marvin Ducksch,GER,FW,Werder Bremen,29,1994,30.0,8,3,4,3,1,6,14,42.9,8,2,0,2,4,12,25,0,Bundesliga,2023_2024
Julien Duranville,BEL,"FW,MF",Dortmund,17,2006,0.1,1,0,0,1,0,1,1,100.0,0,0,0,0,0,1,0,0,Bundesliga,2023_2024
Maximilian Eggestein,GER,MF,Freiburg,26,1996,32.4,49,24,25,19,5,15,36,41.7,21,53,19,34,28,77,40,1,Bundesliga,2023_2024
Lilian Egloff,GER,"MF,DF",Stuttgart,20,2002,1.2,4,1,3,1,0,2,4,50.0,2,3,1,2,1,5,0,0,Bundesliga,2023_2024
Hugo Ekitike,FRA,FW,Eint Frankfurt,21,2002,8.0,11,7,3,6,2,4,6,66.7,2,10,0,10,2,13,4,0,Bundesliga,2023_2024
Elif Elmas,MKD,"MF,FW",RB Leipzig,23,1999,3.0,8,6,1,6,1,6,8,75.0,2,5,0,5,1,9,2,0,Bundesliga,2023_2024
Nico Elvedi,SUI,DF,Gladbach,26,1996,27.6,33,18,22,10,1,18,24,75.0,6,40,25,15,43,76,150,2,Bundesliga,2023_2024
Arne Engels,BEL,"MF,DF",Augsburg,19,2003,15.6,33,18,15,14,4,12,29,41.4,17,23,1,22,15,48,21,0,Bundesliga,2023_2024
Ohis Felix Uduokhai,GER,DF,Augsburg,25,1997,32.5,37,21,18,14,5,16,25,64.0,9,45,35,10,46,83,178,2,Bundesliga,2023_2024
Edimilson Fernandes,SUI,DF,Mainz 05,27,1996,14.3,25,16,15,9,1,16,24,66.7,8,14,6,8,22,47,52,0,Bundesliga,2023_2024
Nacho Ferri,ESP,"FW,MF",Eint Frankfurt,18,2004,0.8,3,3,1,2,0,2,3,66.7,1,0,0,0,0,3,2,0,Bundesliga,2023_2024
Max Finkgräfe,GER,"DF,FW",Köln,19,2004,19.5,65,39,40,25,0,39,74,52.7,35,35,10,25,22,87,39,0,Bundesliga,2023_2024
Kilian Fischer,GER,"DF,MF",Wolfsburg,22,2000,3.2,8,6,4,3,1,2,5,40.0,3,8,1,7,1,9,12,0,Bundesliga,2023_2024
Jonas Föhrenbach,GER,DF,Heidenheim,27,1996,31.0,44,24,24,14,6,19,36,52.8,17,34,19,15,31,75,70,0,Bundesliga,2023_2024
Emil Forsberg,SWE,"MF,FW",RB Leipzig,31,1991,5.2,7,3,2,5,0,5,12,41.7,7,7,0,7,0,7,5,0,Bundesliga,2023_2024
Philipp Förster,GER,"MF,FW",Bochum,28,1995,4.3,9,5,3,4,2,2,6,33.3,4,3,0,3,7,16,3,0,Bundesliga,2023_2024
Bartol Franjić,CRO,MF,Darmstadt 98,23,2000,13.7,15,12,4,10,1,7,28,25.0,21,12,4,8,30,45,29,2,Bundesliga,2023_2024
Marco Friedl,AUT,DF,Werder Bremen,25,1998,24.4,53,32,38,15,0,36,48,75.0,12,45,29,16,35,88,129,0,Bundesliga,2023_2024
Marvin Friedrich,GER,DF,Gladbach,27,1995,17.4,23,15,16,6,1,12,20,60.0,8,28,20,8,17,40,87,0,Bundesliga,2023_2024
Jeremie Frimpong,NED,DF,Leverkusen,22,2000,25.0,26,17,12,7,7,8,20,40.0,12,26,0,26,7,33,17,0,Bundesliga,2023_2024
Chris Führich,GER,"FW,MF",Stuttgart,25,1998,28.5,30,19,6,14,10,16,37,43.2,21,31,0,31,7,37,7,0,Bundesliga,2023_2024
Shiō Fukuda,JPN,"FW,MF",Gladbach,19,2004,0.4,2,0,1,1,0,1,2,50.0,1,0,0,0,1,3,0,0,Bundesliga,2023_2024
Niclas Füllkrug,GER,FW,Werder Bremen,30,1993,2.0,1,1,0,1,0,1,1,100.0,0,2,1,1,0,1,1,0,Bundesliga,2023_2024
Niclas Füllkrug,GER,FW,Dortmund,30,1993,24.6,7,2,1,6,0,2,8,25.0,6,17,4,13,2,9,25,0,Bundesliga,2023_2024
Cristian Gamboa,CRC,DF,Bochum,33,1989,13.2,24,18,12,11,1,14,33,42.4,19,20,7,13,15,39,34,1,Bundesliga,2023_2024
Dennis Geiger,GER,MF,Hoffenheim,25,1998,0.7,1,0,1,0,0,0,0,,0,1,1,0,0,1,0,0,Bundesliga,2023_2024
Yannick Gerhardt,GER,"MF,DF",Wolfsburg,29,1994,18.1,31,20,16,12,3,9,32,28.1,23,15,2,13,7,38,35,0,Bundesliga,2023_2024
Anwar El Ghazi,NED,"MF,DF",Mainz 05,28,1995,0.6,0,0,0,0,0,0,1,0.0,1,0,0,0,0,0,0,0,Bundesliga,2023_2024
Benedikt Gimber,GER,DF,Heidenheim,26,1997,22.5,40,24,25,14,1,19,35,54.3,16,27,17,10,16,56,101,1,Bundesliga,2023_2024
Matthias Ginter,GER,DF,Freiburg,29,1994,21.3,29,15,19,9,1,16,29,55.2,13,40,26,14,16,45,93,0,Bundesliga,2023_2024
Jamie Gittens,ENG,"FW,MF",Dortmund,18,2004,11.8,14,7,6,7,1,2,17,11.8,15,11,2,9,4,18,7,0,Bundesliga,2023_2024
Klaus Gjasula,ALB,"DF,MF",Darmstadt 98,33,1989,15.1,44,22,18,25,1,17,30,56.7,13,26,14,12,19,63,42,2,Bundesliga,2023_2024
Serge Gnabry,GER,"FW,MF",Bayern Munich,28,1995,4.8,8,5,0,5,3,2,13,15.4,11,5,0,5,3,11,2,0,Bundesliga,2023_2024
Leon Goretzka,GER,MF,Bayern Munich,28,1995,24.9,41,23,18,14,9,24,54,44.4,30,44,8,36,31,72,42,1,Bundesliga,2023_2024
Robin Gosens,GER,"DF,MF",Union Berlin,29,1994,25.4,63,44,25,31,7,30,44,68.2,14,52,9,43,36,99,75,0,Bundesliga,2023_2024
Mario Götze,GER,MF,Eint Frankfurt,31,1992,23.0,51,34,18,25,8,28,62,45.2,34,19,3,16,14,65,10,0,Bundesliga,2023_2024
Jeffrey Gouweleeuw,NED,DF,Augsburg,32,1991,28.8,35,23,13,17,5,16,25,64.0,9,44,24,20,35,70,108,0,Bundesliga,2023_2024
Jens Grahl,GER,GK,Eint Frankfurt,34,1988,2.0,0,0,0,0,0,0,0,,0,0,0,0,0,0,3,0,Bundesliga,2023_2024
Ryan Gravenberch,NED,FW,Bayern Munich,21,2002,0.1,0,0,0,0,0,0,0,,0,0,0,0,0,0,0,0,Bundesliga,2023_2024
Michael Gregoritsch,AUT,FW,Freiburg,29,1994,18.7,16,12,8,5,3,2,14,14.3,12,17,4,13,9,25,27,0,Bundesliga,2023_2024
Vincenzo Grifo,ITA,"MF,FW",Freiburg,30,1993,25.8,31,20,14,11,6,14,31,45.2,17,22,1,21,15,46,20,0,Bundesliga,2023_2024
Florian Grillitsch,AUT,"DF,MF",Hoffenheim,27,1995,25.5,54,28,31,19,4,22,54,40.7,32,41,20,21,52,106,90,2,Bundesliga,2023_2024
Álex Grimaldo,ESP,DF,Leverkusen,27,1995,30.9,45,24,26,10,9,30,55,54.5,25,32,7,25,22,67,41,0,Bundesliga,2023_2024
Christian Groß,GER,"DF,MF",Werder Bremen,34,1989,8.9,21,16,11,9,1,11,25,44.0,14,17,6,11,13,34,28,1,Bundesliga,2023_2024
Brajan Gruda,GER,"MF,FW",Mainz 05,19,2004,18.2,22,14,5,11,6,14,24,58.3,10,15,0,15,5,27,4,0,Bundesliga,2023_2024
Ilia Gruev,BUL,MF,Werder Bremen,23,2000,0.0,0,0,0,0,0,0,0,,0,0,0,0,0,0,0,0,Bundesliga,2023_2024
Raphaël Guerreiro,POR,"DF,MF",Bayern Munich,29,1993,13.2,19,16,6,9,4,9,15,60.0,6,7,1,6,15,34,5,1,Bundesliga,2023_2024
Josuha Guilavogui,FRA,DF,Mainz 05,32,1990,4.5,15,10,10,5,0,6,7,85.7,1,13,7,6,13,28,21,0,Bundesliga,2023_2024
Serhou Guirassy,GUI,FW,Stuttgart,27,1996,24.5,6,3,1,4,1,2,5,40.0,3,8,1,7,6,12,29,0,Bundesliga,2023_2024
Péter Gulácsi,HUN,GK,RB Leipzig,33,1990,13.0,0,0,0,0,0,0,0,,0,0,0,0,0,0,8,1,Bundesliga,2023_2024
Manuel Gulde,GER,DF,Freiburg,32,1991,22.7,37,23,23,13,1,17,23,73.9,6,24,14,10,25,62,82,0,Bundesliga,2023_2024
Robert Gumny,POL,DF,Augsburg,25,1998,5.3,6,5,1,3,2,1,5,20.0,4,13,5,8,7,13,15,0,Bundesliga,2023_2024
Christian Günter,GER,DF,Freiburg,30,1993,11.8,20,12,9,11,0,7,18,38.9,11,9,3,6,2,22,16,0,Bundesliga,2023_2024
Janik Haberer,GER,"MF,DF",Union Berlin,29,1994,13.6,36,24,16,13,7,22,45,48.9,23,21,4,17,12,48,18,0,Bundesliga,2023_2024
Robin Hack,GER,"FW,MF",Gladbach,24,1998,15.0,15,8,6,7,2,4,17,23.5,13,16,0,16,14,29,21,0,Bundesliga,2023_2024
Amadou Haidara,MLI,MF,RB Leipzig,25,1998,17.0,42,27,24,16,2,23,41,56.1,18,28,6,22,21,63,37,0,Bundesliga,2023_2024
Sébastien Haller,CIV,FW,Dortmund,29,1994,4.4,1,0,0,1,0,1,1,100.0,0,4,1,3,0,1,7,0,Bundesliga,2023_2024
Andreas Hanche-Olsen,NOR,DF,Mainz 05,26,1997,11.0,20,12,10,8,2,10,16,62.5,6,10,4,6,11,31,41,0,Bundesliga,2023_2024
Isak Hansen-Aarøen,NOR,MF,Werder Bremen,18,2004,0.3,0,0,0,0,0,0,1,0.0,1,1,0,1,1,1,0,0,Bundesliga,2023_2024
Genki Haraguchi,JPN,MF,Stuttgart,32,1991,0.3,1,1,1,0,0,0,0,,0,0,0,0,0,1,1,0,Bundesliga,2023_2024
Makoto Hasebe,JPN,"DF,MF",Eint Frankfurt,39,1984,2.4,4,2,2,2,0,3,6,50.0,3,2,1,1,2,6,5,0,Bundesliga,2023_2024
Thorgan Hazard,BEL,DF,Dortmund,30,1993,0.1,0,0,0,0,0,0,0,,0,0,0,0,0,0,0,0,Bundesliga,2023_2024
Dominique Heintz,GER,DF,Köln,29,1993,6.3,12,5,6,6,0,8,12,66.7,4,6,1,5,3,15,28,0,Bundesliga,2023_2024
Benjamin Henrichs,GER,DF,RB Leipzig,26,1997,28.1,68,39,32,26,10,27,58,46.6,31,49,4,45,33,101,37,0,Bundesliga,2023_2024
Patrick Herrmann,GER,"FW,DF",Gladbach,32,1991,1.0,4,4,2,1,1,2,2,100.0,0,1,0,1,1,5,2,0,Bundesliga,2023_2024
Piero Hincapié,ECU,DF,Leverkusen,21,2002,16.5,35,22,14,17,4,13,17,76.5,4,18,7,11,13,48,43,0,Bundesliga,2023_2024
Adam Hložek,CZE,"MF,FW",Leverkusen,21,2002,5.1,10,4,2,4,4,3,7,42.9,4,4,1,3,2,12,1,0,Bundesliga,2023_2024
Nicolas Höfler,GER,MF,Freiburg,33,1990,25.9,63,40,36,20,7,22,49,44.9,27,30,16,14,31,94,45,0,Bundesliga,2023_2024
Jonas Hofmann,GER,MF,Leverkusen,31,1992,24.5,20,14,6,9,5,10,24,41.7,14,18,0,18,8,28,6,0,Bundesliga,2023_2024
Philipp Hofmann,GER,FW,Bochum,30,1993,17.5,10,5,4,5,1,4,7,57.1,3,11,2,9,4,14,17,0,Bundesliga,2023_2024
Lucas Höler,GER,"FW,MF",Freiburg,29,1994,25.6,32,24,14,10,8,4,23,17.4,19,19,4,15,15,47,35,0,Bundesliga,2023_2024
Fabian Holland,GER,"MF,DF",Darmstadt 98,33,1990,20.4,47,26,18,21,8,20,37,54.1,17,22,12,10,24,71,29,0,Bundesliga,2023_2024
Benedict Hollerbach,GER,"FW,MF",Union Berlin,22,2001,14.2,17,11,5,7,5,7,22,31.8,15,28,0,28,4,21,3,0,Bundesliga,2023_2024
Gerrit Holtmann,PHI,"MF,FW",Darmstadt 98,28,1995,4.4,8,5,3,4,1,7,10,70.0,3,7,0,7,2,10,4,1,Bundesliga,2023_2024
Franck Honorat,FRA,"DF,FW",Gladbach,26,1996,26.1,25,13,13,10,2,11,20,55.0,9,22,3,19,9,34,35,1,Bundesliga,2023_2024
Mathias Honsak,AUT,"FW,MF",Darmstadt 98,26,1996,11.3,14,7,7,6,1,6,20,30.0,14,14,2,12,8,22,25,0,Bundesliga,2023_2024
Fraser Hornby,SCO,"FW,MF",Darmstadt 98,23,1999,2.4,0,0,0,0,0,0,1,0.0,1,2,1,1,0,0,4,0,Bundesliga,2023_2024
Lukáš Hrádecký,FIN,GK,Leverkusen,33,1989,33.0,0,0,0,0,0,0,1,0.0,1,1,0,1,0,0,10,2,Bundesliga,2023_2024
Timo Hübers,GER,DF,Köln,27,1996,30.9,68,47,51,14,3,49,80,61.3,31,54,28,26,63,131,168,1,Bundesliga,2023_2024
Mats Hummels,GER,DF,Dortmund,34,1988,17.6,52,34,34,12,6,30,53,56.6,23,33,11,22,33,85,82,0,Bundesliga,2023_2024
Denis Huseinbasic,BIH,MF,Köln,22,2001,18.1,38,18,17,15,6,20,31,64.5,11,26,1,25,13,51,14,0,Bundesliga,2023_2024
Iago,BRA,DF,Augsburg,26,1997,18.0,36,17,22,10,4,17,33,51.5,16,39,8,31,18,54,43,0,Bundesliga,2023_2024
Borja Iglesias,ESP,FW,Leverkusen,30,1993,2.8,1,0,0,1,0,0,1,0.0,1,2,0,2,1,2,1,0,Bundesliga,2023_2024
Joel Imasuen,USA,FW,Werder Bremen,18,2004,0.0,0,0,0,0,0,0,0,,0,0,0,0,0,0,0,0,Bundesliga,2023_2024
Thomas Isherwood,SWE,DF,Darmstadt 98,25,1998,7.1,11,5,7,3,1,5,9,55.6,4,10,7,3,10,21,34,0,Bundesliga,2023_2024
Ko Itakura,JPN,"DF,MF",Gladbach,26,1997,17.7,34,21,17,15,2,16,26,61.5,10,32,18,14,22,56,62,0,Bundesliga,2023_2024
Hiroki Ito,JPN,DF,Stuttgart,24,1999,24.8,19,18,13,6,0,11,26,42.3,15,29,17,12,29,48,86,2,Bundesliga,2023_2024
Lee Jae-sung,KOR,"MF,FW",Mainz 05,30,1992,23.5,33,20,11,16,6,13,39,33.3,26,22,2,20,27,60,23,0,Bundesliga,2023_2024
Paul Jaeckel,GER,DF,Union Berlin,25,1998,2.6,7,2,4,3,0,5,9,55.6,4,3,2,1,4,11,7,0,Bundesliga,2023_2024
Kristijan Jakić,CRO,MF,Augsburg,26,1997,11.7,28,14,14,10,4,15,33,45.5,18,13,1,12,20,48,15,0,Bundesliga,2023_2024
Kristijan Jakić,CRO,"MF,FW",Eint Frankfurt,26,1997,2.2,3,3,1,2,0,1,3,33.3,2,1,0,1,2,5,2,0,Bundesliga,2023_2024
Tony Jantschke,GER,"DF,MF",Gladbach,33,1990,0.3,1,1,1,0,0,1,1,100.0,0,2,2,0,1,2,4,0,Bundesliga,2023_2024
Nuha Jatta,GAM,FW,RB Leipzig,17,2006,0.0,0,0,0,0,0,0,0,,0,0,0,0,0,0,0,0,Bundesliga,2023_2024
Fredrik Jensen,FIN,"MF,FW",Augsburg,25,1997,14.9,23,11,9,8,6,14,28,50.0,14,30,1,29,12,35,21,0,Bundesliga,2023_2024
Moritz Jenz,GER,DF,Wolfsburg,24,1999,19.4,34,24,21,11,2,14,21,66.7,7,29,17,12,26,60,94,0,Bundesliga,2023_2024
Anthony Jung,GER,DF,Werder Bremen,31,1991,28.7,37,23,21,14,2,18,33,54.5,15,39,17,22,24,61,102,0,Bundesliga,2023_2024
Josip Juranović,CRO,DF,Union Berlin,27,1995,14.4,20,14,11,7,2,10,21,47.6,11,17,3,14,12,32,27,1,Bundesliga,2023_2024
David Jurásek,CZE,DF,Hoffenheim,22,2000,5.5,14,11,13,1,0,7,17,41.2,10,7,2,5,3,17,22,1,Bundesliga,2023_2024
Julian Justvan,GER,"FW,MF",Hoffenheim,25,1998,0.5,1,0,1,0,0,1,2,50.0,1,1,0,1,0,1,0,0,Bundesliga,2023_2024
Julian Justvan,GER,"MF,FW",Darmstadt 98,25,1998,11.4,10,4,2,7,1,3,17,17.6,14,12,2,10,11,21,6,1,Bundesliga,2023_2024
Ozan Kabak,TUR,DF,Hoffenheim,23,2000,25.4,48,35,32,14,2,19,33,57.6,14,43,21,22,46,94,106,2,Bundesliga,2023_2024
Pavel Kadeřábek,CZE,"DF,FW",Hoffenheim,31,1992,26.8,31,19,10,15,6,18,40,45.0,22,22,8,14,23,54,68,0,Bundesliga,2023_2024
Florian Kainz,AUT,"MF,FW",Köln,30,1992,24.4,28,20,8,13,7,17,39,43.6,22,20,6,14,13,41,23,1,Bundesliga,2023_2024
Sasa Kalajdzic,AUT,FW,Eint Frankfurt,26,1997,3.6,2,2,0,2,0,0,0,,0,2,2,0,2,4,6,0,Bundesliga,2023_2024
Jakub Kamiński,POL,"FW,MF",Wolfsburg,21,2002,5.3,14,5,12,2,0,3,6,50.0,3,3,0,3,2,16,5,0,Bundesliga,2023_2024
Kevin Kampl,SVN,MF,RB Leipzig,32,1990,15.1,19,8,8,9,2,10,21,47.6,11,19,7,12,11,30,14,1,Bundesliga,2023_2024
Harry Kane,ENG,FW,Bayern Munich,30,1993,31.5,13,9,4,4,5,6,18,33.3,12,12,4,8,6,19,14,0,Bundesliga,2023_2024
Atakan Karazor,GER,MF,Stuttgart,26,1996,29.1,72,44,23,38,11,29,60,48.3,31,37,8,29,27,99,43,0,Bundesliga,2023_2024
Emir Karic,AUT,DF,Darmstadt 98,26,1997,19.8,45,27,23,14,8,21,33,63.6,12,42,11,31,13,58,43,0,Bundesliga,2023_2024
Silas Katompa,COD,"FW,MF",Stuttgart,24,1998,10.0,5,3,3,2,0,3,12,25.0,9,9,0,9,0,5,4,0,Bundesliga,2023_2024
Mikkel Kaufmann,DEN,FW,Union Berlin,22,2001,5.4,6,3,2,3,1,3,10,30.0,7,12,0,12,1,7,4,0,Bundesliga,2023_2024
Naby Keïta,GUI,"MF,DF",Werder Bremen,28,1995,1.2,1,1,1,0,0,0,1,0.0,1,2,0,2,2,3,1,0,Bundesliga,2023_2024
Yannik Keitel,GER,"DF,MF",Freiburg,23,2000,10.2,20,15,14,5,1,10,15,66.7,5,17,8,9,12,32,44,3,Bundesliga,2023_2024
Thomas Keller,GER,"MF,FW",Heidenheim,23,1999,0.0,0,0,0,0,0,0,0,,0,0,0,0,0,0,0,0,Bundesliga,2023_2024
Aljoscha Kemlein,GER,MF,Union Berlin,18,2004,0.3,0,0,0,0,0,0,3,0.0,3,1,0,1,0,0,0,0,Bundesliga,2023_2024
Tobias Kempe,GER,MF,Darmstadt 98,34,1989,15.0,20,13,9,8,3,8,24,33.3,16,16,4,12,9,29,12,0,Bundesliga,2023_2024
Rani Khedira,GER,MF,Union Berlin,29,1994,14.9,35,22,15,19,1,17,26,65.4,9,12,5,7,22,57,38,0,Bundesliga,2023_2024
Luca Kilian,GER,DF,Köln,23,1999,7.1,16,9,15,1,0,9,14,64.3,5,12,5,7,7,23,28,0,Bundesliga,2023_2024
Joshua Kimmich,GER,"MF,DF",Bayern Munich,28,1995,24.2,45,33,25,15,5,26,39,66.7,13,32,4,28,14,59,28,1,Bundesliga,2023_2024
Christoph Klarer,AUT,DF,Darmstadt 98,23,2000,26.2,37,22,30,4,3,24,36,66.7,12,31,20,11,21,58,94,1,Bundesliga,2023_2024
Tim Kleindienst,GER,FW,Heidenheim,27,1995,31.9,21,12,6,11,4,7,25,28.0,18,32,8,24,12,33,58,0,Bundesliga,2023_2024
Lukas Klostermann,GER,DF,RB Leipzig,27,1996,16.0,15,10,7,7,1,4,13,30.8,9,25,12,13,13,28,64,1,Bundesliga,2023_2024
Ansgar Knauff,GER,"MF,DF",Eint Frankfurt,21,2002,23.4,43,26,17,16,10,17,31,54.8,14,40,3,37,20,63,15,0,Bundesliga,2023_2024
Robin Knoche,GER,DF,Union Berlin,31,1992,21.3,34,22,27,7,0,19,30,63.3,11,27,19,8,13,47,73,0,Bundesliga,2023_2024
Gregor Kobel,SUI,GK,Dortmund,25,1997,26.3,0,0,0,0,0,0,1,0.0,1,0,0,0,0,0,11,0,Bundesliga,2023_2024
Robin Koch,GER,DF,Eint Frankfurt,27,1996,30.4,38,23,26,12,0,17,27,63.0,10,33,24,9,32,70,136,2,Bundesliga,2023_2024
Dominik Kohr,GER,"DF,MF",Mainz 05,29,1994,24.3,65,42,36,25,4,36,57,63.2,21,27,6,21,43,108,58,0,Bundesliga,2023_2024
Randal Kolo Muani,FRA,FW,Eint Frankfurt,24,1998,1.7,0,0,0,0,0,0,0,,0,0,0,0,0,0,1,0,Bundesliga,2023_2024
Mert Kömür,GER,"MF,DF",Augsburg,18,2005,1.3,3,3,3,0,0,3,5,60.0,2,0,0,0,0,3,1,0,Bundesliga,2023_2024
Manu Koné,FRA,MF,Gladbach,22,2001,17.3,45,26,20,20,5,17,25,68.0,8,22,1,21,15,60,16,1,Bundesliga,2023_2024
Odilon Kossounou,CIV,DF,Leverkusen,22,2001,20.1,30,20,11,12,7,15,26,57.7,11,27,3,24,27,57,43,1,Bundesliga,2023_2024
Tomáš Koubek,CZE,GK,Augsburg,30,1992,3.0,0,0,0,0,0,0,0,,0,0,0,0,0,0,1,1,Bundesliga,2023_2024
Matej Kovar,CZE,GK,Leverkusen,23,2000,1.0,0,0,0,0,0,0,0,,0,0,0,0,0,0,0,0,Bundesliga,2023_2024
Dawid Kownacki,POL,FW,Werder Bremen,26,1997,4.2,1,1,1,0,0,1,4,25.0,3,3,1,2,0,1,1,0,Bundesliga,2023_2024
Alex Král,CZE,MF,Union Berlin,25,1998,15.2,19,14,7,10,2,8,20,40.0,12,15,4,11,11,30,30,0,Bundesliga,2023_2024
Andrej Kramarić,CRO,"MF,FW",Hoffenheim,32,1991,24.4,11,2,5,4,2,6,13,46.2,7,14,2,12,10,21,12,2,Bundesliga,2023_2024
Christoph Kramer,GER,MF,Gladbach,32,1991,2.8,10,5,5,5,0,2,14,14.3,12,7,1,6,4,14,6,0,Bundesliga,2023_2024
Frans Krätzig,GER,DF,Bayern Munich,20,2003,0.6,2,0,2,0,0,1,2,50.0,1,0,0,0,0,2,0,0,Bundesliga,2023_2024
Tom Krauß,GER,MF,Mainz 05,22,2001,15.0,57,33,22,31,4,21,58,36.2,37,33,4,29,17,74,28,0,Bundesliga,2023_2024
Lukas Kübler,GER,DF,Freiburg,30,1992,20.5,50,24,35,13,2,26,42,61.9,16,36,14,22,37,87,57,1,Bundesliga,2023_2024
Mahmut Kücüksahin,nan,MF,Augsburg,19,2004,0.0,0,0,0,0,0,0,0,,0,0,0,0,0,0,0,0,Bundesliga,2023_2024
Christian Kühlwetter,GER,MF,Heidenheim,27,1996,0.1,0,0,0,0,0,0,0,,0,0,0,0,0,0,0,0,Bundesliga,2023_2024
Moritz-Broni Kwarteng,GHA,FW,Bochum,25,1998,3.1,3,0,0,3,0,1,7,14.3,6,4,0,4,2,5,0,0,Bundesliga,2023_2024
Maxence Lacroix,FRA,DF,Wolfsburg,23,2000,26.2,48,29,28,18,2,29,41,70.7,12,35,12,23,24,72,121,0,Bundesliga,2023_2024
Aïssa Laïdouni,TUN,MF,Union Berlin,26,1996,11.9,21,12,4,12,5,4,12,33.3,8,26,2,24,12,33,14,2,Bundesliga,2023_2024
Konrad Laimer,AUT,"DF,MF",Bayern Munich,26,1997,19.7,56,36,25,20,11,22,52,42.3,30,42,6,36,18,74,13,2,Bundesliga,2023_2024
Stefan Lainer,AUT,"DF,MF",Gladbach,30,1992,8.3,23,16,15,8,0,14,24,58.3,10,13,6,7,5,28,28,0,Bundesliga,2023_2024
Hugo Larsson,SWE,MF,Eint Frankfurt,19,2004,21.0,32,18,18,10,4,15,28,53.6,13,34,7,27,29,61,30,1,Bundesliga,2023_2024
Diogo Leite,POR,DF,Union Berlin,24,1999,30.0,52,36,31,15,6,25,51,49.0,26,48,22,26,47,99,155,1,Bundesliga,2023_2024
Maxim Leitsch,GER,DF,Mainz 05,25,1998,4.2,6,3,5,1,0,3,6,50.0,3,2,0,2,4,10,13,0,Bundesliga,2023_2024
Christopher Lenz,GER,"DF,MF",RB Leipzig,28,1994,0.5,2,1,2,0,0,1,1,100.0,0,0,0,0,2,4,2,0,Bundesliga,2023_2024
Christopher Lenz,GER,DF,Eint Frankfurt,28,1994,0.1,1,1,0,1,0,1,1,100.0,0,0,0,0,0,1,1,0,Bundesliga,2023_2024
Jamie Leweling,GER,"FW,MF",Stuttgart,22,2001,16.9,18,10,4,6,8,5,17,29.4,12,21,1,20,5,23,13,0,Bundesliga,2023_2024
Philipp Lienhart,AUT,DF,Freiburg,27,1996,14.1,20,13,14,5,1,13,23,56.5,10,18,11,7,14,34,51,0,Bundesliga,2023_2024
Matthijs de Ligt,NED,DF,Bayern Munich,23,1999,15.4,15,12,4,8,3,6,11,54.5,5,14,10,4,19,34,52,0,Bundesliga,2023_2024
Jesper Lindstrøm,DEN,FW,Eint Frankfurt,23,2000,0.9,1,1,1,0,0,0,0,,0,0,0,0,0,1,0,0,Bundesliga,2023_2024
Dejan Ljubicic,AUT,"MF,FW",Köln,25,1997,22.8,43,27,20,18,5,20,43,46.5,23,22,2,20,18,61,11,0,Bundesliga,2023_2024
Noah Loosli,SUI,DF,Bochum,26,1997,3.8,10,7,6,4,0,7,14,50.0,7,7,1,6,7,17,18,0,Bundesliga,2023_2024
Anthony Losilla,FRA,MF,Bochum,37,1986,28.6,63,37,15,40,8,23,51,45.1,28,37,8,29,25,88,51,0,Bundesliga,2023_2024
Castello Lukeba,FRA,DF,RB Leipzig,20,2002,24.3,19,12,10,9,0,10,12,83.3,2,35,13,22,12,31,94,2,Bundesliga,2023_2024
Andreas Luthe,GER,GK,Bochum,36,1987,1.0,0,0,0,0,0,0,0,,0,0,0,0,0,0,1,0,Bundesliga,2023_2024
Senne Lynen,BEL,MF,Werder Bremen,24,1999,20.0,64,38,33,27,4,30,70,42.9,40,41,8,33,41,105,56,0,Bundesliga,2023_2024
Ian Maatsen,NED,DF,Dortmund,21,2002,14.0,30,22,15,9,6,16,30,53.3,14,22,4,18,13,43,26,0,Bundesliga,2023_2024
Matej Maglica,CRO,DF,Darmstadt 98,24,1998,18.9,35,21,25,10,0,22,36,61.1,14,29,11,18,22,57,92,5,Bundesliga,2023_2024
Arne Maier,GER,MF,Augsburg,24,1999,11.1,14,9,5,8,1,5,14,35.7,9,19,2,17,6,20,11,0,Bundesliga,2023_2024
Linton Maina,GER,"FW,MF",Köln,24,1999,21.1,18,15,11,5,2,9,28,32.1,19,12,1,11,6,24,12,0,Bundesliga,2023_2024
Patrick Mainka,GER,DF,Heidenheim,28,1994,34.0,85,49,58,24,3,38,74,51.4,36,66,32,34,49,134,158,1,Bundesliga,2023_2024
Lovro Majer,CRO,"MF,FW",Wolfsburg,25,1998,23.4,39,18,17,22,0,12,31,38.7,19,20,1,19,12,51,13,0,Bundesliga,2023_2024
Jordy Makengo,FRA,DF,Freiburg,21,2001,11.4,17,11,11,5,1,6,10,60.0,4,16,4,12,11,28,37,0,Bundesliga,2023_2024
Julián Malatini,ARG,DF,Werder Bremen,22,2001,6.7,18,13,12,3,3,16,24,66.7,8,8,1,7,13,31,26,0,Bundesliga,2023_2024
Donyell Malen,NED,"FW,MF",Dortmund,24,1999,19.8,11,7,5,3,3,2,6,33.3,4,11,4,7,2,13,8,0,Bundesliga,2023_2024
Lennard Maloney,USA,MF,Heidenheim,23,1999,25.4,43,26,14,24,5,25,59,42.4,34,33,9,24,25,68,88,0,Bundesliga,2023_2024
David Mamutovic,GER,"FW,DF",Mainz 05,22,2000,0.1,1,1,0,1,0,1,1,100.0,0,0,0,0,0,1,0,0,Bundesliga,2023_2024
Braydon Manu,GHA,MF,Darmstadt 98,26,1997,1.9,2,0,0,1,1,0,0,,0,1,0,1,0,2,0,0,Bundesliga,2023_2024
Omar Marmoush,EGY,"FW,MF",Eint Frankfurt,24,1999,25.6,21,11,7,8,6,6,16,37.5,10,13,0,13,11,32,7,0,Bundesliga,2023_2024
Eric Martel,GER,MF,Köln,21,2002,27.3,70,43,32,34,4,37,67,55.2,30,65,19,46,43,113,80,0,Bundesliga,2023_2024
Erhan Mašović,SRB,"DF,MF",Bochum,24,1998,24.7,64,40,37,22,5,37,70,52.9,33,32,10,22,25,89,75,2,Bundesliga,2023_2024
Roberto Massimo,GER,"FW,DF",Stuttgart,22,2000,0.9,1,0,1,0,0,1,2,50.0,1,0,0,0,0,1,1,0,Bundesliga,2023_2024
Jean Mattéo Bahoya,FRA,"MF,FW",Eint Frankfurt,18,2005,2.0,3,1,0,3,0,1,4,25.0,3,2,0,2,1,4,1,0,Bundesliga,2023_2024
Philipp Max,GER,DF,Eint Frankfurt,29,1993,15.0,26,17,6,18,2,19,26,73.1,7,18,1,17,7,33,18,2,Bundesliga,2023_2024
Eric Maxim Choupo-Moting,CMR,"MF,FW",Bayern Munich,34,1989,8.0,17,12,8,5,4,6,14,42.9,8,5,0,5,7,24,7,0,Bundesliga,2023_2024
Noussair Mazraoui,MAR,DF,Bayern Munich,25,1997,13.3,32,21,14,11,7,13,21,61.9,8,14,1,13,20,52,27,1,Bundesliga,2023_2024
Kevin Mbabu,SUI,DF,Augsburg,28,1995,22.7,51,39,25,18,8,23,40,57.5,17,29,9,20,24,75,48,0,Bundesliga,2023_2024
Noah Mbamba,BEL,MF,Leverkusen,18,2005,0.2,0,0,0,0,0,0,0,,0,0,0,0,1,1,0,0,Bundesliga,2023_2024
Nathanael Mbuku,FRA,FW,Augsburg,21,2002,0.1,0,0,0,0,0,0,0,,0,1,0,1,0,0,0,0,Bundesliga,2023_2024
Marvin Mehlem,GER,MF,Darmstadt 98,25,1997,16.5,28,21,10,14,4,11,27,40.7,16,21,2,19,33,61,15,0,Bundesliga,2023_2024
Thomas Meunier,BEL,DF,Dortmund,31,1991,6.5,5,1,3,2,0,3,13,23.1,10,8,2,6,4,9,22,0,Bundesliga,2023_2024
Alexander Meyer,GER,GK,Dortmund,32,1991,7.7,1,1,1,0,0,1,1,100.0,0,0,0,0,0,1,2,1,Bundesliga,2023_2024
Sven Michel,GER,"FW,MF",Augsburg,33,1990,6.5,7,5,2,1,4,2,7,28.6,5,1,0,1,0,7,4,0,Bundesliga,2023_2024
Enzo Millot,FRA,"MF,FW",Stuttgart,21,2002,24.9,40,22,9,21,10,18,39,46.2,21,24,2,22,16,56,7,1,Bundesliga,2023_2024
Jovan Milošević,SRB,"FW,MF",Stuttgart,18,2005,0.3,0,0,0,0,0,0,0,,0,0,0,0,0,0,0,0,Bundesliga,2023_2024
Kim Min-jae,KOR,DF,Bayern Munich,26,1996,21.9,37,24,21,11,5,12,24,50.0,12,29,19,10,45,82,70,2,Bundesliga,2023_2024
Maximilian Mittelstädt,GER,DF,Stuttgart,26,1997,23.4,91,51,46,39,6,53,89,59.6,36,36,6,30,46,137,65,0,Bundesliga,2023_2024
Marko Mladenović,SRB,MF,Eint Frankfurt,18,2005,0.1,0,0,0,0,0,0,0,,0,0,0,0,0,0,0,0,Bundesliga,2023_2024
Max Moerstedt,GER,"DF,FW",Hoffenheim,,,0.1,0,0,0,0,0,0,1,0.0,1,0,0,0,0,0,0,0,Bundesliga,2023_2024
Mateu Morey,ESP,DF,Dortmund,23,2000,1.2,2,2,1,1,0,2,4,50.0,2,3,1,2,1,3,3,0,Bundesliga,2023_2024
Youssoufa Moukoko,GER,FW,Dortmund,18,2004,6.9,4,1,2,2,0,3,7,42.9,4,4,1,3,2,6,4,0,Bundesliga,2023_2024
Andreas Müller,GER,MF,Darmstadt 98,23,2000,3.9,14,9,8,5,1,4,9,44.4,5,5,2,3,4,18,5,0,Bundesliga,2023_2024
Jannik Müller,GER,"DF,MF",Darmstadt 98,29,1994,12.6,33,16,21,9,3,16,27,59.3,11,24,12,12,17,50,39,1,Bundesliga,2023_2024
Kevin Müller,GER,GK,Heidenheim,32,1991,34.0,3,0,3,0,0,3,5,60.0,2,0,0,0,0,3,6,1,Bundesliga,2023_2024
Marcus Müller,GER,MF,Mainz 05,20,2002,0.2,0,0,0,0,0,0,0,,0,0,0,0,0,0,0,0,Bundesliga,2023_2024
Thomas Müller,GER,"MF,FW",Bayern Munich,33,1989,18.4,26,16,5,10,11,13,35,37.1,22,22,0,22,3,29,6,0,Bundesliga,2023_2024
Jamal Musiala,GER,"MF,FW",Bayern Munich,20,2003,19.5,40,25,9,21,10,14,36,38.9,22,25,1,24,16,56,5,0,Bundesliga,2023_2024
Florent Muslija,KVX,"MF,FW",Freiburg,25,1998,1.2,5,4,3,2,0,2,5,40.0,3,1,0,1,0,5,2,0,Bundesliga,2023_2024
Phillipp Mwene,AUT,DF,Mainz 05,29,1994,22.2,34,15,15,16,3,16,33,48.5,17,27,3,24,17,51,47,0,Bundesliga,2023_2024
Joakim Mæhle,DEN,"DF,MF",Wolfsburg,26,1997,27.2,62,39,33,18,11,41,64,64.1,23,43,5,38,29,91,65,0,Bundesliga,2023_2024
Nathan N'Goumou,FRA,"FW,MF",Gladbach,23,2000,15.4,37,22,17,18,2,16,34,47.1,18,22,0,22,5,42,17,1,Bundesliga,2023_2024
Stanley N'Soki,FRA,DF,Hoffenheim,24,1999,7.0,21,10,12,8,1,17,29,58.6,12,13,2,11,8,29,33,0,Bundesliga,2023_2024
Luca Netz,GER,DF,Gladbach,20,2003,24.7,38,22,19,16,3,23,43,53.5,20,36,10,26,22,60,76,1,Bundesliga,2023_2024
Manuel Neuer,GER,GK,Bayern Munich,37,1986,22.8,1,1,1,0,0,0,0,,0,0,0,0,0,1,14,3,Bundesliga,2023_2024
Florian Neuhaus,GER,MF,Gladbach,26,1997,13.6,15,12,7,8,0,8,26,30.8,18,8,6,2,14,29,8,0,Bundesliga,2023_2024
Jessic Ngankam,GER,"FW,MF",Mainz 05,23,2000,2.0,1,1,0,1,0,0,0,,0,3,1,2,3,4,0,0,Bundesliga,2023_2024
Jessic Ngankam,GER,FW,Eint Frankfurt,23,2000,3.1,3,2,1,1,1,0,0,,0,0,0,0,0,3,1,0,Bundesliga,2023_2024
Moritz Nicolas,GER,GK,Gladbach,25,1997,27.0,1,0,1,0,0,1,3,33.3,2,0,0,0,0,1,12,5,Bundesliga,2023_2024
Justin Njinmah,GER,FW,Werder Bremen,22,2000,11.3,5,1,2,2,1,3,9,33.3,6,9,1,8,2,7,6,0,Bundesliga,2023_2024
Niels Nkounkou,FRA,"DF,MF",Eint Frankfurt,22,2000,14.5,54,30,34,17,3,29,64,45.3,35,30,2,28,16,70,30,0,Bundesliga,2023_2024
Felix Nmecha,GER,MF,Dortmund,22,2000,11.3,19,13,7,8,4,11,22,50.0,11,18,5,13,11,30,19,0,Bundesliga,2023_2024
Lukas Nmecha,GER,FW,Wolfsburg,24,1998,0.5,1,1,0,0,1,0,0,,0,1,0,1,0,1,0,0,Bundesliga,2023_2024
Jonathan Norbye,NOR,MF,RB Leipzig,16,2007,0.0,0,0,0,0,0,0,0,,0,0,0,0,0,0,0,0,Bundesliga,2023_2024
Alexander Nübel,GER,GK,Stuttgart,26,1996,30.0,2,2,2,0,0,2,4,50.0,2,0,0,0,0,2,13,4,Bundesliga,2023_2024
Kasim Nuhu,GHA,DF,Hoffenheim,28,1995,0.1,0,0,0,0,0,0,0,,0,0,0,0,0,0,0,0,Bundesliga,2023_2024
Fabian Nürnberger,BUL,"DF,MF",Darmstadt 98,24,1999,16.8,29,22,22,6,1,22,41,53.7,19,11,1,10,17,46,26,0,Bundesliga,2023_2024
Tim Oermann,GER,DF,Bochum,19,2003,7.9,19,11,11,4,4,9,14,64.3,5,15,6,9,2,21,22,0,Bundesliga,2023_2024
Masaya Okugawa,JPN,"FW,DF",Augsburg,27,1996,0.4,0,0,0,0,0,0,0,,0,0,0,0,0,0,2,0,Bundesliga,2023_2024
Finn Ole Becker,GER,MF,Hoffenheim,23,2000,6.7,10,9,8,2,0,4,17,23.5,13,9,1,8,1,11,10,0,Bundesliga,2023_2024
Mathias Olesen,LUX,"MF,FW",Köln,22,2001,1.2,0,0,0,0,0,0,0,,0,0,0,0,2,2,2,0,Bundesliga,2023_2024
Dani Olmo,ESP,MF,RB Leipzig,25,1998,16.1,26,18,14,8,4,10,22,45.5,12,7,0,7,13,39,12,1,Bundesliga,2023_2024
Jonas Omlin,SUI,GK,Gladbach,29,1994,7.0,1,0,1,0,0,1,1,100.0,0,0,0,0,0,1,3,0,Bundesliga,2023_2024
Karim Onisiwo,AUT,"FW,MF",Mainz 05,31,1992,16.6,17,8,4,6,7,6,11,54.5,5,18,4,14,2,19,7,0,Bundesliga,2023_2024
Loïs Openda,BEL,FW,RB Leipzig,23,2000,30.0,3,3,0,1,2,0,6,0.0,6,19,3,16,5,8,14,0,Bundesliga,2023_2024
Leon Opitz,GER,"FW,DF",Werder Bremen,18,2005,0.2,2,2,1,1,0,2,3,66.7,1,0,0,0,0,2,0,0,Bundesliga,2023_2024
Willi Orban,HUN,DF,RB Leipzig,30,1992,17.6,20,12,8,10,2,9,18,50.0,9,22,13,9,16,36,76,1,Bundesliga,2023_2024
Ivan Ordets,UKR,DF,Bochum,31,1992,20.9,19,14,11,6,2,10,17,58.8,7,41,29,12,31,50,130,0,Bundesliga,2023_2024
Patrick Osterhage,GER,MF,Bochum,23,2000,20.7,38,26,14,23,1,17,36,47.2,19,36,9,27,27,65,32,1,Bundesliga,2023_2024
Salih Özcan,TUR,MF,Dortmund,25,1998,13.2,20,12,11,8,1,10,18,55.6,8,28,3,25,17,37,18,1,Bundesliga,2023_2024
Willian Pacho,ECU,DF,Eint Frankfurt,21,2001,33.0,62,37,38,23,1,31,53,58.5,22,51,22,29,47,109,152,2,Bundesliga,2023_2024
Gonçalo Paciência,POR,"FW,MF",Bochum,28,1994,7.2,8,4,2,2,4,3,6,50.0,3,5,0,5,0,8,7,0,Bundesliga,2023_2024
Exequiel Palacios,ARG,MF,Leverkusen,24,1998,20.3,60,34,28,26,6,26,53,49.1,27,24,0,24,29,89,20,2,Bundesliga,2023_2024
Miloš Pantović,SRB,MF,Union Berlin,27,1996,0.2,0,0,0,0,0,0,0,,0,0,0,0,0,0,0,0,Bundesliga,2023_2024
Antonios Papadopoulos,GER,DF,Dortmund,23,1999,1.3,6,3,6,0,0,6,7,85.7,1,3,2,1,2,8,7,0,Bundesliga,2023_2024
Merveille Papela,GER,"MF,DF",Mainz 05,22,2001,2.9,5,4,2,3,0,0,4,0.0,4,1,0,1,4,9,2,0,Bundesliga,2023_2024
Leart Paqarada,KVX,DF,Köln,28,1994,11.9,21,11,9,9,3,11,22,50.0,11,17,5,12,10,31,30,1,Bundesliga,2023_2024
Kevin Paredes,USA,"FW,MF",Wolfsburg,20,2003,15.9,42,21,22,13,7,20,34,58.8,14,27,2,25,23,65,26,0,Bundesliga,2023_2024
Felix Passlack,GER,DF,Bochum,25,1998,10.7,21,14,9,10,2,14,24,58.3,10,13,2,11,10,31,21,0,Bundesliga,2023_2024
Jiří Pavlenka,CZE,GK,Werder Bremen,31,1992,7.0,0,0,0,0,0,0,0,,0,0,0,0,0,0,2,0,Bundesliga,2023_2024
Aleksandar Pavlovic,GER,MF,Bayern Munich,19,2004,13.6,28,16,10,14,4,17,33,51.5,16,13,3,10,17,45,12,0,Bundesliga,2023_2024
Mads Pedersen,DEN,DF,Augsburg,26,1996,19.8,64,39,31,27,6,24,44,54.5,20,20,3,17,19,83,46,0,Bundesliga,2023_2024
Jordan Pefok,USA,FW,Gladbach,27,1996,15.8,10,4,0,8,2,3,8,37.5,5,12,3,9,5,15,28,0,Bundesliga,2023_2024
Jordan Pefok,USA,FW,Union Berlin,27,1996,0.3,0,0,0,0,0,0,0,,0,1,1,0,0,0,0,0,Bundesliga,2023_2024
Dženan Pejčinović,GER,FW,Wolfsburg,18,2005,0.4,0,0,0,0,0,0,0,,0,1,0,1,0,0,0,0,Bundesliga,2023_2024
Daniel Peretz,ISR,GK,Bayern Munich,23,2000,0.2,0,0,0,0,0,0,0,,0,0,0,0,0,0,0,0,Bundesliga,2023_2024
Matteo Perez Vinlöf,SWE,FW,Bayern Munich,17,2005,0.2,0,0,0,0,0,0,0,,0,0,0,0,1,1,0,0,Bundesliga,2023_2024
Pavao Pervan,AUT,GK,Wolfsburg,35,1987,9.0,0,0,0,0,0,0,0,,0,0,0,0,0,0,4,0,Bundesliga,2023_2024
Jens Petter Hauge,NOR,"MF,FW",Eint Frankfurt,23,1999,1.6,2,1,1,0,1,2,7,28.6,5,5,1,4,0,2,1,0,Bundesliga,2023_2024
Luca Pfeiffer,GER,"FW,MF",Darmstadt 98,26,1996,18.0,11,6,2,6,3,5,11,45.5,6,5,1,4,2,13,21,0,Bundesliga,2023_2024
Patric Pfeiffer,GER,DF,Augsburg,23,1999,5.7,11,7,6,4,1,5,6,83.3,1,10,6,4,11,22,21,0,Bundesliga,2023_2024
Maximilian Philipp,GER,"FW,MF",Freiburg,29,1994,3.6,8,5,4,4,0,1,6,16.7,5,7,0,7,1,9,3,0,Bundesliga,2023_2024
Florian Pick,GER,"MF,FW",Heidenheim,27,1995,3.6,4,4,3,0,1,2,3,66.7,1,2,0,2,2,6,2,0,Bundesliga,2023_2024
Amos Pieper,GER,DF,Werder Bremen,25,1998,6.6,14,11,8,6,0,7,13,53.8,6,12,7,5,9,23,36,1,Bundesliga,2023_2024
Marvin Pieringer,GER,"MF,FW",Heidenheim,23,1999,16.8,19,12,5,11,3,8,20,40.0,12,28,4,24,12,31,21,0,Bundesliga,2023_2024
Alassane Pléa,FRA,"FW,MF",Gladbach,30,1993,21.3,17,7,5,8,4,7,15,46.7,8,11,0,11,2,19,6,0,Bundesliga,2023_2024
Ole Pohlmann,GER,MF,Dortmund,22,2001,0.6,1,0,0,1,0,1,2,50.0,1,0,0,0,0,1,1,0,Bundesliga,2023_2024
Sebastian Polter,GER,FW,Darmstadt 98,32,1991,5.0,1,0,1,0,0,0,1,0.0,1,5,1,4,0,1,4,0,Bundesliga,2023_2024
Yussuf Poulsen,DEN,FW,RB Leipzig,29,1994,13.5,13,8,1,9,3,4,14,28.6,10,13,3,10,4,17,15,0,Bundesliga,2023_2024
Grischa Prömel,GER,MF,Hoffenheim,28,1995,23.8,32,18,11,15,6,14,32,43.8,18,22,6,16,22,54,36,0,Bundesliga,2023_2024
Gustavo Puerta,COL,"DF,MF",Leverkusen,20,2003,0.5,5,3,2,2,1,1,2,50.0,1,2,0,2,0,5,0,0,Bundesliga,2023_2024
Luca Raimund,GER,"FW,MF",Stuttgart,18,2005,0.3,3,1,2,1,0,0,0,,0,2,0,2,0,3,0,0,Bundesliga,2023_2024
Grant Ranos,ARM,"MF,FW",Gladbach,20,2003,0.5,1,0,0,0,1,0,0,,0,0,0,0,0,1,0,0,Bundesliga,2023_2024
Nicolai Rapp,GER,DF,Werder Bremen,26,1996,0.8,3,2,2,1,0,2,2,100.0,0,2,0,2,2,5,8,0,Bundesliga,2023_2024
David Raum,GER,DF,RB Leipzig,25,1998,30.4,58,35,24,29,5,34,58,58.6,24,51,9,42,27,85,82,2,Bundesliga,2023_2024
Rocco Reitz,GER,MF,Gladbach,21,2002,23.7,61,36,28,29,4,28,55,50.9,27,61,20,41,44,105,31,1,Bundesliga,2023_2024
Marco Reus,GER,"MF,FW",Dortmund,34,1989,17.8,37,25,20,14,3,12,27,44.4,15,17,2,15,5,42,18,0,Bundesliga,2023_2024
Elvis Rexhbeçaj,KVX,MF,Augsburg,25,1997,22.1,30,19,14,13,3,18,36,50.0,18,32,7,25,20,50,20,0,Bundesliga,2023_2024
Gio Reyna,USA,"MF,FW",Dortmund,20,2002,3.1,9,6,3,4,2,2,5,40.0,3,5,1,4,2,11,5,0,Bundesliga,2023_2024
Marco Richter,GER,"MF,FW",Mainz 05,25,1997,8.0,10,4,5,3,2,4,11,36.4,7,9,0,9,2,12,1,0,Bundesliga,2023_2024
Clemens Riedel,GER,DF,Darmstadt 98,20,2003,8.4,22,13,16,5,1,15,24,62.5,9,11,3,8,11,33,26,0,Bundesliga,2023_2024
Manuel Riemann,GER,GK,Bochum,34,1988,33.0,2,1,2,0,0,2,4,50.0,2,0,0,0,1,3,25,1,Bundesliga,2023_2024
Sebastian Rode,GER,MF,Eint Frankfurt,32,1990,0.7,6,4,0,5,1,4,6,66.7,2,0,0,0,1,7,1,0,Bundesliga,2023_2024
Rogério,BRA,DF,Wolfsburg,25,1998,10.1,14,6,7,5,2,10,14,71.4,4,16,5,11,5,19,23,1,Bundesliga,2023_2024
Merlin Röhl,GER,"MF,FW",Freiburg,21,2002,16.4,21,13,10,9,2,8,21,38.1,13,27,3,24,9,30,22,0,Bundesliga,2023_2024
Frank Ronstadt,GER,"DF,MF",Darmstadt 98,26,1997,0.8,1,0,0,1,0,0,1,0.0,1,1,0,1,1,2,3,0,Bundesliga,2023_2024
Anthony Rouault,FRA,DF,Stuttgart,22,2001,11.2,21,12,14,5,2,13,21,61.9,8,14,8,6,8,29,28,0,Bundesliga,2023_2024
Jérôme Roussillon,FRA,DF,Union Berlin,30,1993,8.4,16,9,6,7,3,8,12,66.7,4,13,4,9,5,21,26,0,Bundesliga,2023_2024
Fabian Rüdlin,GER,MF,Freiburg,26,1997,0.1,1,0,0,0,1,0,0,,0,0,0,0,0,1,0,0,Bundesliga,2023_2024
Julian Ryerson,NOR,DF,Dortmund,25,1997,19.6,41,23,26,11,4,27,47,57.4,20,31,7,24,10,51,35,3,Bundesliga,2023_2024
Frederik Rønnow,DEN,GK,Union Berlin,30,1992,33.0,1,1,1,0,0,0,0,,0,0,0,0,1,2,20,2,Bundesliga,2023_2024
Marcel Sabitzer,AUT,MF,Dortmund,29,1994,21.8,39,24,18,20,1,23,42,54.8,19,31,12,19,12,51,34,0,Bundesliga,2023_2024
Roland Sallai,HUN,"MF,FW",Freiburg,26,1997,20.4,17,10,5,5,7,8,20,40.0,12,21,1,20,6,23,23,0,Bundesliga,2023_2024
Diadie Samassékou,MLI,MF,Hoffenheim,27,1996,0.0,0,0,0,0,0,0,0,,0,0,0,0,1,1,0,0,Bundesliga,2023_2024
Jadon Sancho,ENG,"FW,MF",Dortmund,23,2000,10.5,5,4,1,3,1,0,4,0.0,4,11,0,11,4,9,6,0,Bundesliga,2023_2024
Leroy Sané,GER,FW,Bayern Munich,27,1996,23.7,15,8,6,6,3,4,19,21.1,15,12,0,12,7,22,3,0,Bundesliga,2023_2024
Amin Sarr,SWE,"FW,MF",Wolfsburg,22,2001,4.3,3,2,1,2,0,1,2,50.0,1,6,1,5,2,5,1,0,Bundesliga,2023_2024
Bouna Sarr,SEN,DF,Bayern Munich,31,1992,1.2,2,0,1,1,0,2,2,100.0,0,3,0,3,0,2,1,0,Bundesliga,2023_2024
Joe Scally,USA,DF,Gladbach,20,2002,24.8,41,28,21,17,3,23,40,57.5,17,31,11,20,18,59,78,2,Bundesliga,2023_2024
András Schäfer,HUN,MF,Union Berlin,24,1999,13.5,29,16,9,15,5,11,20,55.0,9,25,4,21,20,49,25,0,Bundesliga,2023_2024
Patrik Schick,CZE,FW,Leverkusen,27,1996,11.8,6,4,0,3,3,1,5,20.0,4,2,0,2,1,7,7,0,Bundesliga,2023_2024
Stefan Schimmer,GER,"MF,FW",Heidenheim,29,1994,1.7,1,1,0,1,0,0,3,0.0,3,2,0,2,1,2,6,0,Bundesliga,2023_2024
Xaver Schlager,AUT,MF,RB Leipzig,25,1997,27.5,81,50,35,38,8,21,53,39.6,32,41,8,33,19,100,27,0,Bundesliga,2023_2024
Keven Schlotterbeck,GER,DF,Bochum,26,1997,24.3,42,22,26,14,2,25,30,83.3,5,33,23,10,33,75,104,2,Bundesliga,2023_2024
Nico Schlotterbeck,GER,DF,Dortmund,23,1999,31.8,70,50,36,27,7,41,65,63.1,24,52,25,27,45,115,101,3,Bundesliga,2023_2024
Romano Schmid,AUT,"MF,FW",Werder Bremen,23,2000,28.9,35,20,7,22,6,14,46,30.4,32,36,7,29,11,46,17,2,Bundesliga,2023_2024
Kenneth Schmidt,GER,DF,Freiburg,21,2002,0.8,2,2,2,0,0,2,4,50.0,2,1,0,1,1,3,2,0,Bundesliga,2023_2024
Benno Schmitz,GER,DF,Köln,28,1994,12.8,27,15,20,7,0,17,34,50.0,17,19,4,15,7,34,29,0,Bundesliga,2023_2024
Fabian Schnellhardt,GER,MF,Darmstadt 98,29,1994,2.6,4,1,2,1,1,1,3,33.3,2,1,0,1,4,8,5,0,Bundesliga,2023_2024
Jan Schöppner,GER,MF,Heidenheim,24,1999,22.2,48,26,26,20,2,21,42,50.0,21,37,7,30,26,74,57,0,Bundesliga,2023_2024
Marcel Schuhen,GER,GK,Darmstadt 98,30,1993,31.0,1,0,1,0,0,1,3,33.3,2,0,0,0,2,3,11,4,Bundesliga,2023_2024
Marvin Schwäbe,GER,GK,Köln,28,1995,34.0,1,0,1,0,0,1,1,100.0,0,0,0,0,0,1,10,1,Bundesliga,2023_2024
Alexander Schwolow,GER,GK,Union Berlin,31,1992,1.0,0,0,0,0,0,0,0,,0,0,0,0,0,0,2,0,Bundesliga,2023_2024
Nicolas Seiwald,AUT,MF,RB Leipzig,22,2001,8.0,33,18,16,15,2,16,25,64.0,9,12,2,10,8,41,15,0,Bundesliga,2023_2024
Davie Selke,GER,FW,Köln,28,1995,14.1,4,2,1,3,0,0,2,0.0,2,5,3,2,0,4,20,0,Bundesliga,2023_2024
Benjamin Šeško,SVN,FW,RB Leipzig,20,2003,17.0,13,5,2,7,4,2,9,22.2,7,23,2,21,3,16,27,0,Bundesliga,2023_2024
Kevin Sessa,GER,"MF,FW",Heidenheim,23,2000,11.2,17,10,9,6,2,7,16,43.8,9,12,1,11,4,21,17,0,Bundesliga,2023_2024
Aaron Seydel,GER,FW,Darmstadt 98,27,1996,6.9,3,2,0,2,1,0,3,0.0,3,8,2,6,1,4,9,0,Bundesliga,2023_2024
Tim Siersleben,GER,DF,Heidenheim,23,2000,10.1,27,11,21,6,0,8,20,40.0,12,16,10,6,21,48,29,1,Bundesliga,2023_2024
Kiliann Sildillia,FRA,DF,Freiburg,21,2002,20.1,43,19,28,8,7,26,42,61.9,16,33,15,18,22,65,64,0,Bundesliga,2023_2024
Mohamed Simakan,FRA,DF,RB Leipzig,23,2000,23.8,48,29,28,19,1,32,44,72.7,12,36,14,22,29,77,69,0,Bundesliga,2023_2024
Xavi Simons,NED,MF,RB Leipzig,20,2003,29.5,30,17,10,11,9,15,31,48.4,16,23,0,23,16,46,4,0,Bundesliga,2023_2024
Tim Skarke,GER,"FW,DF",Darmstadt 98,26,1996,26.7,26,16,12,10,4,10,28,35.7,18,25,2,23,6,32,20,0,Bundesliga,2023_2024
Ellyes Skhiri,TUN,MF,Eint Frankfurt,28,1995,24.1,44,24,18,19,7,19,36,52.8,17,33,4,29,39,83,47,2,Bundesliga,2023_2024
Robert Skov,DEN,"DF,FW",Hoffenheim,27,1996,14.0,24,16,15,8,1,17,36,47.2,19,17,4,13,10,34,23,1,Bundesliga,2023_2024
Hrvoje Smolčić,CRO,DF,Eint Frankfurt,22,2000,3.9,7,3,7,0,0,4,5,80.0,1,3,1,2,6,13,23,1,Bundesliga,2023_2024
Danilo Soares,BRA,DF,Bochum,31,1991,3.9,10,6,5,3,2,5,8,62.5,3,6,0,6,7,17,11,0,Bundesliga,2023_2024
Borna Sosa,CRO,"FW,DF",Stuttgart,25,1998,0.5,0,0,0,0,0,0,1,0.0,1,0,0,0,0,0,0,0,Bundesliga,2023_2024
Anton Stach,GER,MF,Hoffenheim,24,1998,25.8,73,42,40,27,6,33,63,52.4,30,38,12,26,72,145,67,1,Bundesliga,2023_2024
Anton Stach,GER,MF,Mainz 05,24,1998,1.9,3,0,2,0,1,2,4,50.0,2,5,0,5,2,5,5,0,Bundesliga,2023_2024
Jens Stage,DEN,MF,Werder Bremen,26,1996,25.9,52,22,21,23,8,18,50,36.0,32,42,23,19,23,75,55,0,Bundesliga,2023_2024
Josip Stanišić,CRO,DF,Leverkusen,23,2000,14.0,38,20,19,13,6,22,33,66.7,11,18,3,15,9,47,26,0,Bundesliga,2023_2024
Niklas Stark,GER,DF,Werder Bremen,28,1995,12.1,26,15,13,11,2,12,18,66.7,6,14,7,7,19,45,61,1,Bundesliga,2023_2024
Pascal Stenzel,GER,DF,Stuttgart,27,1996,11.8,18,8,7,9,2,10,30,33.3,20,22,8,14,15,33,26,0,Bundesliga,2023_2024
Leonidas Stergiou,SUI,DF,Stuttgart,21,2002,6.6,15,8,7,7,1,9,13,69.2,4,8,1,7,5,20,13,0,Bundesliga,2023_2024
Angelo Stiller,GER,MF,Hoffenheim,22,2001,0.9,0,0,0,0,0,0,1,0.0,1,2,0,2,0,0,3,0,Bundesliga,2023_2024
Angelo Stiller,GER,MF,Stuttgart,22,2001,29.9,55,33,15,34,6,24,42,57.1,18,41,13,28,28,83,25,2,Bundesliga,2023_2024
Kevin Stöger,AUT,MF,Bochum,29,1993,29.6,49,30,21,21,7,25,63,39.7,38,46,4,42,19,68,18,0,Bundesliga,2023_2024
Filip Stojilković,SUI,"FW,MF",Darmstadt 98,23,2000,1.7,1,1,0,0,1,0,0,,0,0,0,0,0,1,1,0,Bundesliga,2023_2024
Niklas Süle,GER,DF,Dortmund,27,1995,16.8,18,10,14,3,1,11,16,68.8,5,25,14,11,25,43,58,2,Bundesliga,2023_2024
Mattias Svanberg,SWE,MF,Wolfsburg,24,1999,19.1,37,17,8,19,10,12,38,31.6,26,25,5,20,21,58,28,0,Bundesliga,2023_2024
Attila Szalai,HUN,DF,Hoffenheim,25,1998,3.2,3,1,3,0,0,1,4,25.0,3,6,2,4,1,4,7,0,Bundesliga,2023_2024
Attila Szalai,HUN,DF,Freiburg,25,1998,1.1,1,1,1,0,0,1,2,50.0,1,5,2,3,1,2,11,1,Bundesliga,2023_2024
Jonathan Tah,GER,DF,Leverkusen,27,1996,29.2,19,9,10,7,2,5,16,31.3,11,28,23,5,23,42,97,1,Bundesliga,2023_2024
Edmond Tapsoba,BFA,DF,Leverkusen,24,1999,23.2,34,25,17,15,2,17,24,70.8,7,21,10,11,24,58,52,3,Bundesliga,2023_2024
Mathys Tel,FRA,"FW,MF",Bayern Munich,18,2005,11.7,12,2,3,4,5,4,6,66.7,2,11,0,11,6,18,6,0,Bundesliga,2023_2024
Nathan Tella,NGA,"DF,MF",Leverkusen,24,1999,9.1,13,8,6,5,2,5,10,50.0,5,10,0,10,3,16,8,0,Bundesliga,2023_2024
Norman Theuerkauf,GER,"MF,DF",Heidenheim,36,1987,14.0,24,16,13,7,4,13,22,59.1,9,16,6,10,14,38,21,0,Bundesliga,2023_2024
Jan Thielmann,GER,"FW,DF",Köln,21,2002,17.5,28,18,13,9,6,12,24,50.0,12,31,6,25,8,36,28,0,Bundesliga,2023_2024
Denis Thomalla,GER,"MF,FW",Heidenheim,30,1992,5.0,9,6,4,4,1,5,11,45.5,6,3,2,1,4,13,13,0,Bundesliga,2023_2024
Phillip Tietz,GER,FW,Augsburg,26,1997,26.5,23,14,7,13,3,6,15,40.0,9,17,3,14,6,29,35,0,Bundesliga,2023_2024
Steffen Tigges,GER,FW,Köln,25,1998,8.1,10,6,4,5,1,3,7,42.9,4,4,2,2,1,11,12,0,Bundesliga,2023_2024
Umut Tohumcu,GER,MF,Hoffenheim,18,2004,11.2,16,12,9,7,0,6,19,31.6,13,11,1,10,6,22,12,0,Bundesliga,2023_2024
Tiago Tomás,POR,"FW,MF",Wolfsburg,21,2002,11.5,5,2,3,0,2,1,6,16.7,5,13,0,13,3,8,9,0,Bundesliga,2023_2024
Fabio Torsiello,ITA,"FW,DF",Darmstadt 98,18,2005,1.7,1,0,1,0,0,1,8,12.5,7,1,0,1,1,2,1,0,Bundesliga,2023_2024
Lucas Tousart,FRA,MF,Union Berlin,26,1997,17.5,35,20,14,17,4,17,37,45.9,20,32,9,23,25,60,41,0,Bundesliga,2023_2024
Omar Traoré,GER,DF,Heidenheim,25,1998,27.5,60,33,33,21,6,32,56,57.1,24,32,7,25,40,100,54,1,Bundesliga,2023_2024
Kevin Trapp,GER,GK,Eint Frankfurt,33,1990,32.0,0,0,0,0,0,0,0,,0,0,0,0,1,1,9,1,Bundesliga,2023_2024
Christopher Trimmel,AUT,DF,Union Berlin,36,1987,18.3,23,15,12,10,1,13,33,39.4,20,16,3,13,13,36,57,0,Bundesliga,2023_2024
Tuta,BRA,DF,Eint Frankfurt,24,1999,28.9,63,33,38,19,6,39,59,66.1,20,29,12,17,36,99,99,0,Bundesliga,2023_2024
Lukas Ullrich,GER,"DF,FW",Gladbach,19,2004,0.5,1,0,1,0,0,1,4,25.0,3,0,0,0,0,1,1,0,Bundesliga,2023_2024
Sven Ulreich,GER,GK,Bayern Munich,34,1988,11.0,1,0,1,0,0,1,1,100.0,0,0,0,0,0,1,3,2,Bundesliga,2023_2024
Deniz Undav,GER,"FW,MF",Stuttgart,27,1996,23.2,28,13,6,8,14,4,15,26.7,11,17,0,17,6,34,5,0,Bundesliga,2023_2024
Dayot Upamecano,FRA,DF,Bayern Munich,24,1998,19.6,34,21,21,11,2,15,29,51.7,14,19,7,12,19,53,56,3,Bundesliga,2023_2024
Mark Uth,GER,"MF,FW",Köln,31,1991,4.1,8,4,2,3,3,4,12,33.3,8,6,0,6,1,9,2,0,Bundesliga,2023_2024
Josha Vagnoman,GER,DF,Stuttgart,22,2000,13.1,28,18,15,11,2,15,30,50.0,15,11,5,6,2,30,16,1,Bundesliga,2023_2024
Ruben Vargas,SUI,"MF,FW",Augsburg,24,1998,21.8,23,10,6,10,7,10,25,40.0,15,19,4,15,7,30,17,0,Bundesliga,2023_2024
Miloš Veljković,SRB,DF,Werder Bremen,27,1995,21.3,31,15,17,13,1,16,31,51.6,15,31,20,11,17,48,57,0,Bundesliga,2023_2024
Yorbe Vertessen,BEL,"FW,MF",Union Berlin,22,2001,6.6,3,2,0,3,0,1,4,25.0,3,8,0,8,1,4,3,0,Bundesliga,2023_2024
Oscar Vilhelmsson,SWE,"FW,MF",Darmstadt 98,19,2003,15.3,13,6,3,7,3,7,10,70.0,3,15,5,10,3,16,19,0,Bundesliga,2023_2024
Kevin Vogt,GER,DF,Hoffenheim,31,1991,14.7,14,10,7,7,0,8,13,61.5,5,16,13,3,9,23,54,0,Bundesliga,2023_2024
Kevin Vogt,GER,DF,Union Berlin,31,1991,14.7,10,9,6,4,0,6,12,50.0,6,22,15,7,7,17,72,2,Bundesliga,2023_2024
Kevin Volland,GER,"FW,MF",Union Berlin,31,1992,14.9,22,9,8,8,6,8,20,40.0,12,8,0,8,6,28,12,0,Bundesliga,2023_2024
Aster Vranckx,BEL,MF,Wolfsburg,20,2002,12.8,32,15,11,11,10,15,28,53.6,13,17,6,11,14,46,29,0,Bundesliga,2023_2024
Luca Waldschmidt,GER,"MF,FW",Köln,27,1996,12.7,19,12,4,12,3,5,16,31.3,11,18,3,15,6,25,8,1,Bundesliga,2023_2024
Kjell-Arik Wätjen,GER,"MF,FW",Dortmund,17,2006,1.2,3,2,2,1,0,2,5,40.0,3,1,1,0,0,3,3,0,Bundesliga,2023_2024
Wout Weghorst,NED,FW,Hoffenheim,30,1992,22.0,13,6,4,7,2,9,15,60.0,6,25,8,17,6,19,24,0,Bundesliga,2023_2024
Julian Weigl,GER,MF,Gladbach,27,1995,30.7,66,40,28,32,6,41,67,61.2,26,47,14,33,48,114,61,1,Bundesliga,2023_2024
Nelson Weiper,GER,"FW,MF",Mainz 05,18,2005,1.4,2,1,2,0,0,2,3,66.7,1,1,0,1,1,3,0,0,Bundesliga,2023_2024
Mitchell Weiser,GER,"DF,MF",Werder Bremen,29,1994,29.3,64,38,29,25,10,31,53,58.5,22,36,6,30,20,84,43,0,Bundesliga,2023_2024
Noah Weißhaupt,GER,"DF,FW",Freiburg,21,2001,8.4,9,4,6,0,3,5,11,45.5,6,8,1,7,8,17,12,0,Bundesliga,2023_2024
Timo Werner,GER,"FW,MF",RB Leipzig,27,1996,2.3,2,1,0,1,1,0,0,,0,1,0,1,1,3,0,0,Bundesliga,2023_2024
Silvan Widmer,SUI,DF,Mainz 05,30,1993,13.8,23,10,12,8,3,17,28,60.7,11,18,5,13,16,39,37,0,Bundesliga,2023_2024
Patrick Wimmer,AUT,"FW,MF",Wolfsburg,22,2001,6.5,14,5,5,5,4,8,18,44.4,10,14,0,14,3,17,7,0,Bundesliga,2023_2024
Jonas Wind,DEN,FW,Wolfsburg,24,1999,29.5,13,10,4,6,3,7,17,41.2,10,13,4,9,3,16,21,0,Bundesliga,2023_2024
Florian Wirtz,GER,MF,Leverkusen,20,2003,26.4,27,18,7,14,6,9,29,31.0,20,36,2,34,9,36,3,0,Bundesliga,2023_2024
Maximilian Wittek,GER,"DF,FW",Bochum,27,1995,11.9,23,17,9,11,3,13,21,61.9,8,12,1,11,18,41,23,0,Bundesliga,2023_2024
Maximilian Wöber,AUT,DF,Gladbach,25,1998,23.0,66,31,40,25,1,31,53,58.5,22,47,26,21,38,104,111,0,Bundesliga,2023_2024
Marius Wolf,GER,DF,Dortmund,28,1995,13.0,20,12,8,11,1,11,23,47.8,12,12,2,10,8,28,20,0,Bundesliga,2023_2024
Nick Woltemade,GER,"FW,MF",Werder Bremen,21,2002,13.2,34,23,7,20,7,15,21,71.4,6,12,0,12,5,39,17,0,Bundesliga,2023_2024
Jeong Woo-yeong,KOR,"MF,FW",Stuttgart,23,1999,7.0,15,9,6,8,1,6,8,75.0,2,5,0,5,7,22,5,0,Bundesliga,2023_2024
Granit Xhaka,SUI,MF,Leverkusen,30,1992,31.3,29,21,11,14,4,9,30,30.0,21,29,8,21,19,48,42,0,Bundesliga,2023_2024
Dan-Axel Zagadou,FRA,DF,Stuttgart,24,1999,16.1,21,14,16,5,0,4,8,50.0,4,23,18,5,20,41,78,1,Bundesliga,2023_2024
Bryan Zaragoza,ESP,"FW,MF",Bayern Munich,22,2001,2.0,4,4,2,1,1,3,3,100.0,0,0,0,0,2,6,0,0,Bundesliga,2023_2024
Robin Zentner,GER,GK,Mainz 05,28,1994,30.0,2,2,2,0,0,2,5,40.0,3,1,0,1,1,3,19,1,Bundesliga,2023_2024
Cedric Zesiger,SUI,DF,Wolfsburg,25,1998,18.2,19,9,13,4,2,10,22,45.5,12,32,21,11,15,34,88,1,Bundesliga,2023_2024
Michael Zetterer,GER,GK,Werder Bremen,28,1995,27.0,3,1,3,0,0,3,3,100.0,0,0,0,0,0,3,7,3,Bundesliga,2023_2024
Christoph Zimmermann,GER,DF,Darmstadt 98,30,1993,13.6,33,21,26,7,0,19,39,48.7,20,21,14,7,21,54,66,1,Bundesliga,2023_2024
Simon Zoller,GER,"FW,MF",Bochum,32,1991,0.5,0,0,0,0,0,0,0,,0,1,0,1,0,0,0,0,Bundesliga,2023_2024
Lovro Zvonarek,CRO,"FW,MF",Bayern Munich,18,2005,1.8,0,0,0,0,0,0,5,0.0,5,3,0,3,0,0,2,0,Bundesliga,2023_2024
Tammy Abraham,ENG,FW,Roma,25,1997,2.7,3,1,0,1,2,0,0,,0,1,0,1,0,3,4,0,Serie_A,2023_2024
Francesco Acerbi,ITA,DF,Inter,35,1988,26.5,22,13,16,6,0,11,14,78.6,3,20,13,7,32,54,77,1,Serie_A,2023_2024
Yacine Adli,FRA,MF,Milan,23,2000,15.6,34,17,17,13,4,13,35,37.1,22,22,8,14,20,54,15,1,Serie_A,2023_2024
Michel Aebischer,SUI,MF,Bologna,26,1997,24.8,35,20,9,20,6,15,34,44.1,19,28,6,22,12,47,22,0,Serie_A,2023_2024
Lucien Agoume,FRA,MF,Inter,21,2002,0.1,0,0,0,0,0,0,0,,0,0,0,0,0,0,0,0,Serie_A,2023_2024
Marley Aké,FRA,FW,Udinese,22,2001,0.1,0,0,0,0,0,0,0,,0,0,0,0,0,0,0,0,Serie_A,2023_2024
Ebenezer Akinsanmiro,NGA,MF,Inter,18,2004,0.2,0,0,0,0,0,0,1,0.0,1,0,0,0,0,0,0,0,Serie_A,2023_2024
Jean-Daniel Akpa-Akpro,CIV,MF,Monza,30,1992,7.8,20,11,14,4,2,3,9,33.3,6,10,4,6,12,32,15,1,Serie_A,2023_2024
David Akpan Ankeye,NGA,FW,Genoa,21,2002,0.6,1,0,0,1,0,0,1,0.0,1,1,0,1,0,1,0,0,Serie_A,2023_2024
Luis Alberto,ESP,MF,Lazio,30,1992,25.7,35,20,16,12,7,15,53,28.3,38,34,4,30,7,42,13,0,Serie_A,2023_2024
Carlos Alcaraz,ARG,MF,Juventus,20,2002,4.2,6,6,0,6,0,5,10,50.0,5,5,2,3,5,11,4,0,Serie_A,2023_2024
Pontus Almqvist,SWE,"FW,MF",Lecce,24,1999,23.4,45,29,16,22,7,23,51,45.1,28,21,2,19,14,59,10,0,Serie_A,2023_2024
Lorenzo Amatucci,ITA,MF,Fiorentina,19,2004,0.2,0,0,0,0,0,0,0,,0,0,0,0,0,0,0,0,Serie_A,2023_2024
Bruno Amione,ARG,DF,Hellas Verona,21,2002,6.4,11,3,9,2,0,4,5,80.0,1,4,2,2,9,20,19,2,Serie_A,2023_2024
Felipe Anderson,BRA,"FW,MF",Lazio,30,1993,30.8,78,45,32,33,13,34,90,37.8,56,45,3,42,27,105,23,0,Serie_A,2023_2024
Angeliño,ESP,DF,Roma,26,1997,12.7,21,11,12,6,3,11,19,57.9,8,11,5,6,12,33,37,1,Serie_A,2023_2024
Houssem Aouar,ALG,"MF,FW",Roma,25,1998,8.4,16,11,4,10,2,3,12,25.0,9,5,0,5,4,20,2,1,Serie_A,2023_2024
Simone Aresti,ITA,GK,Cagliari,37,1986,0.0,0,0,0,0,0,0,0,,0,0,0,0,0,0,0,0,Serie_A,2023_2024
Marko Arnautović,AUT,FW,Inter,34,1989,8.9,10,4,3,5,2,4,7,57.1,3,8,1,7,5,15,5,0,Serie_A,2023_2024
Kristjan Asllani,ALB,MF,Inter,21,2002,8.7,7,2,3,4,0,2,11,18.2,9,9,3,6,11,18,8,0,Serie_A,2023_2024
Emil Audero,ITA,GK,Inter,26,1997,3.7,0,0,0,0,0,0,0,,0,0,0,0,0,0,1,0,Serie_A,2023_2024
Tommaso Augello,ITA,DF,Cagliari,28,1994,26.9,26,19,18,6,2,16,25,64.0,9,21,10,11,17,43,89,0,Serie_A,2023_2024
Carlos Augusto,BRA,DF,Inter,24,1999,19.2,29,21,20,9,0,15,22,68.2,7,20,8,12,16,45,52,0,Serie_A,2023_2024
Yann Aurel Bisseck,GER,DF,Inter,22,2000,10.0,14,6,10,3,1,6,9,66.7,3,10,7,3,5,19,23,0,Serie_A,2023_2024
Sardar Azmoun,IRN,"FW,MF",Roma,28,1995,6.5,8,5,2,5,1,4,8,50.0,4,4,1,3,3,11,6,1,Serie_A,2023_2024
Paulo Azzi,BRA,"DF,MF",Cagliari,29,1994,10.6,19,11,10,6,3,9,18,50.0,9,11,2,9,16,35,23,0,Serie_A,2023_2024
Oussama El Azzouzi,MAR,MF,Bologna,22,2001,6.1,12,7,4,5,3,7,14,50.0,7,8,2,6,6,18,12,0,Serie_A,2023_2024
Milan Badelj,CRO,MF,Genoa,34,1989,28.2,51,27,23,24,4,24,61,39.3,37,45,13,32,50,101,54,1,Serie_A,2023_2024
Jaime Báez,URU,"FW,MF",Frosinone,28,1995,5.6,4,1,0,2,2,0,7,0.0,7,5,0,5,4,8,1,0,Serie_A,2023_2024
Nicola Bagnolini,ITA,GK,Bologna,19,2004,0.1,0,0,0,0,0,0,0,,0,0,0,0,0,0,0,0,Serie_A,2023_2024
Nedim Bajrami,ALB,"MF,FW",Sassuolo,24,1999,14.6,13,6,6,3,4,5,13,38.5,8,5,1,4,6,19,8,0,Serie_A,2023_2024
Mitchel Bakker,NED,DF,Atalanta,23,2000,4.2,7,3,6,1,0,2,12,16.7,10,5,0,5,3,10,6,0,Serie_A,2023_2024
Tommaso Baldanzi,ITA,"MF,FW",Empoli,20,2003,8.3,4,2,1,1,2,3,10,30.0,7,7,0,7,2,6,0,0,Serie_A,2023_2024
Tommaso Baldanzi,ITA,"FW,MF",Roma,20,2003,5.8,9,5,3,4,2,1,1,100.0,0,2,0,2,0,9,4,0,Serie_A,2023_2024
Lameck Banda,ZAM,FW,Lecce,22,2001,15.0,27,23,11,12,4,7,21,33.3,14,18,0,18,3,30,7,0,Serie_A,2023_2024
Daniel Bandeira,POR,MF,Hellas Verona,23,2000,5.0,6,5,1,4,1,3,7,42.9,4,3,0,3,3,9,9,0,Serie_A,2023_2024
Mattia Bani,ITA,DF,Genoa,29,1993,25.6,26,10,18,7,1,11,22,50.0,11,51,31,20,22,48,116,1,Serie_A,2023_2024
Antonín Barák,CZE,"MF,FW",Fiorentina,28,1994,9.0,6,2,1,3,2,3,7,42.9,4,5,0,5,2,8,4,0,Serie_A,2023_2024
Nicolò Barella,ITA,MF,Inter,26,1997,31.6,46,30,17,20,9,19,63,30.2,44,31,1,30,10,56,12,1,Serie_A,2023_2024
Enzo Barrenechea,ARG,MF,Frosinone,22,2001,31.2,65,42,28,29,8,28,70,40.0,42,47,12,35,27,92,61,2,Serie_A,2023_2024
Davide Bartesaghi,ITA,"DF,MF",Milan,17,2005,0.9,2,0,1,1,0,2,4,50.0,2,1,1,0,0,2,7,0,Serie_A,2023_2024
Federico Baschirotto,ITA,DF,Lecce,26,1996,36.6,21,12,16,5,0,8,15,53.3,7,42,26,16,23,44,144,1,Serie_A,2023_2024
Toma Bašić,CRO,MF,Salernitana,26,1996,12.9,20,13,10,9,1,10,27,37.0,17,18,6,12,14,34,29,0,Serie_A,2023_2024
Alessandro Bastoni,ITA,DF,Inter,24,1999,25.2,46,33,31,12,3,26,40,65.0,14,25,11,14,23,69,48,1,Serie_A,2023_2024
Simone Bastoni,ITA,"MF,DF",Empoli,26,1996,8.3,22,13,12,7,3,11,22,50.0,11,8,0,8,11,33,18,0,Serie_A,2023_2024
Reda Belahyane,FRA,MF,Hellas Verona,19,2004,1.0,1,1,0,1,0,1,1,100.0,0,0,0,0,1,2,0,0,Serie_A,2023_2024
Raoul Bellanova,ITA,DF,Torino,23,2000,33.8,36,26,15,17,4,18,31,58.1,13,21,4,17,15,51,36,3,Serie_A,2023_2024
Andrea Belotti,ITA,FW,Fiorentina,29,1993,10.5,8,3,1,5,2,5,12,41.7,7,8,1,7,2,10,3,0,Serie_A,2023_2024
Andrea Belotti,ITA,FW,Roma,29,1993,7.5,8,4,2,3,3,3,6,50.0,3,7,0,7,2,10,3,0,Serie_A,2023_2024
Lucas Beltrán,ARG,"FW,MF",Fiorentina,22,2001,18.8,27,14,4,18,5,11,20,55.0,9,29,3,26,2,29,11,0,Serie_A,2023_2024
Ismaël Bennacer,ALG,MF,Milan,25,1997,12.8,29,19,11,16,2,11,22,50.0,11,12,4,8,12,41,9,2,Serie_A,2023_2024
Domenico Berardi,ITA,FW,Sassuolo,28,1994,15.9,17,8,7,9,1,2,21,9.5,19,17,0,17,13,30,9,0,Serie_A,2023_2024
Bartosz Bereszyński,POL,DF,Empoli,31,1992,19.6,41,25,25,13,3,24,40,60.0,16,22,10,12,21,62,52,0,Serie_A,2023_2024
Etrit Berisha,ALB,GK,Empoli,34,1989,14.0,0,0,0,0,0,0,1,0.0,1,0,0,0,0,0,7,1,Serie_A,2023_2024
Medon Berisha,ALB,"FW,MF",Lecce,19,2003,2.3,3,1,3,0,0,0,2,0.0,2,2,2,0,1,4,0,0,Serie_A,2023_2024
Victor Bernth Kristiansen,DEN,DF,Bologna,20,2002,25.6,52,34,23,22,7,20,35,57.1,15,35,8,27,12,64,45,1,Serie_A,2023_2024
Beto,GNB,FW,Udinese,25,1998,0.8,1,0,0,0,1,0,0,,0,0,0,0,0,1,0,0,Serie_A,2023_2024
Davide Bettella,ITA,MF,Monza,23,2000,0.0,0,0,0,0,0,0,0,,0,0,0,0,0,0,0,0,Serie_A,2023_2024
Sam Beukema,NED,DF,Bologna,24,1998,28.3,27,11,14,11,2,16,25,64.0,9,35,21,14,15,42,99,2,Serie_A,2023_2024
Jaka Bijol,SVN,DF,Udinese,24,1999,23.2,43,27,34,9,0,22,35,62.9,13,36,21,15,23,66,140,1,Serie_A,2023_2024
El Bilal Touré,MLI,FW,Atalanta,21,2001,4.4,1,1,0,1,0,0,1,0.0,1,0,0,0,1,2,2,0,Serie_A,2023_2024
Cristiano Biraghi,ITA,DF,Fiorentina,30,1992,26.2,47,28,20,24,3,28,52,53.8,24,30,5,25,14,61,43,0,Serie_A,2023_2024
Davide Biraschi,ITA,DF,Genoa,29,1994,1.0,3,3,1,2,0,1,3,33.3,2,0,0,0,2,5,5,0,Serie_A,2023_2024
Samuele Birindelli,ITA,DF,Monza,24,1999,22.4,28,19,16,7,5,14,25,56.0,11,30,11,19,18,46,48,0,Serie_A,2023_2024
Alexis Blin,FRA,MF,Lecce,26,1996,18.2,33,19,11,19,3,15,43,34.9,28,16,2,14,22,55,39,0,Serie_A,2023_2024
Jérôme Boateng,GER,DF,Salernitana,34,1988,2.6,0,0,0,0,0,0,0,,0,6,5,1,4,4,21,0,Serie_A,2023_2024
Emil Bohinen,NOR,MF,Genoa,24,1999,0.6,1,1,0,1,0,0,0,,0,1,0,1,0,1,3,0,Serie_A,2023_2024
Emil Bohinen,NOR,MF,Salernitana,24,1999,5.9,8,6,5,3,0,2,10,20.0,8,8,2,6,14,22,6,1,Serie_A,2023_2024
Daniel Boloca,ROU,MF,Sassuolo,24,1998,22.5,48,33,18,25,5,27,46,58.7,19,23,13,10,14,62,33,2,Serie_A,2023_2024
Giacomo Bonaventura,ITA,MF,Fiorentina,33,1989,25.3,26,13,6,10,10,9,21,42.9,12,16,1,15,14,40,10,0,Serie_A,2023_2024
Federico Bonazzoli,ITA,"FW,MF",Hellas Verona,26,1997,11.3,4,1,1,3,0,1,8,12.5,7,9,1,8,3,7,3,0,Serie_A,2023_2024
Warren Bondo,FRA,MF,Monza,19,2003,16.4,29,22,16,10,3,13,17,76.5,4,13,3,10,6,35,13,0,Serie_A,2023_2024
Giovanni Bonfanti,ITA,DF,Atalanta,20,2003,1.0,4,2,2,2,0,2,3,66.7,1,1,1,0,1,5,1,0,Serie_A,2023_2024
Kevin Bonifazi,ITA,DF,Bologna,27,1996,1.0,4,0,0,4,0,1,2,50.0,1,0,0,0,0,4,7,1,Serie_A,2023_2024
Kevin Bonifazi,ITA,DF,Frosinone,27,1996,3.4,5,3,2,3,0,2,3,66.7,1,1,0,1,3,8,9,0,Serie_A,2023_2024
Gennaro Borrelli,ITA,FW,Frosinone,23,2000,0.3,0,0,0,0,0,0,0,,0,0,0,0,0,0,0,0,Serie_A,2023_2024
Erik Botheim,NOR,"FW,MF",Salernitana,23,2000,3.5,2,0,2,0,0,0,1,0.0,1,3,0,3,0,2,2,0,Serie_A,2023_2024
Mehdi Bourabia,MAR,MF,Frosinone,31,1991,2.2,5,4,1,4,0,2,4,50.0,2,3,0,3,0,5,4,0,Serie_A,2023_2024
Edoardo Bove,ITA,MF,Roma,21,2002,19.8,60,31,16,31,13,27,46,58.7,19,21,1,20,11,71,11,1,Serie_A,2023_2024
Domagoj Bradarić,CRO,DF,Salernitana,23,1999,30.5,29,20,13,10,6,15,25,60.0,10,22,7,15,32,61,62,1,Serie_A,2023_2024
Josip Brekalo,CRO,FW,Fiorentina,25,1998,7.2,8,6,6,2,0,2,11,18.2,9,7,0,7,1,9,0,0,Serie_A,2023_2024
Gleison Bremer,BRA,DF,Juventus,26,1997,35.9,58,42,32,21,5,21,29,72.4,8,45,27,18,40,98,147,0,Serie_A,2023_2024
Brenner,BRA,"MF,FW",Udinese,23,2000,2.1,8,7,1,5,2,4,7,57.1,3,2,0,2,0,8,2,0,Serie_A,2023_2024
Marco Brescianini,ITA,MF,Frosinone,23,2000,25.8,28,13,13,12,3,9,25,36.0,16,22,5,17,10,38,37,0,Serie_A,2023_2024
Dylan Bronn,TUN,"DF,MF",Salernitana,28,1995,0.6,0,0,0,0,0,0,1,0.0,1,2,0,2,0,0,4,0,Serie_A,2023_2024
Tajon Buchanan,CAN,DF,Inter,24,1999,1.8,1,1,0,0,1,1,2,50.0,1,1,0,1,0,1,4,0,Serie_A,2023_2024
Alessandro Buongiorno,ITA,DF,Torino,24,1999,28.1,70,39,43,24,3,24,34,70.6,10,20,12,8,69,139,131,0,Serie_A,2023_2024
Rareș-Cătălin Burnete,ROU,FW,Lecce,19,2004,0.1,0,0,0,0,0,0,0,,0,0,0,0,0,0,0,0,Serie_A,2023_2024
Jovane Cabral,CPV,"MF,FW",Salernitana,25,1998,7.5,13,9,4,7,2,3,9,33.3,6,3,0,3,1,14,4,0,Serie_A,2023_2024
Liberato Cacace,NZL,DF,Empoli,22,2000,21.2,40,24,24,13,3,24,38,63.2,14,23,6,17,19,59,56,0,Serie_A,2023_2024
Jens Cajuste,SWE,MF,Napoli,23,1999,11.3,36,24,13,17,6,20,37,54.1,17,20,3,17,4,40,15,0,Serie_A,2023_2024
Davide Calabria,ITA,DF,Milan,26,1996,24.3,70,38,38,25,7,44,72,61.1,28,26,7,19,24,94,49,1,Serie_A,2023_2024
Riccardo Calafiori,ITA,DF,Bologna,21,2002,26.1,47,32,28,16,3,22,32,68.8,10,38,13,25,50,97,74,3,Serie_A,2023_2024
Mattia Caldara,ITA,DF,Milan,29,1994,0.4,1,1,1,0,0,1,1,100.0,0,1,1,0,1,2,1,0,Serie_A,2023_2024
Luca Caldirola,ITA,DF,Monza,32,1991,23.8,25,14,19,4,2,13,22,59.1,9,26,17,9,29,54,53,0,Serie_A,2023_2024
Hakan Çalhanoğlu,TUR,MF,Inter,29,1994,28.4,66,33,29,29,8,32,49,65.3,17,29,13,16,24,90,22,0,Serie_A,2023_2024
Francesco Camarda,ITA,FW,Milan,15,2008,0.2,0,0,0,0,0,0,2,0.0,2,0,0,0,0,0,0,0,Serie_A,2023_2024
Nicolò Cambiaghi,ITA,"FW,MF",Empoli,22,2000,28.4,51,39,15,20,16,16,35,45.7,19,26,1,25,14,65,8,0,Serie_A,2023_2024
Andrea Cambiaso,ITA,"DF,FW",Juventus,23,2000,26.4,47,30,23,15,9,25,43,58.1,18,28,3,25,11,58,26,1,Serie_A,2023_2024
Matteo Cancellieri,ITA,"FW,MF",Empoli,21,2002,19.9,35,22,12,16,7,13,36,36.1,23,19,0,19,6,41,18,0,Serie_A,2023_2024
Antonio Candreva,ITA,"MF,FW",Salernitana,36,1987,30.6,18,13,8,8,2,9,25,36.0,16,9,0,9,7,25,23,0,Serie_A,2023_2024
Luigi Canotto,ITA,FW,Frosinone,29,1994,0.2,0,0,0,0,0,0,0,,0,0,0,0,0,0,0,0,Serie_A,2023_2024
Gianluca Caprari,ITA,"MF,FW",Monza,30,1993,3.2,2,1,1,1,0,0,1,0.0,1,0,0,0,2,4,0,0,Serie_A,2023_2024
Elia Caprile,ITA,GK,Empoli,21,2001,23.0,1,0,1,0,0,1,1,100.0,0,0,0,0,0,1,16,2,Serie_A,2023_2024
Francesco Caputo,ITA,FW,Empoli,35,1987,14.1,2,0,0,0,2,0,1,0.0,1,4,0,4,1,3,3,0,Serie_A,2023_2024
Andrea Carboni,ITA,DF,Monza,22,2001,16.5,38,22,24,12,2,20,31,64.5,11,23,13,10,17,55,56,1,Serie_A,2023_2024
Valentin Carboni,ARG,"MF,FW",Monza,18,2005,13.0,25,15,10,12,3,8,26,30.8,18,12,1,11,7,32,4,0,Serie_A,2023_2024
Marco Carnesecchi,ITA,GK,Atalanta,23,2000,26.9,0,0,0,0,0,0,0,,0,0,0,0,0,0,22,3,Serie_A,2023_2024
Nicolò Casale,ITA,DF,Lazio,25,1998,17.3,15,9,13,2,0,6,15,40.0,9,19,16,3,12,27,61,0,Serie_A,2023_2024
Giuseppe Caso,ITA,"FW,MF",Frosinone,24,1998,4.6,4,3,2,0,2,2,3,66.7,1,0,0,0,0,4,0,0,Serie_A,2023_2024
Valentín Castellanos,ARG,FW,Lazio,24,1998,18.7,22,10,1,12,9,6,20,30.0,14,22,2,20,2,24,18,0,Serie_A,2023_2024
Samu Castillejo,ESP,"FW,MF",Sassuolo,28,1995,6.0,12,10,5,5,2,7,19,36.8,12,16,1,15,1,13,3,0,Serie_A,2023_2024
Santiago Castro,ARG,FW,Bologna,18,2004,2.7,2,1,0,1,1,1,3,33.3,2,1,0,1,1,3,1,0,Serie_A,2023_2024
Gaetano Castrovilli,ITA,"FW,MF",Fiorentina,26,1997,4.1,3,2,1,2,0,1,8,12.5,7,4,0,4,2,5,3,0,Serie_A,2023_2024
Danilo Cataldi,ITA,MF,Lazio,28,1994,15.1,24,12,7,16,1,8,18,44.4,10,15,7,8,17,41,19,1,Serie_A,2023_2024
Emil Ceide,NOR,"FW,MF",Sassuolo,21,2001,2.0,2,2,1,1,0,1,1,100.0,0,6,1,5,0,2,0,0,Serie_A,2023_2024
Zeki Çelik,TUR,DF,Roma,26,1997,7.5,23,16,10,10,3,14,25,56.0,11,12,5,7,8,31,25,0,Serie_A,2023_2024
Fabien Centonze,FRA,DF,Hellas Verona,27,1996,7.5,14,8,10,4,0,5,10,50.0,5,14,2,12,10,24,18,0,Serie_A,2023_2024
Michele Cerofolini,ITA,GK,Frosinone,24,1999,7.5,0,0,0,0,0,0,0,,0,0,0,0,0,0,5,1,Serie_A,2023_2024
Alberto Cerri,ITA,FW,Empoli,27,1996,6.1,3,3,1,1,1,2,5,40.0,3,3,1,2,3,6,7,0,Serie_A,2023_2024
Leonardo Cerri,ITA,DF,Juventus,20,2003,0.1,0,0,0,0,0,0,0,,0,0,0,0,0,0,0,0,Serie_A,2023_2024
Charlys,BRA,MF,Hellas Verona,19,2004,0.3,0,0,0,0,0,0,0,,0,0,0,0,1,1,0,0,Serie_A,2023_2024
Walid Cheddira,MAR,FW,Frosinone,25,1998,23.6,12,7,1,8,3,4,8,50.0,4,6,1,5,5,17,10,0,Serie_A,2023_2024
Federico Chiesa,ITA,FW,Juventus,25,1997,24.4,20,10,7,6,7,3,13,23.1,10,17,1,16,6,26,4,0,Serie_A,2023_2024
Oliver Christensen,DEN,GK,Fiorentina,24,1999,4.0,0,0,0,0,0,0,0,,0,0,0,0,0,0,1,0,Serie_A,2023_2024
Samuel Chukwueze,NGA,FW,Milan,24,1999,11.3,18,7,11,5,2,9,17,52.9,8,3,1,2,6,24,3,0,Serie_A,2023_2024
Alphadjo Cissè,ITA,FW,Hellas Verona,16,2006,0.1,0,0,0,0,0,0,0,,0,0,0,0,0,0,0,0,Serie_A,2023_2024
Giorgio Cittadini,ITA,DF,Monza,21,2002,0.2,1,1,1,0,0,1,1,100.0,0,1,1,0,0,1,0,0,Serie_A,2023_2024
Giorgio Cittadini,ITA,DF,Genoa,21,2002,1.2,5,4,4,1,0,3,3,100.0,0,1,0,1,3,8,5,0,Serie_A,2023_2024
Patrick Ciurria,ITA,"DF,MF",Monza,28,1995,17.8,30,18,13,13,4,13,21,61.9,8,20,5,15,9,39,28,0,Serie_A,2023_2024
Lorenzo Colombo,ITA,FW,Monza,21,2002,15.1,17,12,3,9,5,8,14,57.1,6,18,5,13,0,17,14,0,Serie_A,2023_2024
Andrea Colpani,ITA,"MF,FW",Monza,24,1999,29.5,25,15,6,13,6,11,20,55.0,9,11,4,7,14,39,14,0,Serie_A,2023_2024
Pietro Comuzzo,ITA,"DF,FW",Fiorentina,18,2005,0.5,1,1,1,0,0,1,1,100.0,0,1,0,1,1,2,2,0,Serie_A,2023_2024
Andrea Consigli,ITA,GK,Sassuolo,36,1987,35.0,0,0,0,0,0,0,0,,0,1,0,1,1,1,19,1,Serie_A,2023_2024
Nikita Contini Baranovsky,ITA,GK,Napoli,27,1996,0.2,0,0,0,0,0,0,0,,0,0,0,0,0,0,1,0,Serie_A,2023_2024
Diego Coppola,ITA,DF,Hellas Verona,19,2003,18.2,36,22,25,9,2,20,33,60.6,13,26,9,17,27,63,89,1,Serie_A,2023_2024
Tommaso Corazza,ITA,DF,Bologna,19,2004,2.2,10,4,9,1,0,4,9,44.4,5,2,0,2,5,15,3,0,Serie_A,2023_2024
Jeppe Corfitzen,DEN,FW,Lecce,18,2004,0.1,1,0,0,1,0,1,1,100.0,0,0,0,0,0,1,0,0,Serie_A,2023_2024
Giacomo Corona,ITA,FW,Empoli,19,2004,0.1,0,0,0,0,0,0,0,,0,0,0,0,0,0,0,0,Serie_A,2023_2024
João Costa,BRA,"MF,FW",Roma,18,2005,0.2,0,0,0,0,0,0,0,,0,0,0,0,0,0,0,0,Serie_A,2023_2024
Benoît Costil,FRA,GK,Salernitana,36,1987,13.0,2,1,1,1,0,2,3,66.7,1,0,0,0,0,2,5,1,Serie_A,2023_2024
Lassana Coulibaly,MLI,MF,Salernitana,27,1996,23.1,47,32,20,21,6,22,49,44.9,27,23,5,18,16,63,29,0,Serie_A,2023_2024
Mamadou Coulibaly,SEN,DF,Salernitana,24,1999,0.0,0,0,0,0,0,0,0,,0,0,0,0,0,0,0,0,Serie_A,2023_2024
Alessio Cragno,ITA,GK,Sassuolo,29,1994,3.0,0,0,0,0,0,0,0,,0,0,0,0,0,0,3,1,Serie_A,2023_2024
Bryan Cristante,ITA,"MF,DF",Roma,28,1995,36.5,72,41,33,28,11,28,50,56.0,22,36,6,30,25,97,55,2,Serie_A,2023_2024
Juan Cruz,ARG,"FW,MF",Hellas Verona,24,1999,1.2,2,2,0,0,2,0,0,,0,1,0,1,1,3,0,0,Serie_A,2023_2024
Juan Cuadrado,COL,DF,Inter,35,1988,3.0,4,3,2,2,0,3,5,60.0,2,6,1,5,1,5,2,0,Serie_A,2023_2024
Marvin Cuni,ALB,FW,Frosinone,22,2001,5.9,8,3,1,3,4,3,4,75.0,1,10,1,9,1,9,0,0,Serie_A,2023_2024
Danilo D'Ambrosio,ITA,DF,Monza,34,1988,17.1,57,34,34,20,3,28,41,68.3,13,22,13,9,14,71,31,0,Serie_A,2023_2024
Flavius Daniliuc,AUT,DF,Salernitana,22,2001,8.3,19,11,12,5,2,9,19,47.4,10,13,4,9,8,27,15,0,Serie_A,2023_2024
Danilo,BRA,DF,Juventus,32,1991,27.2,60,36,38,18,4,32,48,66.7,16,34,15,19,37,97,94,0,Serie_A,2023_2024
Matteo Darmian,ITA,DF,Inter,33,1989,26.7,48,22,23,15,10,20,53,37.7,33,27,11,16,13,61,55,0,Serie_A,2023_2024
Juan David Cabal,COL,DF,Hellas Verona,22,2001,16.6,36,27,19,14,3,18,29,62.1,11,30,9,21,26,62,55,2,Serie_A,2023_2024
Keinan Davis,ENG,"FW,MF",Udinese,25,1998,2.1,0,0,0,0,0,0,0,,0,0,0,0,0,0,3,0,Serie_A,2023_2024
Paweł Dawidowicz,POL,DF,Hellas Verona,28,1995,23.8,53,30,33,18,2,17,29,58.6,12,17,9,8,24,77,114,1,Serie_A,2023_2024
Charles De Ketelaere,BEL,"FW,MF",Atalanta,22,2001,22.5,33,21,3,12,18,10,20,50.0,10,30,2,28,7,40,6,0,Serie_A,2023_2024
Mattia De Sciglio,ITA,DF,Juventus,30,1992,0.5,0,0,0,0,0,0,0,,0,1,0,1,1,1,2,0,Serie_A,2023_2024
Lorenzo De Silvestri,ITA,DF,Bologna,35,1988,7.5,10,8,5,2,3,4,7,57.1,3,9,4,5,6,16,27,0,Serie_A,2023_2024
Koni De Winter,BEL,DF,Genoa,21,2002,26.4,44,25,26,13,5,21,31,67.7,10,30,10,20,21,65,78,0,Serie_A,2023_2024
Grégoire Defrel,MTQ,"FW,MF",Sassuolo,32,1991,8.4,17,8,7,5,5,7,15,46.7,8,10,0,10,3,20,9,0,Serie_A,2023_2024
Alessandro Deiola,ITA,MF,Cagliari,27,1995,17.9,33,19,13,16,4,18,47,38.3,29,16,6,10,9,42,37,0,Serie_A,2023_2024
Alessandro Dellavalle,ITA,DF,Torino,19,2004,0.2,0,0,0,0,0,0,0,,0,1,1,0,1,1,0,0,Serie_A,2023_2024
Diego Demme,GER,MF,Napoli,31,1991,0.8,1,1,0,1,0,0,1,0.0,1,0,0,0,0,1,0,0,Serie_A,2023_2024
Leander Dendoncker,BEL,MF,Napoli,28,1995,0.3,0,0,0,0,0,0,0,,0,1,1,0,0,0,0,0,Serie_A,2023_2024
Mattia Destro,ITA,"FW,MF",Empoli,32,1991,4.1,2,1,0,2,0,1,1,100.0,0,4,0,4,2,4,3,0,Serie_A,2023_2024
Federico Di Francesco,ITA,"FW,MF",Lecce,29,1994,0.2,1,0,0,1,0,0,0,,0,0,0,0,0,1,0,0,Serie_A,2023_2024
Raffaele Di Gennaro,ITA,GK,Inter,29,1993,0.3,0,0,0,0,0,0,0,,0,0,0,0,0,0,0,0,Serie_A,2023_2024
Michele Di Gregorio,ITA,GK,Monza,26,1997,31.9,1,0,1,0,0,1,4,25.0,3,1,0,1,1,2,10,2,Serie_A,2023_2024
Giovanni Di Lorenzo,ITA,DF,Napoli,29,1993,35.9,58,36,26,26,6,32,68,47.1,36,43,16,27,24,82,45,0,Serie_A,2023_2024
Alessandro Di Pardo,ITA,"DF,MF",Cagliari,24,1999,4.0,4,1,3,0,1,0,3,0.0,3,9,2,7,5,9,7,0,Serie_A,2023_2024
Boulaye Dia,SEN,"FW,MF",Salernitana,26,1996,12.7,4,2,2,2,0,1,3,33.3,2,5,0,5,3,7,7,0,Serie_A,2023_2024
Federico Dimarco,ITA,DF,Inter,25,1997,23.1,42,25,19,14,9,17,35,48.6,18,18,3,15,9,51,34,1,Serie_A,2023_2024
Tiago Djaló,POR,DF,Juventus,23,2000,0.2,0,0,0,0,0,0,0,,0,1,0,1,0,0,1,0,Serie_A,2023_2024
Koffi Djidji,CIV,DF,Torino,30,1992,8.4,14,9,9,5,0,3,4,75.0,1,10,5,5,10,24,20,0,Serie_A,2023_2024
Berat Djimsiti,ALB,DF,Atalanta,30,1993,31.5,42,24,29,12,1,19,31,61.3,12,53,33,20,57,99,100,0,Serie_A,2023_2024
Dodô,BRA,DF,Fiorentina,24,1998,5.8,5,3,1,4,0,2,5,40.0,3,2,0,2,5,10,11,0,Serie_A,2023_2024
Josh Doig,SCO,DF,Hellas Verona,21,2002,9.2,16,9,9,7,0,13,17,76.5,4,12,3,9,4,20,17,1,Serie_A,2023_2024
Josh Doig,SCO,DF,Sassuolo,21,2002,14.9,25,17,16,9,0,15,27,55.6,12,31,10,21,16,41,38,0,Serie_A,2023_2024
Nicolás Domínguez,ARG,MF,Bologna,25,1998,1.1,1,0,1,0,0,0,2,0.0,2,3,0,3,0,1,2,0,Serie_A,2023_2024
Giulio Donati,ITA,DF,Monza,33,1990,0.4,0,0,0,0,0,0,0,,0,0,0,0,0,0,1,1,Serie_A,2023_2024
Patrick Dorgu,DEN,"DF,MF",Lecce,18,2004,17.4,43,22,22,17,4,22,34,64.7,12,16,5,11,9,52,45,2,Serie_A,2023_2024
Alberto Dossena,ITA,DF,Cagliari,24,1998,33.1,55,35,43,12,0,32,48,66.7,16,50,27,23,45,100,172,2,Serie_A,2023_2024
Radu Drăgușin,ROU,DF,Genoa,21,2002,19.0,16,11,9,6,1,8,9,88.9,1,18,12,6,21,37,87,3,Serie_A,2023_2024
Ondrej Duda,SVK,MF,Hellas Verona,28,1994,27.3,59,39,17,35,7,31,52,59.6,21,29,12,17,26,85,21,0,Serie_A,2023_2024
Denzel Dumfries,NED,DF,Inter,27,1996,18.2,22,13,9,11,2,9,23,39.1,14,15,6,9,12,34,33,1,Serie_A,2023_2024
Alfred Duncan,GHA,MF,Fiorentina,30,1993,21.0,35,22,13,15,7,15,35,42.9,20,27,5,22,11,46,13,0,Serie_A,2023_2024
Paulo Dybala,ARG,"FW,MF",Roma,29,1993,21.8,22,13,3,10,9,2,18,11.1,16,12,0,12,3,25,6,1,Serie_A,2023_2024
Festy Ebosele,IRL,DF,Udinese,20,2002,18.9,33,20,23,9,1,21,35,60.0,14,33,2,31,10,43,27,0,Serie_A,2023_2024
Enzo Ebosse,CMR,DF,Udinese,24,1999,0.1,1,1,1,0,0,0,1,0.0,1,0,0,0,1,2,0,0,Serie_A,2023_2024
Tyronne Ebuehi,NGA,DF,Empoli,27,1995,12.2,14,9,9,5,0,7,11,63.6,4,9,4,5,6,20,27,1,Serie_A,2023_2024
Éderson,BRA,MF,Atalanta,24,1999,31.9,83,49,38,38,7,44,63,69.8,19,48,8,40,41,124,33,1,Serie_A,2023_2024
Kingsley Ehizibue,NED,DF,Udinese,28,1995,10.6,22,14,16,4,2,11,18,61.1,7,21,3,18,8,30,36,0,Serie_A,2023_2024
Emmanuel Ekong,SWE,FW,Empoli,21,2002,0.1,0,0,0,0,0,0,0,,0,0,0,0,0,0,0,0,Serie_A,2023_2024
Caleb Ekuban,GHA,FW,Genoa,29,1994,12.6,8,4,2,4,2,5,9,55.6,4,11,3,8,1,9,7,0,Serie_A,2023_2024
Elif Elmas,MKD,"FW,MF",Napoli,23,1999,3.8,4,3,1,3,0,2,2,100.0,0,2,0,2,2,6,8,0,Serie_A,2023_2024
Martin Erlic,CRO,DF,Sassuolo,25,1998,29.1,37,22,26,8,3,20,30,66.7,10,31,16,15,28,65,128,1,Serie_A,2023_2024
Giovanni Fabbian,ITA,"MF,FW",Bologna,20,2003,11.7,17,10,9,7,1,7,12,58.3,5,5,2,3,7,24,11,0,Serie_A,2023_2024
Nicolò Fagioli,ITA,MF,Juventus,22,2001,4.9,5,3,1,3,1,3,7,42.9,4,3,0,3,4,9,1,0,Serie_A,2023_2024
Wladimiro Falcone,ITA,GK,Lecce,28,1995,38.0,0,0,0,0,0,0,0,,0,1,0,1,1,1,21,2,Serie_A,2023_2024
Davide Faraoni,ITA,DF,Hellas Verona,31,1991,6.7,13,10,5,6,2,7,10,70.0,3,9,5,4,6,19,21,0,Serie_A,2023_2024
Davide Faraoni,ITA,DF,Fiorentina,31,1991,4.4,9,4,5,2,2,5,11,45.5,6,3,1,2,5,14,14,0,Serie_A,2023_2024
Federico Fazio,ARG,DF,Salernitana,36,1987,15.1,18,11,14,4,0,8,14,57.1,6,22,19,3,17,35,99,1,Serie_A,2023_2024
Jacopo Fazzini,ITA,MF,Empoli,20,2003,13.7,49,25,27,13,9,30,53,56.6,23,21,3,18,12,61,18,0,Serie_A,2023_2024
Lewis Ferguson,SCO,MF,Bologna,23,1999,30.1,37,21,16,17,4,16,37,43.2,21,25,8,17,17,54,27,1,Serie_A,2023_2024
Andrea Ferraris,ITA,MF,Monza,20,2003,0.1,1,1,1,0,0,0,0,,0,0,0,0,0,1,0,0,Serie_A,2023_2024
João Ferreira,POR,DF,Udinese,22,2001,20.2,58,42,36,18,4,34,58,58.6,24,27,6,21,29,87,89,0,Serie_A,2023_2024
Seydou Fini,ITA,"DF,FW",Genoa,17,2006,0.4,0,0,0,0,0,0,0,,0,0,0,0,0,0,0,0,Serie_A,2023_2024
Vincenzo Fiorillo,ITA,GK,Salernitana,33,1990,4.0,0,0,0,0,0,0,0,,0,0,0,0,0,0,0,1,Serie_A,2023_2024
Alessandro Florenzi,ITA,DF,Milan,32,1991,19.2,43,21,26,12,5,26,48,54.2,22,16,9,7,20,63,25,1,Serie_A,2023_2024
Michael Folorunsho,ITA,"MF,FW",Hellas Verona,25,1998,30.9,50,28,21,22,7,23,57,40.4,34,45,12,33,17,67,44,2,Serie_A,2023_2024
Davide Frattesi,ITA,MF,Inter,23,1999,10.6,10,6,3,7,0,4,8,50.0,4,9,3,6,5,15,19,0,Serie_A,2023_2024
Morten Frendrup,DEN,MF,Genoa,22,2001,34.9,133,72,47,70,16,55,91,60.4,36,55,14,41,51,184,42,1,Serie_A,2023_2024
Remo Freuler,SUI,MF,Bologna,31,1992,29.2,78,50,41,32,5,38,69,55.1,31,37,9,28,36,114,53,2,Serie_A,2023_2024
Gerardo Fusco,ITA,FW,Salernitana,18,2005,0.2,0,0,0,0,0,0,0,,0,0,0,0,0,0,0,0,Serie_A,2023_2024
Matteo Gabbia,ITA,DF,Milan,23,1999,14.2,29,20,15,13,1,18,24,75.0,6,11,6,5,10,39,48,0,Serie_A,2023_2024
Gianluca Gaetano,ITA,"FW,MF",Cagliari,23,2000,8.3,7,4,0,4,3,2,7,28.6,5,4,0,4,3,10,4,0,Serie_A,2023_2024
Gianluca Gaetano,ITA,MF,Napoli,23,2000,1.8,4,1,0,4,0,2,4,50.0,2,5,2,3,1,5,4,0,Serie_A,2023_2024
Roberto Gagliardini,ITA,"MF,DF",Monza,29,1994,26.2,61,30,27,25,9,31,50,62.0,19,30,11,19,31,92,38,0,Serie_A,2023_2024
Pablo Galdames Millán,CHI,"MF,DF",Genoa,26,1996,0.1,0,0,0,0,0,0,0,,0,1,0,1,0,0,0,0,Serie_A,2023_2024
Antonino Gallo,ITA,DF,Lecce,23,2000,27.7,43,27,31,11,1,31,49,63.3,18,34,9,25,25,68,67,0,Serie_A,2023_2024
Luca Garritano,ITA,"MF,DF",Frosinone,29,1994,5.4,10,5,7,2,1,5,15,33.3,10,13,0,13,4,14,8,1,Serie_A,2023_2024
Federico Gatti,ITA,DF,Juventus,25,1998,29.3,33,19,16,16,1,19,24,79.2,5,26,15,11,19,52,90,1,Serie_A,2023_2024
Francesco Gelli,ITA,"MF,DF",Frosinone,26,1996,17.3,19,13,8,4,7,10,24,41.7,14,19,3,16,11,30,27,1,Serie_A,2023_2024
Luca Gemello,ITA,GK,Torino,23,2000,2.0,0,0,0,0,0,0,1,0.0,1,0,0,0,0,0,1,1,Serie_A,2023_2024
Valentin Gendrey,FRA,DF,Lecce,23,2000,33.8,55,33,35,16,4,30,46,65.2,16,40,11,29,35,90,99,0,Serie_A,2023_2024
Farés Ghedjemis,FRA,"FW,MF",Frosinone,20,2002,2.0,2,0,1,0,1,0,2,0.0,2,2,0,2,1,3,2,0,Serie_A,2023_2024
Lautaro Gianetti,ARG,DF,Udinese,29,1993,7.0,9,4,7,2,0,4,5,80.0,1,10,6,4,19,28,39,0,Serie_A,2023_2024
Mario Gila,ESP,DF,Lazio,22,2000,20.1,32,14,23,8,1,19,34,55.9,15,27,14,13,20,52,69,0,Serie_A,2023_2024
Gvidas Gineitis,LTU,MF,Torino,19,2004,6.0,11,7,3,8,0,4,7,57.1,3,10,4,6,4,15,9,1,Serie_A,2023_2024
Olivier Giroud,FRA,FW,Milan,36,1986,26.3,17,11,6,6,5,2,14,14.3,12,14,3,11,6,23,22,0,Serie_A,2023_2024
Edoardo Goldaniga,ITA,DF,Cagliari,29,1993,11.2,12,7,9,3,0,4,10,40.0,6,11,7,4,15,27,37,1,Serie_A,2023_2024
Pierluigi Gollini,ITA,GK,Napoli,28,1995,7.0,1,1,1,0,0,1,1,100.0,0,0,0,0,1,2,2,0,Serie_A,2023_2024
Papu Gómez,ARG,"MF,FW",Monza,35,1988,0.5,0,0,0,0,0,0,2,0.0,2,0,0,0,1,1,0,0,Serie_A,2023_2024
Iron Gomis,FRA,MF,Salernitana,23,1999,1.5,4,1,2,2,0,0,1,0.0,1,2,0,2,2,6,2,0,Serie_A,2023_2024
Joan Gonzàlez,ESP,MF,Lecce,21,2002,14.3,31,18,16,12,3,17,28,60.7,11,20,3,17,5,36,9,0,Serie_A,2023_2024
Nicolás González,ARG,FW,Fiorentina,25,1998,21.3,28,18,15,8,5,8,28,28.6,20,26,1,25,12,40,9,0,Serie_A,2023_2024
Alberto Grassi,ITA,MF,Empoli,28,1995,20.1,30,18,13,13,4,10,26,38.5,16,26,11,15,41,71,37,0,Serie_A,2023_2024
Mattéo Guendouzi,FRA,MF,Lazio,24,1999,26.3,34,15,11,18,5,21,49,42.9,28,24,6,18,21,55,24,1,Serie_A,2023_2024
Axel Guessand,FRA,DF,Udinese,18,2004,0.5,1,1,0,1,0,1,1,100.0,0,1,0,1,0,1,0,0,Serie_A,2023_2024
Albert Guðmundsson,ISL,"FW,MF",Genoa,26,1997,33.5,23,10,8,10,5,12,44,27.3,32,15,2,13,11,34,13,0,Serie_A,2023_2024
Emmanuel Gyasi,GHA,"DF,FW",Empoli,29,1994,20.9,34,17,18,13,3,15,32,46.9,17,30,12,18,5,39,27,1,Serie_A,2023_2024
Norbert Gyömbér,SVK,DF,Salernitana,31,1992,19.6,36,18,30,6,0,20,26,76.9,6,33,23,10,23,59,77,2,Serie_A,2023_2024
Nicolas Haas,SUI,MF,Empoli,27,1996,1.0,5,3,1,2,2,3,3,100.0,0,1,0,1,1,6,1,0,Serie_A,2023_2024
Ridgeciano Haps,SUR,DF,Genoa,30,1993,8.6,7,6,3,2,2,5,8,62.5,3,3,0,3,6,13,11,1,Serie_A,2023_2024
Abdou Harroui,NED,"MF,FW",Frosinone,25,1998,11.3,23,11,11,11,1,8,16,50.0,8,19,3,16,5,28,8,0,Serie_A,2023_2024
Hans Hateboer,NED,DF,Atalanta,29,1994,12.4,12,5,8,2,2,5,15,33.3,10,21,7,14,4,16,21,0,Serie_A,2023_2024
Pantelis Hatzidiakos,GRE,DF,Cagliari,26,1997,9.5,22,10,12,10,0,10,17,58.8,7,14,5,9,13,35,30,1,Serie_A,2023_2024
Silvan Hefti,SUI,"MF,DF",Genoa,25,1997,1.3,6,1,2,3,1,4,7,57.1,3,2,0,2,0,6,1,0,Serie_A,2023_2024
Liam Henderson,SCO,MF,Empoli,27,1996,0.1,0,0,0,0,0,0,0,,0,0,0,0,0,0,0,0,Serie_A,2023_2024
Matheus Henrique,BRA,MF,Sassuolo,25,1997,27.8,43,29,21,18,4,18,43,41.9,25,18,8,10,25,68,31,6,Serie_A,2023_2024
Thomas Henry,FRA,FW,Hellas Verona,28,1994,3.7,0,0,0,0,0,0,0,,0,0,0,0,0,0,5,0,Serie_A,2023_2024
Theo Hernández,FRA,DF,Milan,25,1997,31.0,30,17,19,11,0,11,22,50.0,11,33,13,20,23,53,42,1,Serie_A,2023_2024
Isak Hien,SWE,DF,Hellas Verona,24,1999,9.6,17,10,10,7,0,10,19,52.6,9,12,5,7,7,24,33,1,Serie_A,2023_2024
Isak Hien,SWE,DF,Atalanta,24,1999,10.4,18,12,8,10,0,7,15,46.7,8,12,5,7,14,32,33,0,Serie_A,2023_2024
Emil Holm,SWE,DF,Atalanta,23,2000,10.5,28,19,17,9,2,16,36,44.4,20,25,3,22,7,35,25,0,Serie_A,2023_2024
Martin Hongla,CMR,MF,Hellas Verona,25,1998,12.0,24,13,9,13,2,8,11,72.7,3,8,3,5,7,31,24,0,Serie_A,2023_2024
Sydney van Hooijdonk,NED,FW,Bologna,23,2000,2.4,3,0,0,2,1,1,2,50.0,1,1,1,0,1,4,4,0,Serie_A,2023_2024
Dean Huijsen,ESP,DF,Roma,18,2005,5.7,10,5,5,5,0,1,4,25.0,3,7,4,3,4,14,26,2,Serie_A,2023_2024
Dean Huijsen,ESP,DF,Juventus,18,2005,0.1,0,0,0,0,0,0,0,,0,0,0,0,0,0,1,0,Serie_A,2023_2024
Elseid Hysaj,ALB,DF,Lazio,29,1994,13.3,24,14,8,13,3,15,24,62.5,9,16,6,10,17,41,31,0,Serie_A,2023_2024
Arijon Ibrahimović,GER,"FW,DF",Frosinone,17,2005,5.3,7,6,4,2,1,1,9,11.1,8,4,0,4,1,8,3,0,Serie_A,2023_2024
Jonathan Ikone,FRA,FW,Fiorentina,25,1998,18.7,22,11,7,9,6,10,17,58.8,7,12,0,12,3,25,8,0,Serie_A,2023_2024
Chukwubuikem Ikwuemesi,NGA,FW,Salernitana,21,2001,11.8,3,1,0,2,1,2,6,33.3,4,1,1,0,1,4,8,0,Serie_A,2023_2024
Ivan Ilić,SRB,MF,Torino,22,2001,23.3,22,8,9,10,3,13,27,48.1,14,20,7,13,20,42,31,0,Serie_A,2023_2024
Samuel Iling-Junior,ENG,"DF,MF",Juventus,19,2003,9.0,23,13,9,11,3,11,18,61.1,7,17,5,12,6,29,19,0,Serie_A,2023_2024
Ciro Immobile,ITA,FW,Lazio,33,1990,18.4,11,9,2,5,4,3,14,21.4,11,9,3,6,5,16,11,0,Serie_A,2023_2024
Gino Infantino,ARG,MF,Fiorentina,20,2003,1.1,1,1,0,1,0,0,1,0.0,1,4,0,4,3,4,1,0,Serie_A,2023_2024
Gustav Isaksen,DEN,FW,Lazio,22,2001,11.9,4,3,2,1,1,1,9,11.1,8,11,1,10,4,8,4,0,Serie_A,2023_2024
Ardian Ismajli,ALB,DF,Empoli,26,1996,22.7,26,16,18,6,2,18,23,78.3,5,28,17,11,23,49,126,1,Serie_A,2023_2024
Armando Izzo,ITA,DF,Monza,31,1992,18.3,27,17,17,9,1,16,27,59.3,11,20,16,4,27,54,49,1,Serie_A,2023_2024
Filip Jagiełło,POL,MF,Genoa,25,1997,0.4,0,0,0,0,0,0,1,0.0,1,1,1,0,1,1,0,0,Serie_A,2023_2024
Jakub Jankto,CZE,"MF,FW",Cagliari,27,1996,9.7,12,9,9,1,2,8,20,40.0,12,5,1,4,5,17,20,0,Serie_A,2023_2024
Juan Jesus,BRA,DF,Napoli,32,1991,23.5,42,19,28,12,2,23,33,69.7,10,23,12,11,23,65,67,1,Serie_A,2023_2024
Alejandro Jiménez,ESP,DF,Milan,18,2005,0.8,2,1,2,0,0,2,5,40.0,3,0,0,0,0,2,4,0,Serie_A,2023_2024
Kaio Jorge,BRA,FW,Frosinone,21,2002,9.0,6,4,0,1,5,3,4,75.0,1,6,0,6,1,7,0,0,Serie_A,2023_2024
Luka Jović,SRB,FW,Milan,25,1997,9.7,6,4,0,3,3,4,6,66.7,2,3,0,3,1,7,9,0,Serie_A,2023_2024
Hamed Junior Traorè,CIV,MF,Napoli,23,2000,4.2,4,2,2,0,2,1,6,16.7,5,3,0,3,2,6,1,1,Serie_A,2023_2024
Mohamed Kaba,FRA,MF,Lecce,21,2001,15.3,39,23,15,16,8,17,34,50.0,17,22,4,18,12,51,13,0,Serie_A,2023_2024
Christian Kabasele,BEL,DF,Udinese,32,1991,9.6,10,7,4,5,1,2,11,18.2,9,15,9,6,12,22,56,0,Serie_A,2023_2024
Yayah Kallon,SLE,FW,Hellas Verona,22,2001,0.0,0,0,0,0,0,0,0,,0,0,0,0,0,0,0,0,Serie_A,2023_2024
Pierre Kalulu,FRA,DF,Milan,23,2000,4.2,5,1,2,3,0,1,2,50.0,1,4,3,1,1,6,12,1,Serie_A,2023_2024
Daichi Kamada,JPN,MF,Lazio,26,1996,17.2,53,36,22,22,9,28,52,53.8,24,24,5,19,18,71,7,0,Serie_A,2023_2024
Hassane Kamara,CIV,DF,Udinese,29,1994,24.7,45,32,26,13,6,25,38,65.8,13,29,2,27,26,71,66,0,Serie_A,2023_2024
Yann Karamoh,FRA,"MF,FW",Torino,25,1998,1.8,1,0,0,0,1,0,0,,0,0,0,0,0,1,1,0,Serie_A,2023_2024
Jesper Karlsson,SWE,FW,Bologna,25,1998,3.8,3,3,2,1,0,2,8,25.0,6,4,0,4,4,7,1,0,Serie_A,2023_2024
Rick Karsdorp,NED,DF,Roma,28,1995,13.2,25,18,11,8,6,16,24,66.7,8,13,4,9,9,34,16,0,Serie_A,2023_2024
Grigoris Kastanos,CYP,"MF,DF",Salernitana,25,1998,16.4,23,14,8,9,6,9,20,45.0,11,13,4,9,8,31,9,0,Serie_A,2023_2024
Michael Kayode,ITA,DF,Fiorentina,19,2004,22.9,53,30,27,15,11,35,48,72.9,13,25,12,13,18,71,46,2,Serie_A,2023_2024
Moise Kean,ITA,FW,Juventus,23,2000,7.3,7,4,3,2,2,1,3,33.3,2,4,1,3,2,9,5,0,Serie_A,2023_2024
Simon Kjær,DEN,DF,Milan,34,1989,13.0,24,15,11,11,2,14,22,63.6,8,22,16,6,14,38,46,2,Serie_A,2023_2024
Davy Klaassen,NED,MF,Inter,30,1993,2.3,4,2,0,4,0,1,3,33.3,2,5,1,4,3,7,4,0,Serie_A,2023_2024
Sead Kolašinac,BIH,DF,Atalanta,30,1993,24.2,44,32,23,19,2,30,49,61.2,19,22,9,13,21,65,47,0,Serie_A,2023_2024
Teun Koopmeiners,NED,MF,Atalanta,25,1998,29.2,39,24,12,22,5,17,50,34.0,33,33,3,30,10,49,35,0,Serie_A,2023_2024
Filip Kostić,SRB,DF,Juventus,30,1992,20.2,37,23,20,13,4,17,33,51.5,16,29,8,21,9,46,43,0,Serie_A,2023_2024
Christian Kouamé,CIV,FW,Fiorentina,25,1997,12.1,13,4,7,6,0,6,10,60.0,4,16,0,16,2,15,10,0,Serie_A,2023_2024
Viktor Kovalenko,UKR,MF,Empoli,27,1996,6.8,5,2,2,2,1,2,8,25.0,6,12,2,10,1,6,7,0,Serie_A,2023_2024
Rasmus Kristensen,DEN,DF,Roma,26,1997,19.4,36,19,25,8,3,28,50,56.0,22,27,7,20,8,44,50,0,Serie_A,2023_2024
Thomas Kristensen,DEN,DF,Udinese,21,2002,23.3,35,24,25,10,0,21,33,63.6,12,29,20,9,29,64,118,0,Serie_A,2023_2024
Nikola Krstović,MNE,FW,Lecce,23,2000,26.4,17,6,3,9,5,6,10,60.0,4,12,4,8,4,21,22,0,Serie_A,2023_2024
Rade Krunić,BIH,MF,Milan,29,1993,7.6,10,8,3,6,1,4,9,44.4,5,7,3,4,11,21,14,0,Serie_A,2023_2024
Marash Kumbulla,ALB,DF,Sassuolo,23,2000,4.0,3,2,2,1,0,1,2,50.0,1,8,6,2,0,3,22,0,Serie_A,2023_2024
Justin Kumi,ITA,FW,Sassuolo,19,2004,0.0,0,0,0,0,0,0,0,,0,0,0,0,0,0,0,0,Serie_A,2023_2024
Berkan Kutlu,TUR,MF,Genoa,25,1998,2.2,6,4,5,1,0,3,6,50.0,3,3,0,3,4,10,5,0,Serie_A,2023_2024
Khvicha Kvaratskhelia,GEO,FW,Napoli,22,2001,30.4,42,21,11,19,12,15,49,30.6,34,15,1,14,13,55,9,0,Serie_A,2023_2024
Giorgi Kvernadze,GEO,"FW,DF",Frosinone,20,2003,0.7,3,0,2,0,1,2,2,100.0,0,1,0,1,1,4,0,0,Serie_A,2023_2024
Giorgos Kyriakopoulos,GRE,DF,Monza,27,1996,19.0,19,10,16,3,0,11,24,45.8,13,18,1,17,13,32,28,0,Serie_A,2023_2024
Gianluca Lapadula,PER,FW,Cagliari,33,1990,13.4,1,1,0,0,1,1,10,10.0,9,2,1,1,2,3,5,0,Serie_A,2023_2024
Armand Lauriente,FRA,FW,Sassuolo,24,1998,32.3,31,20,8,14,9,13,44,29.5,31,29,4,25,15,46,11,0,Serie_A,2023_2024
Valentino Lazaro,AUT,"DF,MF",Torino,27,1996,22.2,18,11,7,9,2,13,19,68.4,6,14,1,13,8,26,29,0,Serie_A,2023_2024
Darko Lazović,SRB,"FW,MF",Hellas Verona,32,1990,21.4,26,16,11,6,9,16,31,51.6,15,10,1,9,6,32,14,0,Serie_A,2023_2024
Manuel Lazzari,ITA,DF,Lazio,29,1993,18.6,26,18,13,10,3,18,28,64.3,10,20,4,16,12,38,37,1,Serie_A,2023_2024
Nicola Leali,ITA,GK,Genoa,30,1993,2.0,0,0,0,0,0,0,0,,0,0,0,0,0,0,0,0,Serie_A,2023_2024
Rafael Leão,POR,FW,Milan,24,1999,27.9,16,10,3,8,5,8,13,61.5,5,15,1,14,9,25,19,0,Serie_A,2023_2024
Jesper Lindstrøm,DEN,"FW,MF",Napoli,23,2000,4.8,8,3,2,3,3,4,8,50.0,4,3,0,3,2,10,6,0,Serie_A,2023_2024
Karol Linetty,POL,MF,Torino,28,1995,20.6,30,21,9,20,1,9,29,31.0,20,24,8,16,23,53,27,1,Serie_A,2023_2024
Luca Lipani,ITA,MF,Sassuolo,18,2005,4.3,9,7,4,3,2,3,11,27.3,8,9,2,7,6,15,7,0,Serie_A,2023_2024
Pol Lirola,ESP,DF,Frosinone,25,1997,17.1,30,18,14,15,1,17,35,48.6,18,12,1,11,19,49,41,1,Serie_A,2023_2024
Marcin Listkowski,POL,FW,Lecce,25,1998,0.1,0,0,0,0,0,0,0,,0,0,0,0,0,0,0,0,Serie_A,2023_2024
Diego Llorente,ESP,DF,Roma,29,1993,24.1,31,19,20,10,1,11,24,45.8,13,40,27,13,22,53,79,0,Serie_A,2023_2024
Stanislav Lobotka,SVK,MF,Napoli,28,1994,36.5,61,39,18,30,13,24,60,40.0,36,30,8,22,30,91,29,0,Serie_A,2023_2024
Manuel Locatelli,ITA,MF,Juventus,25,1998,33.4,69,43,24,35,10,31,58,53.4,27,43,17,26,25,94,65,0,Serie_A,2023_2024
Ruben Loftus-Cheek,ENG,MF,Milan,27,1996,23.0,28,18,7,14,7,15,27,55.6,12,24,12,12,9,37,10,1,Serie_A,2023_2024
Ademola Lookman,NGA,"FW,MF",Atalanta,25,1997,21.0,20,15,2,11,7,8,22,36.4,14,19,0,19,9,29,0,1,Serie_A,2023_2024
Maxime Lopez,FRA,MF,Fiorentina,25,1997,8.9,18,9,5,10,3,6,12,50.0,6,3,1,2,7,25,6,0,Serie_A,2023_2024
Maxime Lopez,FRA,MF,Sassuolo,25,1997,1.6,2,1,1,1,0,1,2,50.0,1,1,1,0,2,4,0,0,Serie_A,2023_2024
Matteo Lovato,ITA,DF,Torino,23,2000,6.0,10,7,5,5,0,4,5,80.0,1,9,5,4,13,23,10,0,Serie_A,2023_2024
Matteo Lovato,ITA,DF,Salernitana,23,2000,10.5,27,14,17,8,2,16,24,66.7,8,14,7,7,18,45,41,1,Serie_A,2023_2024
Sandi Lovrić,SVN,MF,Udinese,25,1998,22.1,25,12,9,11,5,9,23,39.1,14,21,2,19,21,46,24,0,Serie_A,2023_2024
Lorenzo Lucca,ITA,FW,Udinese,22,2000,28.8,19,11,4,11,4,5,20,25.0,15,18,3,15,3,22,36,1,Serie_A,2023_2024
Jhon Lucumí,COL,DF,Bologna,25,1998,24.6,48,29,31,17,0,27,36,75.0,9,32,17,15,16,64,68,2,Serie_A,2023_2024
José Luis Palomino,ARG,DF,Atalanta,33,1990,0.3,2,1,1,1,0,1,1,100.0,0,2,1,1,1,3,6,0,Serie_A,2023_2024
Romelu Lukaku,BEL,FW,Roma,30,1993,29.3,6,5,1,2,3,2,4,50.0,2,7,1,6,0,6,19,1,Serie_A,2023_2024
Karlo Lulić,CRO,MF,Frosinone,27,1996,0.2,0,0,0,0,0,0,0,,0,1,0,1,1,1,0,0,Serie_A,2023_2024
Sebastiano Luperto,ITA,DF,Empoli,26,1996,37.8,37,26,25,10,2,15,24,62.5,9,46,35,11,32,69,157,1,Serie_A,2023_2024
Mateus Lusuardi,BRA,DF,Frosinone,19,2004,2.4,2,1,1,1,0,1,3,33.3,2,4,2,2,4,6,8,0,Serie_A,2023_2024
Zito Luvumbo,ANG,"FW,MF",Cagliari,21,2002,21.6,9,6,5,2,2,4,15,26.7,11,19,0,19,1,10,2,0,Serie_A,2023_2024
Charalambos Lykogiannis,GRE,DF,Bologna,29,1993,10.0,10,6,5,4,1,5,10,50.0,5,15,5,10,5,15,30,0,Serie_A,2023_2024
Giulio Maggiore,ITA,MF,Salernitana,25,1998,20.0,49,29,26,22,1,20,42,47.6,22,27,5,22,24,73,38,0,Serie_A,2023_2024
Giangiacomo Magnani,ITA,DF,Hellas Verona,27,1995,27.2,33,18,23,10,0,15,25,60.0,10,50,28,22,45,78,118,0,Serie_A,2023_2024
Mike Maignan,FRA,GK,Milan,28,1995,29.0,1,0,1,0,0,1,1,100.0,0,1,0,1,1,2,4,3,Serie_A,2023_2024
Antoine Makoumbou,CGO,MF,Cagliari,25,1998,30.0,41,24,21,15,5,15,30,50.0,15,23,4,19,16,57,27,2,Serie_A,2023_2024
Daniel Maldini,ITA,"MF,FW",Monza,21,2001,3.7,3,2,0,2,1,3,6,50.0,3,2,0,2,2,5,1,0,Serie_A,2023_2024
Daniel Maldini,ITA,"FW,MF",Empoli,21,2001,2.9,4,2,0,2,2,2,2,100.0,0,5,0,5,2,6,2,0,Serie_A,2023_2024
Youssef Maleh,MAR,MF,Empoli,24,1998,28.9,74,48,30,36,8,23,52,44.2,29,62,7,55,25,99,29,0,Serie_A,2023_2024
Ruslan Malinovskyi,UKR,MF,Genoa,30,1993,17.2,35,20,18,11,6,17,41,41.5,24,22,8,14,5,40,16,0,Serie_A,2023_2024
Gianluca Mancini,ITA,DF,Roma,27,1996,31.9,34,20,21,11,2,11,27,40.7,16,38,26,12,36,70,77,1,Serie_A,2023_2024
Marco Mancosu,ITA,"MF,FW",Cagliari,34,1988,1.7,3,0,0,2,1,1,2,50.0,1,0,0,0,0,3,0,0,Serie_A,2023_2024
Christos Mandas,GRE,GK,Lazio,21,2001,8.0,0,0,0,0,0,0,1,0.0,1,0,0,0,1,1,3,1,Serie_A,2023_2024
Rolando Mandragora,ITA,MF,Fiorentina,26,1997,17.6,26,11,8,13,5,10,22,45.5,12,14,3,11,9,35,18,1,Serie_A,2023_2024
Kostas Manolas,GRE,DF,Salernitana,32,1991,5.4,9,5,6,3,0,6,8,75.0,2,10,7,3,2,11,20,0,Serie_A,2023_2024
Riccardo Marchizza,ITA,DF,Frosinone,25,1998,12.8,7,6,4,3,0,3,13,23.1,10,10,2,8,7,14,33,0,Serie_A,2023_2024
Gian Marco Ferrari,ITA,DF,Sassuolo,31,1992,25.2,22,10,11,11,0,12,18,66.7,6,28,17,11,25,47,76,0,Serie_A,2023_2024
Pablo Marí,ESP,DF,Monza,29,1993,29.1,41,25,34,7,0,22,34,64.7,12,40,25,15,37,78,115,1,Serie_A,2023_2024
Mirko Marić,CRO,FW,Monza,28,1995,3.2,4,0,2,1,1,0,2,0.0,2,4,0,4,2,6,3,0,Serie_A,2023_2024
Răzvan Marin,ROU,MF,Empoli,27,1996,20.2,40,22,13,23,4,19,29,65.5,10,16,4,12,6,46,30,2,Serie_A,2023_2024
Agustín Martegani,ARG,MF,Salernitana,23,2000,8.1,13,7,7,3,3,6,18,33.3,12,4,1,3,4,17,7,1,Serie_A,2023_2024
Aarón Martín,ESP,DF,Genoa,26,1997,15.3,21,10,7,10,4,9,22,40.9,13,12,4,8,9,30,15,0,Serie_A,2023_2024
Tommaso Martinelli,ITA,GK,Fiorentina,17,2006,1.0,0,0,0,0,0,0,0,,0,0,0,0,0,0,0,0,Serie_A,2023_2024
Josep Martinez,ESP,GK,Genoa,25,1998,36.0,0,0,0,0,0,0,0,,0,0,0,0,1,1,21,3,Serie_A,2023_2024
Lautaro Martínez,ARG,FW,Inter,25,1997,29.5,22,16,4,13,5,4,19,21.1,15,30,1,29,20,42,10,0,Serie_A,2023_2024
Lucas Martínez Quarta,ARG,DF,Fiorentina,27,1996,25.5,75,47,43,28,4,36,54,66.7,18,38,14,24,30,105,69,4,Serie_A,2023_2024
Adam Marušić,MNE,DF,Lazio,30,1992,34.4,45,31,24,19,2,27,49,55.1,22,27,7,20,29,74,63,2,Serie_A,2023_2024
Adam Masina,MAR,DF,Udinese,29,1994,0.7,4,0,2,2,0,2,4,50.0,2,2,1,1,2,6,5,0,Serie_A,2023_2024
Adam Masina,MAR,DF,Torino,29,1994,11.4,17,12,8,8,1,5,20,25.0,15,12,6,6,11,28,30,0,Serie_A,2023_2024
Alan Matturro,URU,DF,Genoa,18,2004,1.2,1,1,1,0,0,1,1,100.0,0,6,3,3,2,3,4,0,Serie_A,2023_2024
Luca Mazzitelli,ITA,MF,Frosinone,27,1995,24.6,45,23,15,24,6,26,49,53.1,23,23,7,16,19,64,62,0,Serie_A,2023_2024
Pasquale Mazzocchi,ITA,DF,Salernitana,28,1995,14.1,25,19,14,10,1,16,29,55.2,13,14,6,8,5,30,31,0,Serie_A,2023_2024
Pasquale Mazzocchi,ITA,DF,Napoli,28,1995,4.8,5,2,1,2,2,2,3,66.7,1,5,1,4,1,6,13,0,Serie_A,2023_2024
Jordi Mboula,ESP,"FW,MF",Hellas Verona,24,1999,3.4,4,4,1,2,1,4,7,57.1,3,4,1,3,1,5,0,0,Serie_A,2023_2024
Weston McKennie,USA,"MF,DF",Juventus,24,1998,28.8,48,29,31,11,6,17,27,63.0,10,28,7,21,18,66,69,0,Serie_A,2023_2024
Arthur Melo,BRA,MF,Fiorentina,26,1996,22.1,45,30,17,24,4,26,42,61.9,16,27,3,24,18,63,8,0,Serie_A,2023_2024
Leonardo Mendicino,ITA,MF,Atalanta,17,2006,0.0,0,0,0,0,0,0,0,,0,0,0,0,0,0,0,0,Serie_A,2023_2024
Alex Meret,ITA,GK,Napoli,26,1997,30.8,1,0,1,0,0,1,2,50.0,1,0,0,0,0,1,10,1,Serie_A,2023_2024
Junior Messias,BRA,"MF,DF",Genoa,32,1991,11.7,26,20,19,5,2,8,19,42.1,11,9,1,8,5,31,22,0,Serie_A,2023_2024
Nikola Milenković,SRB,DF,Fiorentina,25,1997,27.9,41,21,24,14,3,22,36,61.1,14,22,14,8,27,68,95,1,Serie_A,2023_2024
Arkadiusz Milik,POL,FW,Juventus,29,1994,10.2,9,5,2,5,2,3,5,60.0,2,7,1,6,5,14,3,0,Serie_A,2023_2024
Vanja Milinković-Savić,SRB,GK,Torino,26,1997,36.0,1,0,1,0,0,1,1,100.0,0,0,0,0,1,2,14,4,Serie_A,2023_2024
Yerry Mina,COL,"DF,MF",Fiorentina,28,1994,0.5,1,1,1,0,0,1,2,50.0,1,0,0,0,0,1,2,0,Serie_A,2023_2024
Yerry Mina,COL,DF,Cagliari,28,1994,13.5,20,13,14,6,0,13,19,68.4,6,23,14,9,4,24,77,0,Serie_A,2023_2024
Aleksei Miranchuk,RUS,"MF,FW",Atalanta,27,1995,13.1,12,6,6,4,2,5,13,38.5,8,6,1,5,2,14,5,1,Serie_A,2023_2024
Kevin Miranda,ITA,DF,Sassuolo,20,2003,0.2,0,0,0,0,0,0,0,,0,0,0,0,0,0,1,0,Serie_A,2023_2024
Antonio Mirante,ITA,GK,Milan,40,1983,2.0,0,0,0,0,0,0,0,,0,0,0,0,0,0,1,0,Serie_A,2023_2024
Fabio Miretti,ITA,MF,Juventus,19,2003,12.3,18,14,6,8,4,10,26,38.5,16,10,1,9,7,25,6,0,Serie_A,2023_2024
Filippo Missori,ITA,DF,Sassuolo,19,2004,3.0,6,3,2,4,0,4,11,36.4,7,3,2,1,4,10,8,0,Serie_A,2023_2024
Stefan Mitrović,SRB,"FW,MF",Hellas Verona,20,2002,4.3,6,3,0,5,1,2,5,40.0,3,6,1,5,0,6,4,0,Serie_A,2023_2024
Henrikh Mkhitaryan,ARM,MF,Inter,34,1989,30.9,62,34,18,35,9,24,49,49.0,25,23,4,19,29,91,43,0,Serie_A,2023_2024
Ilario Monterisi,ITA,DF,Frosinone,21,2001,16.3,23,13,14,7,2,12,26,46.2,14,22,18,4,8,31,63,0,Serie_A,2023_2024
Lorenzo Montipò,ITA,GK,Hellas Verona,27,1996,37.0,1,1,1,0,0,1,3,33.3,2,0,0,0,0,1,25,2,Serie_A,2023_2024
Nikola Moro,CRO,MF,Bologna,25,1998,9.3,21,16,8,12,1,8,15,53.3,7,14,1,13,7,28,10,0,Serie_A,2023_2024
Dany Mota,POR,"FW,MF",Monza,25,1998,22.8,13,7,2,5,6,8,17,47.1,9,4,1,3,2,15,18,0,Serie_A,2023_2024
Samuele Mulattieri,ITA,"FW,MF",Sassuolo,22,2000,5.1,1,1,0,0,1,1,2,50.0,1,7,2,5,1,2,2,0,Serie_A,2023_2024
Luis Muriel,COL,"FW,MF",Atalanta,32,1991,4.5,3,2,0,2,1,1,1,100.0,0,4,0,4,1,4,0,0,Serie_A,2023_2024
Yunus Musah,USA,"MF,FW",Milan,20,2002,16.4,25,14,15,6,4,8,15,53.3,7,18,4,14,10,35,16,1,Serie_A,2023_2024
Juan Musso,ARG,GK,Atalanta,29,1994,11.0,1,0,1,0,0,1,1,100.0,0,0,0,0,0,1,6,0,Serie_A,2023_2024
Kingstone Mutandwa,ZAM,"FW,MF",Cagliari,20,2003,0.4,1,0,1,0,0,1,4,25.0,3,1,0,1,0,1,2,0,Serie_A,2023_2024
Obite N'Dicka,CIV,DF,Roma,23,1999,24.1,32,18,12,19,1,12,20,60.0,8,30,16,14,16,48,75,0,Serie_A,2023_2024
Nahitan Nández,URU,"MF,DF",Cagliari,27,1995,26.0,59,40,27,23,9,27,64,42.2,37,25,2,23,19,78,32,0,Serie_A,2023_2024
Natan,BRA,DF,Napoli,22,2001,10.6,14,10,10,3,1,5,10,50.0,5,12,9,3,8,22,32,0,Serie_A,2023_2024
Lapo Nava,ITA,GK,Milan,19,2004,0.0,0,0,0,0,0,0,0,,0,0,0,0,0,0,0,0,Serie_A,2023_2024
Michel Ndary Adopo,FRA,MF,Atalanta,23,2000,1.2,4,3,0,3,1,1,1,100.0,0,0,0,0,0,4,2,1,Serie_A,2023_2024
Dan Ndoye,SUI,"FW,MF",Bologna,22,2000,19.7,30,15,17,11,2,17,39,43.6,22,20,1,19,10,40,14,0,Serie_A,2023_2024
Cyril Ngonge,BEL,"FW,MF",Hellas Verona,23,2000,15.9,14,9,5,3,6,5,14,35.7,9,7,1,6,4,18,10,0,Serie_A,2023_2024
Cyril Ngonge,BEL,FW,Napoli,23,2000,3.5,5,3,1,4,0,2,2,100.0,0,2,0,2,0,5,2,0,Serie_A,2023_2024
M'Baye Niang,SEN,FW,Empoli,28,1994,7.9,3,1,0,1,2,0,6,0.0,6,7,1,6,3,6,10,0,Serie_A,2023_2024
Hans Nicolussi Caviglia,ITA,MF,Juventus,23,2000,3.0,5,2,1,3,1,4,6,66.7,2,5,1,4,0,5,2,0,Serie_A,2023_2024
Joseph Nonge,BEL,MF,Juventus,18,2005,0.3,0,0,0,0,0,0,0,,0,0,0,0,0,0,1,0,Serie_A,2023_2024
Tijjani Noslin,NED,"FW,MF",Hellas Verona,24,1999,14.9,18,8,5,7,6,6,16,37.5,10,17,2,15,2,20,14,0,Serie_A,2023_2024
Simeon Nwankwo,NGA,FW,Salernitana,31,1992,7.6,6,3,0,2,4,1,3,33.3,2,7,0,7,0,6,4,0,Serie_A,2023_2024
M'Bala Nzola,ANG,FW,Fiorentina,26,1996,17.2,11,8,1,4,6,6,7,85.7,1,10,1,9,0,11,22,0,Serie_A,2023_2024
Adam Obert,SVK,DF,Cagliari,20,2002,10.5,17,9,8,8,1,8,17,47.1,9,13,7,6,21,38,41,1,Serie_A,2023_2024
Pedro Obiang,EQG,MF,Sassuolo,31,1992,5.0,8,4,3,4,1,2,10,20.0,8,6,4,2,8,16,10,0,Serie_A,2023_2024
Guillermo Ochoa,MEX,GK,Salernitana,38,1985,21.0,0,0,0,0,0,0,1,0.0,1,0,0,0,0,0,9,1,Serie_A,2023_2024
Jens Odgaard,DEN,"FW,MF",Bologna,24,1999,4.8,4,4,1,1,2,1,3,33.3,2,9,0,9,1,5,3,0,Serie_A,2023_2024
Noah Okafor,SUI,"FW,MF",Milan,23,2000,9.9,6,4,1,4,1,3,10,30.0,7,8,1,7,0,6,10,0,Serie_A,2023_2024
David Okereke,NGA,"FW,MF",Torino,25,1997,2.8,3,1,1,1,1,0,3,0.0,3,2,0,2,1,4,0,0,Serie_A,2023_2024
Caleb Okoli,ITA,DF,Frosinone,22,2001,32.4,56,34,33,22,1,29,44,65.9,15,48,32,16,29,85,156,4,Serie_A,2023_2024
Maduka Okoye,NGA,GK,Udinese,23,1999,21.0,0,0,0,0,0,0,0,,0,0,0,0,1,1,4,2,Serie_A,2023_2024
Mathías Olivera,URU,DF,Napoli,25,1997,17.4,50,29,29,15,6,23,39,59.0,16,35,6,29,20,70,25,0,Serie_A,2023_2024
Gaetano Oristanio,ITA,"FW,MF",Cagliari,20,2002,12.3,20,10,5,14,1,5,17,29.4,12,11,0,11,9,29,8,0,Serie_A,2023_2024
Riccardo Orsolini,ITA,"FW,MF",Bologna,26,1997,19.9,23,14,13,4,6,9,30,30.0,21,25,3,22,8,31,19,1,Serie_A,2023_2024
Victor Osimhen,NGA,FW,Napoli,24,1998,22.0,9,5,0,4,5,2,4,50.0,2,5,1,4,2,11,18,0,Serie_A,2023_2024
Remi Oudin,FRA,"MF,FW",Lecce,26,1996,20.2,26,14,12,12,2,12,19,63.2,7,13,1,12,20,46,22,0,Serie_A,2023_2024
Anthony Oyono,GAB,DF,Frosinone,22,2001,13.3,37,26,21,14,2,23,34,67.6,11,17,3,14,9,46,32,0,Serie_A,2023_2024
Simone Pafundi,ITA,MF,Udinese,17,2006,0.1,0,0,0,0,0,0,0,,0,0,0,0,0,0,0,0,Serie_A,2023_2024
Riccardo Pagano,ITA,"MF,DF",Roma,18,2004,0.6,2,2,1,1,0,0,6,0.0,6,3,2,1,0,2,2,0,Serie_A,2023_2024
Christos Papadopoulos,GRE,FW,Genoa,18,2004,0.0,0,0,0,0,0,0,1,0.0,1,0,0,0,0,0,0,0,Serie_A,2023_2024
Leandro Paredes,ARG,MF,Roma,29,1994,29.3,57,36,30,22,5,33,77,42.9,44,26,7,19,29,86,43,1,Serie_A,2023_2024
Fabiano Parisi,ITA,DF,Fiorentina,22,2000,16.2,30,15,11,12,7,15,26,57.7,11,21,5,16,17,47,26,0,Serie_A,2023_2024
Mario Pašalić,CRO,MF,Atalanta,28,1995,22.8,28,17,9,18,1,14,31,45.2,17,29,6,23,16,44,34,0,Serie_A,2023_2024
Triantafyllos Pasaridīs,GRE,DF,Salernitana,27,1996,5.0,11,7,9,2,0,9,14,64.3,5,7,3,4,3,14,19,0,Serie_A,2023_2024
Patric,ESP,DF,Lazio,30,1993,17.9,13,8,10,3,0,8,18,44.4,10,15,9,6,6,19,44,0,Serie_A,2023_2024
Rui Patrício,POR,GK,Roma,35,1988,23.0,0,0,0,0,0,0,1,0.0,1,1,0,1,0,0,3,1,Serie_A,2023_2024
Benjamin Pavard,FRA,DF,Inter,27,1996,18.6,34,21,21,11,2,20,24,83.3,4,25,15,10,32,66,44,1,Serie_A,2023_2024
Leonardo Pavoletti,ITA,FW,Cagliari,34,1988,7.0,1,1,0,0,1,0,1,0.0,1,2,1,1,0,1,7,0,Serie_A,2023_2024
Martín Payero,ARG,MF,Udinese,24,1998,20.0,54,32,28,19,7,19,46,41.3,27,25,7,18,15,69,21,0,Serie_A,2023_2024
Marcus Pedersen,NOR,DF,Sassuolo,23,2000,17.9,36,24,25,5,6,21,25,84.0,4,19,5,14,10,46,51,0,Serie_A,2023_2024
Pedro,ESP,"FW,MF",Lazio,36,1987,9.1,16,12,5,7,4,3,12,25.0,9,16,2,14,3,19,1,0,Serie_A,2023_2024
Pietro Pellegri,ITA,FW,Torino,22,2001,8.4,5,1,1,4,0,1,5,20.0,4,4,1,3,2,7,3,0,Serie_A,2023_2024
Lorenzo Pellegrini,ITA,MF,Roma,27,1996,20.7,35,20,14,16,5,17,51,33.3,34,28,5,23,20,55,22,0,Serie_A,2023_2024
Luca Pellegrini,ITA,DF,Lazio,24,1999,8.7,18,13,7,10,1,9,17,52.9,8,7,3,4,9,27,20,0,Serie_A,2023_2024
Marco Pellegrino,nan,DF,Salernitana,,,6.1,8,6,4,3,1,5,10,50.0,5,11,6,5,10,18,28,0,Serie_A,2023_2024
Marco Pellegrino,nan,DF,Milan,,,0.8,1,1,0,0,1,0,2,0.0,2,1,1,0,1,2,2,0,Serie_A,2023_2024
Pepín,EQG,"MF,FW",Monza,26,1996,2.7,6,1,1,4,1,2,4,50.0,2,5,2,3,0,6,6,0,Serie_A,2023_2024
Pedro Pereira,POR,DF,Monza,25,1998,9.3,19,13,14,4,1,9,17,52.9,8,15,2,13,4,23,18,0,Serie_A,2023_2024
Roberto Pereyra,ARG,"FW,MF",Udinese,32,1991,20.6,19,9,11,5,3,11,29,37.9,18,20,4,16,7,26,18,0,Serie_A,2023_2024
Nehuén Pérez,ARG,DF,Udinese,23,2000,36.0,72,48,42,28,2,39,48,81.3,9,53,26,27,45,117,158,1,Serie_A,2023_2024
Simone Perilli,ITA,GK,Hellas Verona,28,1995,1.0,0,0,0,0,0,0,0,,0,0,0,0,0,0,0,0,Serie_A,2023_2024
Mattia Perin,ITA,GK,Juventus,30,1992,2.5,0,0,0,0,0,0,0,,0,0,0,0,0,0,1,0,Serie_A,2023_2024
Samuele Perisan,ITA,GK,Empoli,25,1997,1.0,0,0,0,0,0,0,0,,0,0,0,0,0,0,0,0,Serie_A,2023_2024
Matteo Pessina,ITA,MF,Monza,26,1997,35.8,44,25,20,20,4,23,49,46.9,26,29,11,18,27,71,46,1,Serie_A,2023_2024
Andrea Petagna,ITA,FW,Cagliari,28,1995,11.1,4,2,1,0,3,1,2,50.0,1,6,3,3,1,5,4,0,Serie_A,2023_2024
Giuseppe Pezzella,ITA,DF,Empoli,25,1997,12.1,25,14,19,5,1,20,28,71.4,8,17,6,11,2,27,35,0,Serie_A,2023_2024
Roberto Piccoli,ITA,FW,Empoli,22,2001,0.4,1,1,0,0,1,1,1,100.0,0,0,0,0,0,1,0,0,Serie_A,2023_2024
Roberto Piccoli,ITA,FW,Lecce,22,2001,15.3,10,6,3,5,2,1,4,25.0,3,17,1,16,4,14,16,0,Serie_A,2023_2024
Santiago Pierotti,ARG,"MF,FW",Lecce,22,2001,2.2,8,8,2,5,1,2,8,25.0,6,5,0,5,1,9,0,0,Serie_A,2023_2024
Niccolò Pierozzi,ITA,DF,Salernitana,21,2001,9.7,17,11,13,4,0,11,22,50.0,11,24,7,17,11,28,36,0,Serie_A,2023_2024
Andrea Pinamonti,ITA,FW,Sassuolo,24,1999,34.2,13,8,1,6,6,5,22,22.7,17,19,2,17,1,14,40,0,Serie_A,2023_2024
Carlo Pinsoglio,ITA,GK,Juventus,33,1990,0.5,0,0,0,0,0,0,0,,0,0,0,0,0,0,0,0,Serie_A,2023_2024
Lorenzo Pirola,ITA,DF,Salernitana,21,2002,22.1,39,23,25,14,0,15,28,53.6,13,46,30,16,25,64,93,1,Serie_A,2023_2024
Niccolò Pisilli,ITA,MF,Roma,18,2004,0.1,0,0,0,0,0,0,0,,0,0,0,0,0,0,0,0,Serie_A,2023_2024
Tommaso Pobega,ITA,MF,Milan,24,1999,3.5,16,9,11,5,0,6,13,46.2,7,10,2,8,6,22,7,0,Serie_A,2023_2024
Paul Pogba,FRA,MF,Juventus,30,1993,0.6,1,1,0,1,0,1,1,100.0,0,0,0,0,1,2,1,0,Serie_A,2023_2024
Matteo Politano,ITA,FW,Napoli,29,1993,26.2,19,8,8,7,4,11,34,32.4,23,9,1,8,15,34,11,1,Serie_A,2023_2024
Marin Pongračić,CRO,DF,Lecce,25,1997,35.8,43,30,22,20,1,19,25,76.0,6,37,26,11,51,94,130,1,Serie_A,2023_2024
Stefan Posch,AUT,DF,Bologna,26,1997,26.8,77,46,35,38,4,49,88,55.7,39,27,8,19,18,95,72,0,Serie_A,2023_2024
Matteo Prati,ITA,MF,Cagliari,19,2003,21.9,45,25,15,27,3,26,42,61.9,16,29,6,23,15,60,26,1,Serie_A,2023_2024
Ivan Provedel,ITA,GK,Lazio,29,1994,30.0,1,0,1,0,0,1,3,33.3,2,0,0,0,0,1,12,1,Serie_A,2023_2024
Christian Pulisic,USA,"FW,MF",Milan,24,1998,28.9,35,26,14,11,10,17,30,56.7,13,20,1,19,10,45,10,1,Serie_A,2023_2024
George Pușcaș,ROU,FW,Genoa,27,1996,2.1,0,0,0,0,0,0,3,0.0,3,1,0,1,0,0,1,0,Serie_A,2023_2024
Domingos Quina,POR,MF,Udinese,23,1999,0.1,1,1,1,0,0,0,0,,0,0,0,0,0,1,0,0,Serie_A,2023_2024
Adrien Rabiot,FRA,MF,Juventus,28,1995,29.5,58,39,22,30,6,30,45,66.7,15,26,6,20,25,83,34,0,Serie_A,2023_2024
Uroš Račić,SRB,MF,Sassuolo,25,1998,9.1,10,4,6,4,0,0,9,0.0,9,16,7,9,7,17,22,0,Serie_A,2023_2024
Nemanja Radonjić,SRB,"MF,FW",Torino,27,1996,4.2,1,1,0,0,1,1,3,33.3,2,3,0,3,0,1,0,0,Serie_A,2023_2024
Boris Radunović,SRB,GK,Cagliari,27,1996,7.0,0,0,0,0,0,0,0,,0,0,0,0,1,1,1,2,Serie_A,2023_2024
Hamza Rafia,TUN,MF,Lecce,24,1999,13.4,44,31,13,27,4,13,30,43.3,17,27,1,26,11,55,13,0,Serie_A,2023_2024
Ylber Ramadani,ALB,MF,Lecce,27,1996,33.0,68,41,32,29,7,37,96,38.5,59,54,13,41,44,112,44,0,Serie_A,2023_2024
Luca Ranieri,ITA,DF,Fiorentina,24,1999,22.9,14,10,11,1,2,8,13,61.5,5,25,11,14,29,43,64,0,Serie_A,2023_2024
Filippo Ranocchia,ITA,"MF,DF",Empoli,22,2001,5.3,16,11,7,9,0,7,16,43.8,9,9,1,8,3,19,14,0,Serie_A,2023_2024
Giacomo Raspadori,ITA,"FW,MF",Napoli,23,2000,17.6,21,10,6,10,5,6,15,40.0,9,15,1,14,3,24,7,0,Serie_A,2023_2024
Federico Ravaglia,ITA,GK,Bologna,23,1999,5.9,0,0,0,0,0,0,0,,0,0,0,0,0,0,2,0,Serie_A,2023_2024
Tijjani Reijnders,NED,MF,Milan,25,1998,31.3,46,25,10,31,5,21,43,48.8,22,26,8,18,18,64,26,0,Serie_A,2023_2024
Reinier,BRA,"MF,FW",Frosinone,21,2002,11.8,21,10,6,12,3,5,17,29.4,12,24,4,20,10,31,5,0,Serie_A,2023_2024
Mateo Retegui,ITA,FW,Genoa,24,1999,24.6,17,9,7,8,2,6,20,30.0,14,18,2,16,0,17,30,0,Serie_A,2023_2024
Samuele Ricci,ITA,MF,Torino,21,2001,26.6,33,18,17,12,4,15,23,65.2,8,21,3,18,27,60,25,0,Serie_A,2023_2024
Ricardo Rodríguez,SUI,DF,Torino,30,1992,30.8,45,26,21,22,2,28,45,62.2,17,22,9,13,24,69,64,2,Serie_A,2023_2024
Alessio Romagnoli,ITA,DF,Lazio,28,1995,26.8,25,18,14,11,0,16,24,66.7,8,29,17,12,29,54,115,0,Serie_A,2023_2024
Simone Romagnoli,ITA,DF,Frosinone,33,1990,30.2,35,15,23,11,1,15,20,75.0,5,51,36,15,29,64,147,0,Serie_A,2023_2024
Luka Romero,ARG,"FW,MF",Milan,18,2004,1.0,0,0,0,0,0,0,3,0.0,3,2,0,2,0,0,0,0,Serie_A,2023_2024
Marten de Roon,NED,"MF,DF",Atalanta,32,1991,28.9,80,43,36,32,12,35,82,42.7,47,36,10,26,40,120,54,0,Serie_A,2023_2024
Francesco Rossi,ITA,GK,Atalanta,32,1991,0.1,0,0,0,0,0,0,0,,0,0,0,0,0,0,0,0,Serie_A,2023_2024
Nicolò Rovella,ITA,MF,Lazio,21,2001,14.6,46,28,25,17,4,16,36,44.4,20,27,6,21,23,69,29,0,Serie_A,2023_2024
Amir Rrahmani,KVX,DF,Napoli,29,1994,28.9,33,27,17,14,2,16,32,50.0,16,24,10,14,20,53,90,0,Serie_A,2023_2024
Ruan,BRA,DF,Sassuolo,24,1999,16.8,25,15,11,10,4,10,18,55.6,8,18,15,3,24,49,68,2,Serie_A,2023_2024
Daniele Rugani,ITA,DF,Juventus,29,1994,13.2,11,9,7,3,1,4,5,80.0,1,11,4,7,9,20,42,0,Serie_A,2023_2024
Matteo Ruggeri,ITA,DF,Atalanta,21,2002,27.2,29,15,14,7,8,16,30,53.3,14,46,4,42,23,52,44,0,Serie_A,2023_2024
Mário Rui,POR,DF,Napoli,32,1991,13.4,27,15,17,5,5,14,21,66.7,7,17,2,15,15,42,19,0,Serie_A,2023_2024
Stefano Sabelli,ITA,DF,Genoa,30,1993,27.0,50,24,28,19,3,15,46,32.6,31,27,6,21,23,73,35,0,Serie_A,2023_2024
Alexis Saelemaekers,BEL,"FW,MF",Bologna,24,1999,21.0,32,22,13,14,5,12,27,44.4,15,13,1,12,13,45,10,1,Serie_A,2023_2024
Lazar Samardzic,SRB,MF,Udinese,21,2002,26.4,40,19,18,18,4,16,39,41.0,23,26,6,20,10,50,25,0,Serie_A,2023_2024
Junior Sambia,FRA,"DF,MF",Salernitana,26,1996,11.5,12,5,8,1,3,6,11,54.5,5,15,7,8,11,23,28,0,Serie_A,2023_2024
Antonio Sanabria,PAR,"FW,MF",Torino,27,1996,23.7,18,15,5,9,4,4,9,44.4,5,7,1,6,6,24,12,0,Serie_A,2023_2024
Renato Sanches,POR,MF,Roma,25,1997,1.6,2,1,1,1,0,2,3,66.7,1,2,0,2,0,2,1,0,Serie_A,2023_2024
Alexis Sánchez,CHI,"FW,MF",Inter,34,1988,8.5,7,6,0,5,2,1,4,25.0,3,4,1,3,1,8,3,0,Serie_A,2023_2024
Alex Sandro,BRA,DF,Juventus,32,1991,8.0,13,7,7,6,0,4,5,80.0,1,13,7,6,15,28,23,0,Serie_A,2023_2024
Nicola Sansone,ITA,"FW,MF",Lecce,31,1991,8.5,11,6,6,2,3,5,16,31.3,11,7,1,6,4,15,5,2,Serie_A,2023_2024
Riccardo Saponara,ITA,"FW,MF",Hellas Verona,31,1991,3.8,3,1,2,0,1,1,7,14.3,6,4,0,4,0,3,2,0,Serie_A,2023_2024
Zanos Savva,CYP,"DF,MF",Torino,17,2005,0.3,1,1,0,1,0,1,3,33.3,2,0,0,0,0,1,1,0,Serie_A,2023_2024
Saba Sazonov,GEO,DF,Torino,21,2002,4.0,9,7,4,5,0,3,3,100.0,0,8,5,3,3,12,22,0,Serie_A,2023_2024
Giorgio Scalvini,ITA,DF,Atalanta,19,2003,28.3,53,33,29,19,5,19,40,47.5,21,44,17,27,59,112,71,0,Serie_A,2023_2024
Gianluca Scamacca,ITA,FW,Atalanta,24,1999,16.1,15,9,4,5,6,7,14,50.0,7,7,1,6,4,19,9,0,Serie_A,2023_2024
Perr Schuurs,NED,DF,Torino,23,1999,8.6,20,12,11,8,1,3,9,33.3,6,10,2,8,9,29,23,0,Serie_A,2023_2024
Simone Scuffet,ITA,GK,Cagliari,27,1996,31.0,1,0,1,0,0,1,2,50.0,1,1,0,1,1,2,9,0,Serie_A,2023_2024
Demba Seck,SEN,MF,Torino,22,2001,4.7,5,3,1,4,0,3,4,75.0,1,1,0,1,1,6,0,0,Serie_A,2023_2024
Demba Seck,SEN,"FW,MF",Frosinone,22,2001,3.3,7,4,2,3,2,4,5,80.0,1,3,0,3,1,8,1,0,Serie_A,2023_2024
Nikola Sekulov,ITA,FW,Juventus,21,2002,0.1,0,0,0,0,0,0,0,,0,0,0,0,0,0,0,0,Serie_A,2023_2024
Vivaldo Semedo,POR,FW,Udinese,18,2005,0.1,0,0,0,0,0,0,0,,0,0,0,0,0,0,0,0,Serie_A,2023_2024
Stefano Sensi,ITA,MF,Inter,27,1995,0.5,1,1,0,1,0,1,3,33.3,2,1,0,1,1,2,0,0,Serie_A,2023_2024
Suat Serdar,GER,MF,Hellas Verona,26,1997,18.4,51,39,24,23,4,22,45,48.9,23,29,7,22,20,71,25,1,Serie_A,2023_2024
Andres Sfait,ROU,"DF,MF",Salernitana,18,2004,0.3,1,1,1,0,0,1,2,50.0,1,0,0,0,0,1,0,0,Serie_A,2023_2024
Stephan El Shaarawy,ITA,"FW,DF",Roma,30,1992,19.3,21,13,14,4,3,6,15,40.0,9,11,4,7,13,34,15,2,Serie_A,2023_2024
Eldor Shomurodov,UZB,"FW,MF",Cagliari,28,1995,10.4,11,4,2,6,3,6,10,60.0,4,5,0,5,4,15,4,0,Serie_A,2023_2024
Steven Shpendi,ALB,"FW,MF",Empoli,20,2003,4.6,0,0,0,0,0,0,4,0.0,4,2,1,1,1,1,0,0,Serie_A,2023_2024
Marco Silvestri,ITA,GK,Udinese,32,1991,17.0,0,0,0,0,0,0,3,0.0,3,1,0,1,0,0,5,3,Serie_A,2023_2024
Giovanni Simeone,ARG,FW,Napoli,28,1995,8.9,12,4,1,3,8,3,12,25.0,9,11,0,11,1,13,7,0,Serie_A,2023_2024
Jan-Carlo Simic,SRB,DF,Milan,18,2005,1.6,1,1,1,0,0,0,0,,0,5,4,1,0,1,3,0,Serie_A,2023_2024
Leo Skiri Østigård,NOR,DF,Napoli,23,1999,18.1,24,12,13,10,1,6,11,54.5,5,18,12,6,16,40,65,0,Serie_A,2023_2024
Łukasz Skorupski,POL,GK,Bologna,32,1991,32.0,2,2,2,0,0,2,3,66.7,1,0,0,0,1,3,11,3,Serie_A,2023_2024
Chris Smalling,ENG,DF,Roma,33,1989,4.3,1,1,1,0,0,1,4,25.0,3,6,5,1,5,6,8,0,Serie_A,2023_2024
Andrea Sodero,ITA,MF,Empoli,18,2004,0.1,0,0,0,0,0,0,0,,0,0,0,0,0,0,0,0,Serie_A,2023_2024
Ola Solbakken,NOR,FW,Roma,24,1998,0.3,0,0,0,0,0,0,0,,0,0,0,0,0,0,0,0,Serie_A,2023_2024
Daniele Sommariva,ITA,GK,Genoa,26,1997,0.1,0,0,0,0,0,0,0,,0,0,0,0,0,0,0,0,Serie_A,2023_2024
Yann Sommer,SUI,GK,Inter,34,1988,34.0,2,1,2,0,0,2,2,100.0,0,1,0,1,0,2,7,1,Serie_A,2023_2024
Brandon Soppy,FRA,DF,Torino,21,2002,2.0,2,2,1,1,0,2,6,33.3,4,2,0,2,0,2,3,1,Serie_A,2023_2024
Alessandro Sorrentino,ITA,GK,Monza,21,2002,6.1,0,0,0,0,0,0,0,,0,0,0,0,0,0,0,0,Serie_A,2023_2024
Riccardo Sottil,ITA,FW,Fiorentina,24,1999,12.3,10,5,5,1,4,3,8,37.5,5,12,0,12,2,12,2,0,Serie_A,2023_2024
Matìas Soulé,ARG,"FW,MF",Frosinone,20,2003,34.7,41,27,12,14,15,19,40,47.5,21,38,4,34,18,59,9,0,Serie_A,2023_2024
Djed Spence,ENG,DF,Genoa,22,2000,9.5,16,10,12,4,0,8,10,80.0,2,20,5,15,8,24,28,0,Serie_A,2023_2024
Leonardo Spinazzola,ITA,DF,Roma,30,1993,14.6,15,7,10,5,0,8,18,44.4,10,8,2,6,3,18,15,0,Serie_A,2023_2024
Marco Sportiello,ITA,GK,Milan,31,1992,7.0,0,0,0,0,0,0,0,,0,0,0,0,0,0,2,0,Serie_A,2023_2024
Trivante Stewart,JAM,"FW,MF",Salernitana,23,2000,1.1,0,0,0,0,0,0,0,,0,1,0,1,0,0,0,0,Serie_A,2023_2024
Gabriel Strefezza,BRA,FW,Lecce,26,1997,12.4,24,17,8,7,9,14,20,70.0,6,17,0,17,7,31,11,0,Serie_A,2023_2024
Kevin Strootman,NED,MF,Genoa,33,1990,13.4,34,19,13,18,3,15,31,48.4,16,20,6,14,7,41,22,0,Serie_A,2023_2024
Isaac Success,NGA,"FW,MF",Udinese,27,1996,9.8,6,4,0,5,1,1,3,33.3,2,6,1,5,2,8,11,0,Serie_A,2023_2024
Ibrahim Sulemana,GHA,MF,Cagliari,20,2003,14.9,36,14,15,15,6,17,27,63.0,10,24,5,19,7,43,23,0,Serie_A,2023_2024
Tomáš Suslov,SVK,"MF,FW",Hellas Verona,21,2002,23.2,42,30,11,22,9,15,47,31.9,32,15,0,15,6,48,8,0,Serie_A,2023_2024
Mile Svilar,SRB,GK,Roma,23,1999,15.0,0,0,0,0,0,0,0,,0,0,0,0,0,0,2,1,Serie_A,2023_2024
Karol Świderski,POL,"FW,MF",Hellas Verona,26,1997,5.6,7,3,1,3,3,2,3,66.7,1,6,4,2,1,8,8,0,Serie_A,2023_2024
Wojciech Szczęsny,POL,GK,Juventus,33,1990,35.0,0,0,0,0,0,0,0,,0,0,0,0,1,1,11,2,Serie_A,2023_2024
Przemysław Szymiński,POL,MF,Frosinone,29,1994,0.1,0,0,0,0,0,0,0,,0,1,1,0,0,0,0,0,Serie_A,2023_2024
Adrien Tameze,CMR,"DF,MF",Torino,29,1994,23.8,35,16,13,18,4,18,37,48.6,19,24,11,13,47,82,25,2,Serie_A,2023_2024
Elayis Tavsan,NED,"MF,FW",Hellas Verona,22,2001,0.6,0,0,0,0,0,0,1,0.0,1,0,0,0,0,0,1,0,Serie_A,2023_2024
Loum Tchaouna,FRA,"FW,MF",Salernitana,19,2003,23.3,20,10,5,13,2,10,20,50.0,10,20,1,19,4,24,16,1,Serie_A,2023_2024
Jackson Tchatchoua,CMR,DF,Hellas Verona,21,2001,19.2,39,26,25,12,2,23,48,47.9,25,17,7,10,23,62,49,2,Serie_A,2023_2024
Filippo Terracciano,ITA,DF,Hellas Verona,20,2003,14.4,30,19,23,6,1,17,31,54.8,14,24,6,18,20,50,17,0,Serie_A,2023_2024
Filippo Terracciano,ITA,"DF,FW",Milan,20,2003,0.8,2,2,1,1,0,1,3,33.3,2,3,0,3,0,2,1,0,Serie_A,2023_2024
Pietro Terracciano,ITA,GK,Fiorentina,33,1990,33.0,1,1,1,0,0,1,3,33.3,2,1,0,1,0,1,8,0,Serie_A,2023_2024
Florian Thauvin,FRA,FW,Udinese,30,1993,19.0,7,4,2,4,1,4,13,30.8,9,9,1,8,3,10,2,0,Serie_A,2023_2024
Malick Thiaw,GER,DF,Milan,21,2001,18.0,34,17,15,17,2,12,25,48.0,13,23,13,10,13,47,55,0,Serie_A,2023_2024
Morten Thorsby,NOR,MF,Genoa,27,1996,12.9,19,11,9,8,2,7,14,50.0,7,21,5,16,4,23,20,0,Serie_A,2023_2024
Kristian Thorstvedt,NOR,MF,Sassuolo,24,1999,26.6,40,22,7,28,5,22,44,50.0,22,25,9,16,21,61,36,0,Serie_A,2023_2024
Marcus Thuram,FRA,FW,Inter,25,1997,29.9,23,15,9,9,5,4,13,30.8,9,26,3,23,4,27,19,0,Serie_A,2023_2024
Antonio Tikvić,CRO,DF,Udinese,19,2004,0.0,0,0,0,0,0,0,0,,0,0,0,0,0,0,0,0,Serie_A,2023_2024
Jeremy Toljan,GER,DF,Sassuolo,28,1994,23.1,13,10,8,4,1,9,15,60.0,6,17,5,12,16,29,49,1,Serie_A,2023_2024
Rafael Tolói,ITA,DF,Atalanta,32,1990,10.7,20,9,7,8,5,14,27,51.9,13,9,4,5,13,33,29,0,Serie_A,2023_2024
Fikayo Tomori,ENG,DF,Milan,25,1997,23.6,42,24,29,10,3,18,29,62.1,11,34,23,11,26,68,75,1,Serie_A,2023_2024
Ahmed Touba,ALG,DF,Lecce,25,1998,3.1,6,4,3,3,0,3,4,75.0,1,4,3,1,7,13,20,0,Serie_A,2023_2024
Chaka Traorè,CIV,FW,Milan,18,2004,0.2,2,1,2,0,0,1,2,50.0,1,1,1,0,0,2,0,0,Serie_A,2023_2024
Stefano Turati,ITA,GK,Frosinone,21,2001,30.5,0,0,0,0,0,0,0,,0,0,0,0,0,0,6,3,Serie_A,2023_2024
Kacper Urbanski,POL,"MF,FW",Bologna,18,2004,10.3,16,10,5,10,1,6,13,46.2,7,15,1,14,4,20,14,0,Serie_A,2023_2024
Emanuele Valeri,ITA,DF,Frosinone,24,1998,13.1,19,16,10,5,4,10,21,47.6,11,14,3,11,9,28,22,0,Serie_A,2023_2024
Johan Vásquez,MEX,DF,Genoa,24,1998,31.7,51,33,38,11,2,32,50,64.0,18,50,26,24,45,96,113,0,Serie_A,2023_2024
Matías Vecino,URU,MF,Lazio,31,1991,12.8,32,17,12,20,0,20,31,64.5,11,17,5,12,12,44,21,0,Serie_A,2023_2024
Lorenzo Venuti,ITA,DF,Lecce,28,1995,4.0,6,4,5,1,0,6,10,60.0,4,4,3,1,5,11,14,0,Serie_A,2023_2024
Simone Verdi,ITA,FW,Torino,31,1992,0.0,0,0,0,0,0,0,0,,0,0,0,0,0,0,0,0,Serie_A,2023_2024
Emanuel Vignato,ITA,"MF,FW",Salernitana,22,2000,3.5,10,7,4,5,1,5,6,83.3,1,1,0,1,1,11,7,0,Serie_A,2023_2024
Samuele Vignato,ITA,"MF,FW",Monza,19,2004,3.8,6,4,2,3,1,2,3,66.7,1,2,0,2,1,7,1,0,Serie_A,2023_2024
Matías Viña,URU,DF,Sassuolo,25,1997,11.3,34,21,22,7,5,20,36,55.6,16,12,2,10,9,43,34,0,Serie_A,2023_2024
Rúben Vinagre,POR,"DF,FW",Hellas Verona,24,1999,3.1,4,2,1,1,2,3,4,75.0,1,6,3,3,1,5,4,0,Serie_A,2023_2024
Nicolas Viola,ITA,"MF,FW",Cagliari,33,1989,13.4,13,9,2,8,3,7,17,41.2,10,9,0,9,2,15,6,0,Serie_A,2023_2024
Mattia Viti,ITA,DF,Sassuolo,21,2002,10.9,24,15,14,7,3,10,22,45.5,12,20,10,10,10,34,44,0,Serie_A,2023_2024
Vitinha,POR,"FW,MF",Genoa,23,2000,3.2,2,2,1,0,1,1,2,50.0,1,2,0,2,0,2,2,0,Serie_A,2023_2024
Dušan Vlahović,SRB,FW,Juventus,23,2000,25.6,9,5,0,6,3,4,11,36.4,7,4,2,2,1,10,11,0,Serie_A,2023_2024
Nikola Vlašić,CRO,"MF,FW",Torino,25,1997,29.0,28,16,6,14,8,4,30,13.3,26,26,7,19,11,39,16,0,Serie_A,2023_2024
Alessandro Vogliacco,ITA,DF,Genoa,24,1998,13.0,23,15,14,8,1,12,15,80.0,3,16,10,6,30,53,40,1,Serie_A,2023_2024
Mërgim Vojvoda,KVX,DF,Torino,28,1995,15.3,17,8,7,6,4,11,16,68.8,5,12,2,10,13,30,28,0,Serie_A,2023_2024
Cristian Volpato,ITA,"MF,FW",Sassuolo,19,2003,7.2,16,8,9,6,1,9,25,36.0,16,7,0,7,1,17,5,0,Serie_A,2023_2024
Stefan de Vrij,NED,DF,Inter,31,1992,17.6,18,13,13,4,1,8,15,53.3,7,22,10,12,24,42,51,0,Serie_A,2023_2024
Walace,BRA,MF,Udinese,28,1995,36.0,66,43,40,26,0,36,77,46.8,41,43,6,37,43,109,66,1,Serie_A,2023_2024
Sebastian Walukiewicz,POL,DF,Empoli,23,2000,22.8,39,28,33,6,0,28,41,68.3,13,50,31,19,15,54,121,0,Serie_A,2023_2024
Timothy Weah,USA,"DF,FW",Juventus,23,2000,14.0,27,20,16,8,3,15,20,75.0,5,12,1,11,5,32,15,0,Serie_A,2023_2024
Shon Weissman,ISR,"FW,DF",Salernitana,27,1996,5.5,4,3,2,0,2,0,4,0.0,4,2,1,1,3,7,4,0,Serie_A,2023_2024
Mateusz Wieteska,POL,DF,Cagliari,26,1997,10.7,14,11,9,3,2,3,10,30.0,7,10,5,5,14,28,48,0,Serie_A,2023_2024
Kenan Yıldız,TUR,"FW,MF",Juventus,18,2005,10.6,13,9,5,6,2,4,8,50.0,4,6,0,6,1,14,4,0,Serie_A,2023_2024
Mattia Zaccagni,ITA,"FW,MF",Lazio,28,1995,21.7,27,16,11,15,1,9,21,42.9,12,26,2,24,21,48,15,0,Serie_A,2023_2024
Nicola Zalewski,POL,"DF,FW",Roma,21,2002,10.8,20,14,10,9,1,8,22,36.4,14,12,4,8,9,29,17,0,Serie_A,2023_2024
Andre-Frank Zambo Anguissa,CMR,MF,Napoli,27,1995,31.0,61,33,21,29,11,34,69,49.3,35,40,5,35,28,89,19,1,Serie_A,2023_2024
Alessandro Zanoli,ITA,DF,Salernitana,22,2000,10.2,16,13,9,7,0,7,12,58.3,5,10,2,8,1,17,17,0,Serie_A,2023_2024
Alessandro Zanoli,ITA,"DF,FW",Napoli,22,2000,0.6,1,1,1,0,0,0,0,,0,0,0,0,1,2,1,0,Serie_A,2023_2024
Duván Zapata,COL,FW,Torino,32,1991,32.0,18,7,9,2,7,3,12,25.0,9,20,6,14,7,25,26,0,Serie_A,2023_2024
Duván Zapata,COL,FW,Atalanta,32,1991,1.2,0,0,0,0,0,0,1,0.0,1,0,0,0,0,0,1,0,Serie_A,2023_2024
Gabriele Zappa,ITA,DF,Cagliari,23,1999,28.5,54,31,29,16,9,29,41,70.7,12,29,5,24,20,74,75,2,Serie_A,2023_2024
Davide Zappacosta,ITA,DF,Atalanta,31,1992,20.7,30,20,15,10,5,16,34,47.1,18,29,4,25,5,35,19,0,Serie_A,2023_2024
Oier Zarraga,ESP,MF,Udinese,24,1999,4.5,3,3,2,1,0,1,5,20.0,4,5,2,3,5,8,16,1,Serie_A,2023_2024
Jordan Zemura,ZIM,DF,Udinese,23,1999,11.5,24,16,13,7,4,11,19,57.9,8,5,1,4,13,37,21,0,Serie_A,2023_2024
Alessio Zerbin,ITA,"DF,FW",Monza,24,1999,7.6,18,10,13,2,3,4,13,30.8,9,16,3,13,3,21,5,0,Serie_A,2023_2024
Alessio Zerbin,ITA,"FW,DF",Napoli,24,1999,1.7,5,2,1,3,1,2,7,28.6,5,1,0,1,0,5,0,0,Serie_A,2023_2024
Kevin Zeroli,ITA,MF,Milan,18,2005,0.3,1,1,1,0,0,0,0,,0,1,0,1,0,1,1,0,Serie_A,2023_2024
Piotr Zieliński,POL,MF,Napoli,29,1994,21.4,23,15,6,13,4,12,24,50.0,12,12,1,11,9,32,15,0,Serie_A,2023_2024
David Zima,CZE,DF,Torino,22,2000,1.0,1,1,1,0,0,0,0,,0,0,0,0,3,4,7,0,Serie_A,2023_2024
Joshua Zirkzee,NED,FW,Bologna,22,2001,30.7,32,20,8,15,9,13,24,54.2,11,25,2,23,3,35,36,0,Serie_A,2023_2024
Nadir Zortea,ITA,DF,Frosinone,24,1999,14.0,21,14,8,13,0,10,22,45.5,12,13,5,8,4,25,29,1,Serie_A,2023_2024
Nadir Zortea,ITA,DF,Atalanta,24,1999,1.7,5,4,3,1,1,1,4,25.0,3,2,0,2,1,6,3,0,Serie_A,2023_2024
Szymon Żurkowski,POL,MF,Empoli,25,1997,9.6,15,6,5,8,2,5,15,33.3,10,5,1,4,6,21,11,0,Serie_A,2023_2024
Milan Đurić,BIH,FW,Hellas Verona,33,1990,13.4,1,0,0,0,1,0,3,0.0,3,0,0,0,1,2,13,0,Serie_A,2023_2024
Milan Đurić,BIH,FW,Monza,33,1990,14.0,5,5,0,5,0,2,4,50.0,2,6,2,4,0,5,27,0,Serie_A,2023_2024
Mateusz Łęgowski,POL,MF,Salernitana,20,2003,12.7,23,12,8,12,3,11,26,42.3,15,13,2,11,7,30,16,0,Serie_A,2023_2024
Rodrigo Abascal,URU,DF,Boavista,29,1994,27.5,46,26,33,13,0,26,40,65.0,14,59,32,27,34,80,110,3,Primeira_Liga,2023_2024
Antonio Adán,ESP,GK,Sporting CP,36,1987,22.0,0,0,0,0,0,0,1,0.0,1,0,0,0,0,0,3,1,Primeira_Liga,2023_2024
Dennis Adeniran,ENG,MF,Portimonense,24,1999,0.1,0,0,0,0,0,0,0,,0,0,0,0,2,2,0,0,Primeira_Liga,2023_2024
Martin Agirregabiria,ESP,DF,Famalicão,27,1996,13.4,21,18,15,4,2,17,24,70.8,7,12,2,10,11,32,31,1,Primeira_Liga,2023_2024
Salvador Agra,POR,"FW,DF",Boavista,31,1991,27.3,21,9,14,5,2,9,31,29.0,22,8,1,7,16,37,19,0,Primeira_Liga,2023_2024
Matheus Aiás,BRA,"FW,MF",Moreirense,26,1996,5.3,4,2,2,0,2,1,10,10.0,9,7,4,3,4,8,2,0,Primeira_Liga,2023_2024
Alan,BRA,MF,Moreirense,23,2000,27.3,44,32,7,25,12,9,29,31.0,20,24,2,22,7,51,5,0,Primeira_Liga,2023_2024
Rafael Alcobia,POR,DF,Portimonense,20,2003,2.3,3,3,2,1,0,1,1,100.0,0,4,1,3,1,4,4,0,Primeira_Liga,2023_2024
Alemão,BRA,DF,Portimonense,20,2002,26.3,49,34,39,10,0,27,39,69.2,12,49,33,16,30,79,137,1,Primeira_Liga,2023_2024
Ali Alipour,IRN,FW,Gil Vicente FC,27,1995,8.9,9,4,0,3,6,2,5,40.0,3,6,0,6,0,9,4,0,Primeira_Liga,2023_2024
Almeida,BRA,DF,Estrela,23,2000,5.4,6,5,3,3,0,3,7,42.9,4,6,4,2,3,9,19,0,Primeira_Liga,2023_2024
Pedro Álvaro,POR,DF,Estoril,23,2000,19.9,11,7,11,0,0,7,12,58.3,5,21,15,6,23,34,96,0,Primeira_Liga,2023_2024
Pedro Amador,POR,DF,Moreirense,24,1998,12.6,28,19,16,10,2,16,31,51.6,15,17,3,14,15,43,32,0,Primeira_Liga,2023_2024
Artur Jorge Marques Amorim,POR,DF,Farense,28,1994,5.5,7,4,5,2,0,4,5,80.0,1,10,8,2,7,14,37,0,Primeira_Liga,2023_2024
André André,POR,MF,Vitória,33,1989,7.3,9,4,3,5,1,6,10,60.0,4,9,1,8,4,13,7,0,Primeira_Liga,2023_2024
Andrew,BRA,GK,Gil Vicente FC,22,2001,32.0,0,0,0,0,0,0,0,,0,0,0,0,0,0,14,2,Primeira_Liga,2023_2024
Jeremy Antonisse,CUW,FW,Moreirense,21,2002,6.1,13,8,8,5,0,8,20,40.0,12,8,1,7,5,18,9,0,Primeira_Liga,2023_2024
Pedro Aparício,POR,"MF,FW",Moreirense,27,1995,3.7,2,1,1,1,0,1,6,16.7,5,0,0,0,1,3,3,0,Primeira_Liga,2023_2024
Óscar Aranda,ESP,"FW,MF",Famalicão,21,2002,8.0,7,4,1,4,2,2,10,20.0,8,6,2,4,1,8,1,0,Primeira_Liga,2023_2024
Henrique Araújo,POR,FW,Famalicão,21,2002,7.6,3,1,0,3,0,1,3,33.3,2,3,1,2,1,4,3,0,Primeira_Liga,2023_2024
Tiago Araújo,POR,"DF,MF",Estoril,22,2001,25.0,34,22,17,14,3,21,48,43.8,27,23,0,23,27,61,67,1,Primeira_Liga,2023_2024
Tomás Araújo,POR,DF,Benfica,21,2002,5.4,12,9,4,3,5,5,8,62.5,3,10,4,6,8,20,18,0,Primeira_Liga,2023_2024
Gustavo Assuncao,POR,MF,Famalicão,23,2000,7.0,17,12,11,6,0,10,20,50.0,10,8,2,6,9,26,16,1,Primeira_Liga,2023_2024
Otavio Ataide,BRA,DF,Famalicão,21,2002,15.4,31,21,24,5,2,20,31,64.5,11,33,21,12,25,56,66,0,Primeira_Liga,2023_2024
Otavio Ataide,BRA,DF,Porto,21,2002,12.0,11,6,9,1,1,9,15,60.0,6,10,6,4,7,18,29,0,Primeira_Liga,2023_2024
Fredrik Aursnes,NOR,DF,Benfica,27,1995,31.0,73,43,32,32,9,49,84,58.3,35,41,8,33,18,91,43,0,Primeira_Liga,2023_2024
Chidozie Awaziem,NGA,DF,Boavista,26,1997,21.7,23,18,18,3,2,13,21,61.9,8,27,17,10,18,41,98,2,Primeira_Liga,2023_2024
Abdul Awudu,GHA,"FW,MF",Vizela,22,2001,2.1,4,3,1,1,2,2,7,28.6,5,2,1,1,0,4,1,0,Primeira_Liga,2023_2024
Amadou Ba-Sy,FRA,"FW,MF",Vizela,22,2001,1.3,1,1,0,1,0,0,1,0.0,1,2,1,1,1,2,0,0,Primeira_Liga,2023_2024
Alexander Bah,DEN,DF,Benfica,25,1997,16.9,52,35,23,19,10,30,44,68.2,14,24,4,20,32,84,28,1,Primeira_Liga,2023_2024
Elves Baldé,GNB,"FW,MF",Farense,23,1999,10.8,9,5,6,2,1,6,17,35.3,11,11,2,9,1,10,12,0,Primeira_Liga,2023_2024
Robson Bambu,BRA,DF,Arouca,25,1997,9.8,15,12,9,6,0,7,11,63.6,4,12,8,4,9,24,35,0,Primeira_Liga,2023_2024
Daniel Bandeira,POR,MF,Vitória,23,2000,7.8,8,6,3,3,2,3,7,42.9,4,6,0,6,11,19,11,0,Primeira_Liga,2023_2024
Simon Banza,COD,FW,Braga,26,1996,22.2,11,6,4,2,5,1,10,10.0,9,16,1,15,8,19,14,0,Primeira_Liga,2023_2024
Rafael Barbosa,POR,"MF,FW",Farense,27,1996,9.5,12,9,5,4,3,6,11,54.5,5,8,4,4,4,16,3,0,Primeira_Liga,2023_2024
Romário Baró,POR,"MF,FW",Porto,23,2000,2.5,2,2,1,1,0,1,6,16.7,5,0,0,0,1,3,4,0,Primeira_Liga,2023_2024
Afonso Bastardo,POR,"FW,DF",Gil Vicente FC,18,2005,0.5,1,1,0,0,1,0,1,0.0,1,1,0,1,1,2,0,0,Primeira_Liga,2023_2024
Afonso Bastardo,POR,MF,Sporting CP,18,2005,0.3,1,1,1,0,0,1,2,50.0,1,1,0,1,0,1,1,0,Primeira_Liga,2023_2024
Gilberto Batista,GNB,DF,Moreirense,19,2003,2.5,3,2,3,0,0,2,4,50.0,2,5,5,0,1,4,19,1,Primeira_Liga,2023_2024
Ricardo Batista,POR,GK,Casa Pia,36,1986,30.9,1,0,1,0,0,1,3,33.3,2,0,0,0,0,1,6,1,Primeira_Liga,2023_2024
Roko Baturina,CRO,FW,Gil Vicente FC,23,2000,7.9,1,1,0,0,1,0,3,0.0,3,2,0,2,0,1,5,0,Primeira_Liga,2023_2024
Bachir Belloumi,ALG,"FW,MF",Farense,21,2002,23.0,41,28,19,17,5,17,41,41.5,24,38,6,32,21,62,32,0,Primeira_Liga,2023_2024
Fahem Benaissa Yahia,FRA,MF,Casa Pia,21,2002,0.1,0,0,0,0,0,0,1,0.0,1,0,0,0,0,0,0,0,Primeira_Liga,2023_2024
Beni,ANG,MF,Casa Pia,21,2002,16.3,32,24,17,15,0,13,28,46.4,15,17,2,15,19,51,18,1,Primeira_Liga,2023_2024
Benny,POR,"MF,FW",Chaves,23,2000,14.1,10,3,4,4,2,3,14,21.4,11,18,0,18,6,16,17,0,Primeira_Liga,2023_2024
Berna,ANG,"FW,DF",Boavista,19,2003,3.6,15,11,8,5,2,5,10,50.0,5,5,2,3,5,20,4,0,Primeira_Liga,2023_2024
Juan Bernat,ESP,DF,Benfica,30,1993,0.9,0,0,0,0,0,0,2,0.0,2,2,0,2,0,0,3,0,Primeira_Liga,2023_2024
Emmanuel Boateng,GHA,FW,Rio Ave,27,1996,20.7,12,9,4,6,2,3,7,42.9,4,11,3,8,5,17,16,0,Primeira_Liga,2023_2024
Kiko Bondoso,POR,"FW,MF",Vizela,27,1995,2.1,5,3,1,2,2,4,6,66.7,2,2,0,2,1,6,2,0,Primeira_Liga,2023_2024
Toni Borevkovic,CRO,DF,Vitória,26,1997,22.7,22,14,20,2,0,22,28,78.6,6,25,11,14,36,58,108,0,Primeira_Liga,2023_2024
Gonçalo Borges,POR,"MF,FW",Porto,22,2001,3.2,7,4,6,1,0,4,8,50.0,4,3,0,3,0,7,4,0,Primeira_Liga,2023_2024
Cristian Borja,COL,DF,Braga,30,1993,27.2,61,33,36,23,2,23,42,54.8,19,25,5,20,22,83,55,0,Primeira_Liga,2023_2024
Róbert Boženík,SVK,FW,Boavista,23,1999,28.6,16,10,0,12,4,5,16,31.3,11,12,1,11,4,20,34,0,Primeira_Liga,2023_2024
Daniel Bragança,POR,MF,Sporting CP,24,1999,11.4,33,22,9,15,9,14,26,53.8,12,11,2,9,19,52,4,2,Primeira_Liga,2023_2024
Bruno Brigido,BRA,GK,Estrela,32,1991,26.0,2,2,2,0,0,2,4,50.0,2,1,0,1,0,2,18,0,Primeira_Liga,2023_2024
Rafael Brito,POR,MF,Casa Pia,21,2002,3.8,12,8,4,5,3,4,12,33.3,8,3,1,2,5,17,8,0,Primeira_Liga,2023_2024
Bruma,POR,"FW,MF",Braga,28,1994,19.1,22,12,6,12,4,8,27,29.6,19,13,1,12,6,28,4,0,Primeira_Liga,2023_2024
Jonathan Buatu Mananga,ANG,DF,Gil Vicente FC,29,1993,5.0,8,4,8,0,0,5,5,100.0,0,7,3,4,1,9,23,0,Primeira_Liga,2023_2024
Leonel Bucca,ARG,"MF,FW",Estrela,24,1999,9.1,36,23,15,14,7,21,39,53.8,18,11,2,9,4,40,5,0,Primeira_Liga,2023_2024
André Bukia,COD,"MF,FW",Arouca,28,1995,1.7,5,4,3,1,1,3,6,50.0,3,3,0,3,1,6,1,0,Primeira_Liga,2023_2024
Fabijan Buntić,CRO,GK,Vizela,26,1997,27.7,0,0,0,0,0,0,0,,0,1,0,1,0,0,18,0,Primeira_Liga,2023_2024
Aleksandar Busnić,SRB,"MF,FW",Vizela,25,1997,8.5,21,12,10,9,2,10,20,50.0,10,13,4,9,6,27,23,0,Primeira_Liga,2023_2024
Oriol Busquets,ESP,MF,Arouca,24,1999,4.8,9,5,5,3,1,3,4,75.0,1,5,3,2,2,11,10,0,Primeira_Liga,2023_2024
Rafael Bustamante,COL,MF,Vizela,23,1999,7.9,16,9,10,5,1,7,25,28.0,18,17,3,14,12,28,7,0,Primeira_Liga,2023_2024
Leonardo Buta,POR,DF,Gil Vicente FC,21,2002,24.3,48,30,28,15,5,33,46,71.7,13,21,8,13,28,76,65,1,Primeira_Liga,2023_2024
Adrián Butzke,ESP,FW,Vitória,24,1999,4.1,3,3,0,3,0,1,2,50.0,1,4,1,3,0,3,8,0,Primeira_Liga,2023_2024
Erick Cabaco,URU,DF,Estoril,28,1995,3.7,5,4,3,2,0,1,3,33.3,2,4,3,1,7,12,16,0,Primeira_Liga,2023_2024
Arthur Cabral,BRA,FW,Benfica,25,1998,14.8,11,7,2,5,4,3,9,33.3,6,8,0,8,1,12,7,0,Primeira_Liga,2023_2024
Jhonder Cádiz,VEN,FW,Famalicão,28,1995,25.6,10,7,1,6,3,2,9,22.2,7,4,2,2,1,11,21,0,Primeira_Liga,2023_2024
João Pedro Gomes Camacho,POR,"FW,MF",Moreirense,29,1994,23.1,37,25,13,14,10,15,28,53.6,13,23,2,21,14,51,16,0,Primeira_Liga,2023_2024
Ibrahima Camará,GUI,"MF,DF",Boavista,24,1999,5.3,4,4,2,1,1,3,6,50.0,3,4,1,3,4,8,18,0,Primeira_Liga,2023_2024
Cambila,ANG,GK,Estrela,21,2002,0.2,0,0,0,0,0,0,0,,0,0,0,0,0,0,1,1,Primeira_Liga,2023_2024
Luan Campos,BRA,"FW,MF",Portimonense,21,2002,5.2,7,5,2,4,1,4,8,50.0,4,4,1,3,5,12,6,0,Primeira_Liga,2023_2024
Fábio Cardoso,POR,DF,Porto,29,1994,13.4,5,3,1,4,0,0,2,0.0,2,12,8,4,12,17,37,0,Primeira_Liga,2023_2024
Felippe Cardoso,BRA,FW,Casa Pia,24,1998,17.4,14,8,1,7,6,3,13,23.1,10,7,1,6,1,15,7,0,Primeira_Liga,2023_2024
Carlinhos,BRA,MF,Portimonense,29,1994,31.6,44,27,14,24,6,23,44,52.3,21,12,2,10,8,52,24,2,Primeira_Liga,2023_2024
João Carlos,BRA,"FW,DF",Estoril,28,1995,3.5,2,1,1,1,0,0,2,0.0,2,4,0,4,1,3,2,0,Primeira_Liga,2023_2024
Zé Carlos,POR,"MF,DF",Vitória,21,2001,4.7,10,5,5,5,0,6,18,33.3,12,6,1,5,6,16,7,0,Primeira_Liga,2023_2024
Zé Carlos,POR,DF,Gil Vicente FC,25,1998,21.4,50,34,34,9,7,20,37,54.1,17,21,6,15,30,80,56,2,Primeira_Liga,2023_2024
David Carmo,ANG,DF,Porto,24,1999,6.8,5,4,2,2,1,4,5,80.0,1,11,7,4,2,7,31,1,Primeira_Liga,2023_2024
Marcelo Carné,BRA,GK,Estoril,33,1990,22.0,1,1,1,0,0,1,2,50.0,1,0,0,0,0,1,8,4,Primeira_Liga,2023_2024
Carraça,POR,"DF,MF",Chaves,30,1993,11.1,9,5,3,6,0,6,11,54.5,5,7,0,7,7,16,23,0,Primeira_Liga,2023_2024
Álvaro Carreras,ESP,DF,Benfica,20,2003,6.3,18,10,7,9,2,8,12,66.7,4,8,3,5,10,28,9,0,Primeira_Liga,2023_2024
Ronie Carrillo,ECU,"FW,MF",Portimonense,26,1996,14.6,9,4,1,5,3,2,7,28.6,5,13,1,12,3,12,19,0,Primeira_Liga,2023_2024
António Filipe de Carvalho,POR,GK,Estrela,38,1985,3.0,0,0,0,0,0,0,0,,0,0,0,0,0,0,1,0,Primeira_Liga,2023_2024
Miguel Carvalho,POR,GK,Farense,27,1996,2.0,0,0,0,0,0,0,0,,0,0,0,0,0,0,1,0,Primeira_Liga,2023_2024
Vitor Carvalho,BRA,MF,Braga,26,1997,14.5,41,22,21,19,1,22,37,59.5,15,22,4,18,18,59,29,1,Primeira_Liga,2023_2024
Facundo Cáseres,ARG,MF,Farense,22,2001,12.4,49,25,27,20,2,21,33,63.6,12,35,14,21,11,60,17,0,Primeira_Liga,2023_2024
Midana Cassama,GNB,"FW,MF",Portimonense,20,2002,3.2,4,3,1,2,1,2,3,66.7,1,2,1,1,2,6,2,0,Primeira_Liga,2023_2024
Cassiano,BRA,FW,Estoril,34,1989,17.9,31,20,10,13,8,13,30,43.3,17,16,2,14,0,31,11,0,Primeira_Liga,2023_2024
Jesús Castillo,PER,MF,Gil Vicente FC,22,2001,2.7,6,5,1,4,1,4,9,44.4,5,4,1,3,4,10,8,0,Primeira_Liga,2023_2024
André Castro,POR,MF,Braga,35,1988,0.5,1,0,0,1,0,1,4,25.0,3,4,1,3,1,2,1,0,Primeira_Liga,2023_2024
André Castro,POR,MF,Moreirense,35,1988,6.0,15,10,6,7,2,10,17,58.8,7,6,0,6,6,21,15,0,Primeira_Liga,2023_2024
Cristian Castro,COL,DF,Rio Ave,22,2001,0.8,0,0,0,0,0,0,2,0.0,2,1,1,0,1,1,8,0,Primeira_Liga,2023_2024
Geny Catamo,MOZ,"MF,DF",Sporting CP,22,2001,18.7,25,17,12,5,8,15,33,45.5,18,19,1,18,12,37,15,0,Primeira_Liga,2023_2024
Tidjany Chabrol,FRA,"FW,MF",Gil Vicente FC,21,2002,12.0,13,8,3,9,1,5,17,29.4,12,14,2,12,3,16,8,1,Primeira_Liga,2023_2024
Charles,BRA,GK,Vitória,29,1994,7.5,0,0,0,0,0,0,1,0.0,1,0,0,0,0,0,6,0,Primeira_Liga,2023_2024
Chiquinho,POR,"FW,MF",Famalicão,23,2000,19.3,31,18,13,15,3,12,31,38.7,19,43,4,39,13,44,10,0,Primeira_Liga,2023_2024
Chiquinho,POR,MF,Benfica,28,1995,2.1,5,4,1,4,0,1,3,33.3,2,1,0,1,2,7,3,0,Primeira_Liga,2023_2024
Clayton,BRA,FW,Casa Pia,24,1999,18.8,9,7,1,3,5,1,14,7.1,13,13,2,11,3,12,12,0,Primeira_Liga,2023_2024
Sebastián Coates,URU,DF,Sporting CP,32,1990,25.3,38,19,23,14,1,24,36,66.7,12,28,19,9,24,62,81,1,Primeira_Liga,2023_2024
Fábio Conceição,POR,"MF,FW",Rio Ave,22,2001,28.2,36,24,25,7,4,22,52,42.3,30,35,5,30,17,53,35,0,Primeira_Liga,2023_2024
Francisco Conceição,POR,"FW,MF",Porto,20,2002,21.0,40,31,9,15,16,16,30,53.3,14,14,1,13,2,42,4,1,Primeira_Liga,2023_2024
Leo Cordeiro,BRA,MF,Estrela,27,1995,29.0,60,40,23,30,7,32,64,50.0,32,36,8,28,19,79,20,0,Primeira_Liga,2023_2024
Jeriel Córdova,VEN,FW,Boavista,21,2002,1.7,0,0,0,0,0,0,2,0.0,2,1,0,1,0,0,1,0,Primeira_Liga,2023_2024
Félix Correia,POR,FW,Gil Vicente FC,22,2001,24.1,31,22,11,11,9,21,29,72.4,8,28,2,26,21,52,16,2,Primeira_Liga,2023_2024
João Pedro Araújo Correia,CPV,"DF,MF",Chaves,26,1996,23.3,19,12,10,7,2,12,41,29.3,29,21,8,13,31,50,44,1,Primeira_Liga,2023_2024
Alberto costa,POR,DF,Vitória,19,2003,0.2,0,0,0,0,0,0,0,,0,0,0,0,0,0,0,0,Primeira_Liga,2023_2024
Bruno Xavier Almeida Costa,POR,MF,Vizela,26,1997,6.8,3,1,1,1,1,2,9,22.2,7,4,1,3,10,13,5,0,Primeira_Liga,2023_2024
Diogo Costa,POR,GK,Porto,23,1999,32.7,0,0,0,0,0,0,0,,0,0,0,0,0,0,17,2,Primeira_Liga,2023_2024
Gonçalo Costa,POR,"DF,MF",Portimonense,23,2000,19.0,59,38,32,22,5,33,48,68.8,15,27,3,24,27,86,46,1,Primeira_Liga,2023_2024
Michel Costa,BRA,MF,Estoril,21,2001,3.3,10,4,5,3,2,6,10,60.0,4,4,0,4,2,12,6,0,Primeira_Liga,2023_2024
Murilo Costa,BRA,FW,Gil Vicente FC,28,1994,22.1,21,15,9,12,0,10,20,50.0,10,16,0,16,16,37,13,0,Primeira_Liga,2023_2024
Rui Costa,POR,"FW,MF",Farense,27,1996,7.8,3,2,2,1,0,3,5,60.0,2,7,1,6,0,3,2,0,Primeira_Liga,2023_2024
Tomás Costa Silva,POR,DF,Vizela,23,1999,29.1,74,50,42,24,8,45,79,57.0,34,33,8,25,41,115,102,1,Primeira_Liga,2023_2024
Costinha,POR,"MF,DF",Rio Ave,23,2000,33.9,95,60,41,43,11,55,104,52.9,49,88,12,76,40,135,92,3,Primeira_Liga,2023_2024
Sandro Cruz,ANG,"DF,MF",Chaves,22,2001,18.1,34,23,23,10,1,22,35,62.9,13,23,8,15,20,54,70,2,Primeira_Liga,2023_2024
Florian Danho Seke,FRA,FW,Famalicão,23,2000,2.7,3,3,1,0,2,2,2,100.0,0,5,0,5,0,3,3,0,Primeira_Liga,2023_2024
Ignacio De Arruabarrena,URU,GK,Arouca,26,1997,31.0,3,2,3,0,0,3,6,50.0,3,0,0,0,1,4,23,3,Primeira_Liga,2023_2024
Fran Delgado,ESP,DF,Farense,22,2001,5.5,7,2,3,3,1,4,6,66.7,2,9,2,7,2,9,8,0,Primeira_Liga,2023_2024
Dener,BRA,MF,Portimonense,31,1992,19.6,51,31,26,21,4,22,47,46.8,25,16,4,12,26,77,43,0,Primeira_Liga,2023_2024
Depú,ANG,FW,Gil Vicente FC,23,2000,8.6,5,4,2,1,2,2,5,40.0,3,3,0,3,2,7,4,0,Primeira_Liga,2023_2024
Ángel Di María,ARG,FW,Benfica,35,1988,24.6,20,12,9,8,3,7,32,21.9,25,26,0,26,8,28,3,1,Primeira_Liga,2023_2024
Tiago Dias,POR,"MF,FW",Casa Pia,25,1998,8.8,8,7,4,3,1,4,14,28.6,10,15,1,14,5,13,4,0,Primeira_Liga,2023_2024
Vinicius Dias,BRA,GK,Gil Vicente FC,26,1997,2.0,0,0,0,0,0,0,0,,0,0,0,0,0,0,0,1,Primeira_Liga,2023_2024
Dida,BRA,GK,Estrela,25,1998,4.7,0,0,0,0,0,0,0,,0,1,0,1,0,0,5,0,Primeira_Liga,2023_2024
Ousmane Diomande,CIV,DF,Sporting CP,19,2003,23.5,41,24,23,14,4,17,22,77.3,5,11,7,4,13,54,43,1,Primeira_Liga,2023_2024
Álvaro djaló,ESP,"FW,MF",Braga,23,1999,19.9,27,19,7,14,6,15,45,33.3,30,17,1,16,23,50,15,0,Primeira_Liga,2023_2024
Mihai Dobre,ROU,FW,Famalicão,24,1998,3.9,5,3,4,0,1,3,12,25.0,9,4,0,4,3,8,5,0,Primeira_Liga,2023_2024
Maxime Dominguez,SUI,"MF,FW",Gil Vicente FC,27,1996,25.9,46,26,16,25,5,28,68,41.2,40,51,4,47,28,74,6,2,Primeira_Liga,2023_2024
Bruno Duarte,BRA,FW,Farense,27,1996,25.1,15,9,1,11,3,8,27,29.6,19,24,5,19,7,22,27,0,Primeira_Liga,2023_2024
Jorge Eduardo Sánchez,MEX,DF,Porto,25,1997,6.3,19,13,12,5,2,15,23,65.2,8,5,0,5,7,26,7,0,Primeira_Liga,2023_2024
Marcus Edwards,ENG,"FW,MF",Sporting CP,24,1998,14.9,10,7,2,6,2,1,8,12.5,7,8,0,8,6,16,2,0,Primeira_Liga,2023_2024
Úmaro Embaló,POR,"MF,FW",Rio Ave,22,2001,8.8,10,4,3,6,1,0,7,0.0,7,9,0,9,3,13,9,0,Primeira_Liga,2023_2024
João Escoval,POR,DF,Vizela,26,1997,15.2,25,10,20,4,1,10,17,58.8,7,14,9,5,14,39,55,1,Primeira_Liga,2023_2024
Ricardo Esgaio,POR,"MF,DF",Sporting CP,30,1993,16.6,44,22,19,18,7,22,42,52.4,20,14,2,12,7,51,35,0,Primeira_Liga,2023_2024
Tiago Esgaio,POR,DF,Arouca,27,1995,25.3,61,37,37,20,4,42,68,61.8,26,36,9,27,34,95,72,0,Primeira_Liga,2023_2024
Samuel Essende,COD,FW,Vizela,25,1998,29.6,9,7,1,5,3,4,9,44.4,5,21,8,13,3,12,17,0,Primeira_Liga,2023_2024
Dario Essugo,POR,MF,Chaves,18,2005,12.9,29,19,15,11,3,16,25,64.0,9,21,3,18,21,50,32,0,Primeira_Liga,2023_2024
Dario Essugo,POR,MF,Sporting CP,18,2005,0.4,2,2,0,2,0,1,1,100.0,0,0,0,0,0,2,0,0,Primeira_Liga,2023_2024
Paulo Estrela Moreira,POR,"MF,FW",Portimonense,24,1999,5.9,14,7,6,7,1,4,15,26.7,11,11,1,10,7,21,10,0,Primeira_Liga,2023_2024
Stephen Eustáquio,CAN,MF,Porto,26,1996,17.0,41,27,16,19,6,19,35,54.3,16,28,5,23,18,59,25,0,Primeira_Liga,2023_2024
Evanilson,BRA,FW,Porto,23,1999,22.8,19,11,2,9,8,7,13,53.8,6,15,1,14,3,22,8,0,Primeira_Liga,2023_2024
Fabiano,BRA,DF,Moreirense,23,2000,23.7,45,30,27,11,7,25,35,71.4,10,13,2,11,29,74,60,1,Primeira_Liga,2023_2024
Claudio Falcão,BRA,MF,Farense,29,1994,28.9,78,45,33,44,1,29,82,35.4,53,48,17,31,40,118,128,1,Primeira_Liga,2023_2024
Jean Felipe,BRA,"MF,DF",Estrela,29,1994,12.8,24,18,9,13,2,18,30,60.0,12,11,1,10,10,34,21,0,Primeira_Liga,2023_2024
Volnei Feltes,BRA,DF,Estoril,23,2000,16.4,19,15,10,9,0,8,24,33.3,16,21,14,7,21,40,55,2,Primeira_Liga,2023_2024
Jorge Filipe Oliveira Fernandes,POR,DF,Vitória,26,1997,27.1,52,39,29,22,1,38,68,55.9,30,35,11,24,26,78,115,0,Primeira_Liga,2023_2024
Martim Fernandes,POR,DF,Porto,17,2006,2.8,10,6,6,3,1,6,7,85.7,1,2,0,2,5,15,7,0,Primeira_Liga,2023_2024
Mateus Fernandes,POR,MF,Estoril,19,2004,24.8,79,46,28,40,11,39,78,50.0,39,44,6,38,25,104,16,2,Primeira_Liga,2023_2024
Mateus Fernandes,POR,FW,Sporting CP,19,2004,0.0,0,0,0,0,0,0,0,,0,0,0,0,0,0,0,0,Primeira_Liga,2023_2024
Rafael Fernandes,POR,DF,Arouca,21,2002,8.3,12,8,8,2,2,6,7,85.7,1,6,5,1,9,21,31,0,Primeira_Liga,2023_2024
Roger Fernandes,GNB,"MF,FW",Braga,17,2005,7.5,16,11,3,10,3,9,20,45.0,11,10,0,10,4,20,3,0,Primeira_Liga,2023_2024
Rúben Fernandes,POR,DF,Gil Vicente FC,37,1986,29.0,18,11,15,3,0,9,21,42.9,12,33,19,14,35,53,117,1,Primeira_Liga,2023_2024
Vasco Fernandes,POR,DF,Casa Pia,36,1986,10.0,8,5,7,1,0,5,9,55.6,4,13,6,7,10,18,29,0,Primeira_Liga,2023_2024
Vasco Fernandes,POR,DF,Chaves,36,1986,16.8,26,14,18,7,1,17,25,68.0,8,17,9,8,9,35,68,1,Primeira_Liga,2023_2024
Fernando,BRA,"FW,MF",Casa Pia,30,1993,6.0,10,6,4,3,3,3,8,37.5,5,6,0,6,0,10,2,0,Primeira_Liga,2023_2024
Filipe Ferreira,POR,DF,Boavista,32,1990,19.2,31,22,16,15,0,19,26,73.1,7,21,8,13,18,49,47,1,Primeira_Liga,2023_2024
Marcelo dos Santos Ferreira,BRA,DF,Moreirense,34,1989,26.0,36,20,28,8,0,18,31,58.1,13,39,27,12,28,64,142,0,Primeira_Liga,2023_2024
Vitó Ferreira,POR,MF,Estrela,25,1997,6.4,12,7,5,7,0,7,24,29.2,17,6,0,6,4,16,9,0,Primeira_Liga,2023_2024
Daniel Figueira,POR,GK,Estoril,25,1998,12.0,3,2,3,0,0,3,3,100.0,0,0,0,0,0,3,9,0,Primeira_Liga,2023_2024
Diogo Fonseca,POR,DF,Estrela,21,2002,4.8,6,4,3,3,0,2,3,66.7,1,3,1,2,4,10,15,0,Primeira_Liga,2023_2024
Tiago Fonseca Morais,POR,"FW,MF",Boavista,19,2003,15.3,23,17,14,6,3,12,38,31.6,26,21,1,20,10,33,7,0,Primeira_Liga,2023_2024
Théo Fonseca,FRA,FW,Famalicão,23,2000,7.2,10,3,5,3,2,3,6,50.0,3,7,2,5,7,17,7,0,Primeira_Liga,2023_2024
José Fonte,POR,DF,Braga,39,1983,16.8,8,3,6,2,0,3,8,37.5,5,18,13,5,20,28,70,0,Primeira_Liga,2023_2024
Hernâni Fortes,POR,FW,Rio Ave,31,1991,3.8,0,0,0,0,0,0,4,0.0,4,1,1,0,1,1,1,0,Primeira_Liga,2023_2024
André Franco,POR,"MF,FW",Porto,25,1998,4.9,6,5,3,3,0,4,11,36.4,7,1,0,1,4,10,5,0,Primeira_Liga,2023_2024
Gonçalo Franco,POR,MF,Moreirense,22,2000,30.2,81,54,38,33,10,29,75,38.7,46,57,5,52,59,140,52,0,Primeira_Liga,2023_2024
Afonso freitas,POR,"DF,MF",Vitória,23,2000,8.1,16,11,8,5,3,8,12,66.7,4,5,0,5,4,20,15,0,Primeira_Liga,2023_2024
Iván Fresneda,ESP,"MF,DF",Sporting CP,18,2004,0.4,4,2,3,1,0,2,3,66.7,1,1,0,1,0,4,2,0,Primeira_Liga,2023_2024
Godfried Frimpong,NED,DF,Moreirense,24,1999,22.4,35,22,26,7,2,21,29,72.4,8,21,5,16,39,74,81,0,Primeira_Liga,2023_2024
Kanya Fujimoto,JPN,MF,Gil Vicente FC,24,1999,22.2,26,15,7,15,4,9,15,60.0,6,23,4,19,11,37,8,0,Primeira_Liga,2023_2024
Taichi Fukui,JPN,MF,Portimonense,19,2004,6.6,8,5,0,3,5,2,11,18.2,9,4,0,4,5,13,8,0,Primeira_Liga,2023_2024
Galeno,BRA,"FW,MF",Porto,25,1997,24.9,25,18,11,8,6,11,28,39.3,17,22,2,20,15,40,18,0,Primeira_Liga,2023_2024
Nino Galović,CRO,DF,Arouca,31,1992,16.0,10,6,6,2,2,7,17,41.2,10,10,7,3,16,26,68,0,Primeira_Liga,2023_2024
Fabrício Garcia,CPV,"FW,MF",Estoril,22,2001,3.7,13,10,6,4,3,7,10,70.0,3,5,0,5,1,14,3,0,Primeira_Liga,2023_2024
Gaspar,ANG,DF,Estrela,25,1997,26.1,53,36,29,20,4,32,41,78.0,9,35,19,16,40,93,146,2,Primeira_Liga,2023_2024
Bruno Gaspar,ANG,"MF,DF",Vitória,30,1993,25.4,37,23,21,10,6,19,32,59.4,13,35,4,31,17,54,32,1,Primeira_Liga,2023_2024
Mory Gbane,CIV,MF,Gil Vicente FC,22,2000,21.2,59,36,28,21,10,32,47,68.1,15,33,15,18,27,86,52,1,Primeira_Liga,2023_2024
André Geraldes,POR,"MF,DF",Casa Pia,32,1991,6.7,7,3,6,1,0,3,4,75.0,1,5,1,4,2,9,15,0,Primeira_Liga,2023_2024
Saviour Godwin,NGA,"FW,MF",Casa Pia,26,1996,3.8,5,3,3,1,1,0,1,0.0,1,7,0,7,4,9,0,0,Primeira_Liga,2023_2024
Eulânio Ângelo Chipela Gomes,GNB,MF,Estrela,29,1994,6.5,8,5,1,2,5,2,4,50.0,2,10,1,9,5,13,6,0,Primeira_Liga,2023_2024
Rodrigo Gomes,POR,"MF,DF",Estoril,20,2003,27.2,47,30,21,19,7,19,49,38.8,30,39,6,33,25,72,53,1,Primeira_Liga,2023_2024
Vítor Gomes,POR,MF,Rio Ave,35,1987,3.6,5,4,2,3,0,2,4,50.0,2,7,3,4,3,8,5,0,Primeira_Liga,2023_2024
Victor Gomez,ESP,DF,Braga,23,2000,22.6,41,27,18,17,6,31,49,63.3,18,22,6,16,26,67,62,1,Primeira_Liga,2023_2024
Nuno Gonçalo Moreira,POR,"FW,MF",Casa Pia,24,1999,11.3,21,12,4,13,4,8,21,38.1,13,12,1,11,9,30,7,0,Primeira_Liga,2023_2024
Nuno Gonçalo Moreira,POR,"FW,MF",Vizela,24,1999,10.7,14,9,6,7,1,4,14,28.6,10,14,2,12,10,24,8,1,Primeira_Liga,2023_2024
João Gonçalves,POR,GK,Boavista,22,2000,34.0,1,1,1,0,0,1,4,25.0,3,0,0,0,0,1,20,2,Primeira_Liga,2023_2024
Jota Gonçalves,POR,DF,Vizela,23,2000,16.1,17,8,11,5,1,9,22,40.9,13,18,11,7,21,38,97,1,Primeira_Liga,2023_2024
Pedro Gonçalves,POR,"FW,MF",Sporting CP,25,1998,28.6,47,30,10,23,14,20,55,36.4,35,31,2,29,10,57,4,0,Primeira_Liga,2023_2024
Vítor Gonçalves,POR,MF,Farense,31,1992,7.7,10,7,2,4,4,2,4,50.0,2,12,3,9,4,14,17,0,Primeira_Liga,2023_2024
Cristo González,ESP,"FW,MF",Arouca,25,1997,30.9,20,15,4,7,9,9,31,29.0,22,9,1,8,6,26,12,0,Primeira_Liga,2023_2024
Nicolás González,ESP,MF,Porto,21,2002,18.9,42,28,13,21,8,22,38,57.9,16,24,3,21,10,52,11,0,Primeira_Liga,2023_2024
Tiago Gouveia,POR,FW,Benfica,22,2001,6.0,12,7,3,4,5,8,14,57.1,6,7,0,7,1,13,0,0,Primeira_Liga,2023_2024
João Graça,POR,MF,Rio Ave,28,1995,13.3,38,25,13,18,7,20,44,45.5,24,8,3,5,9,47,9,0,Primeira_Liga,2023_2024
Marko Grujić,SRB,MF,Porto,27,1996,3.2,17,13,5,11,1,11,13,84.6,2,4,1,3,6,23,4,0,Primeira_Liga,2023_2024
Gonçalo Guedes,POR,"FW,MF",Benfica,26,1996,1.4,1,0,0,1,0,1,3,33.3,2,0,0,0,1,2,0,0,Primeira_Liga,2023_2024
Guga,POR,"DF,MF",Portimonense,19,2003,17.0,56,34,31,20,5,30,60,50.0,30,18,7,11,16,72,29,0,Primeira_Liga,2023_2024
Ricardo Guimarães,MOZ,MF,Chaves,27,1995,13.9,35,19,20,11,4,18,37,48.6,19,16,5,11,18,53,15,1,Primeira_Liga,2023_2024
Rafik Guitane,FRA,"FW,MF",Estoril,24,1999,30.1,18,9,5,10,3,5,18,27.8,13,18,1,17,7,25,3,0,Primeira_Liga,2023_2024
Raphael Guzzo,POR,"MF,FW",Chaves,28,1995,13.2,13,7,7,3,3,2,11,18.2,9,17,6,11,11,24,13,0,Primeira_Liga,2023_2024
Viktor Gyökeres,SWE,FW,Sporting CP,25,1998,32.4,16,11,3,5,8,3,6,50.0,3,13,1,12,5,21,22,0,Primeira_Liga,2023_2024
Justin de Haas,NED,DF,Famalicão,23,2000,17.8,23,16,17,6,0,11,21,52.4,10,16,12,4,24,47,80,1,Primeira_Liga,2023_2024
Yanis Hamache,ALG,DF,Arouca,24,1999,0.5,1,0,1,0,0,0,0,,0,2,1,1,0,1,1,0,Primeira_Liga,2023_2024
Tomás Händel,POR,MF,Vitória,22,2000,28.0,48,31,16,26,6,28,47,59.6,19,21,3,18,23,71,10,0,Primeira_Liga,2023_2024
Héctor,ESP,FW,Chaves,27,1995,28.8,11,8,3,5,3,5,17,29.4,12,14,3,11,5,16,18,0,Primeira_Liga,2023_2024
Gustavo Henrique,BRA,"DF,MF",Estrela,24,1999,1.4,2,2,2,0,0,2,3,66.7,1,2,0,2,0,2,2,0,Primeira_Liga,2023_2024
Morten Hjulmand,DEN,MF,Sporting CP,24,1999,24.3,60,37,24,28,8,25,43,58.1,18,27,5,22,20,80,25,0,Primeira_Liga,2023_2024
Jordan Holsgrove,SCO,MF,Estoril,23,1999,13.0,30,25,9,18,3,14,24,58.3,10,11,7,4,15,45,19,2,Primeira_Liga,2023_2024
André Horta,POR,MF,Braga,26,1996,6.1,12,8,2,4,6,8,15,53.3,7,12,1,11,1,13,5,0,Primeira_Liga,2023_2024
Ricardo Horta,POR,"FW,MF",Braga,28,1994,26.0,23,13,9,11,3,5,37,13.5,32,23,2,21,11,34,12,0,Primeira_Liga,2023_2024
André Inácio,BRA,"FW,MF",Estrela,21,2002,13.3,19,10,6,9,4,9,24,37.5,15,22,1,21,4,23,8,0,Primeira_Liga,2023_2024
Gonçalo Inácio,POR,DF,Sporting CP,21,2001,27.6,48,35,20,26,2,26,42,61.9,16,29,14,15,25,73,64,1,Primeira_Liga,2023_2024
Hernani Infande,POR,"FW,MF",Moreirense,22,2001,0.9,4,2,1,2,1,3,5,60.0,2,2,0,2,1,5,0,0,Primeira_Liga,2023_2024
Fabrício Isidoro,BRA,MF,Farense,31,1992,18.5,25,10,14,8,3,13,37,35.1,24,27,9,18,22,47,19,0,Primeira_Liga,2023_2024
Ismael,POR,MF,Moreirense,24,1999,6.2,6,1,1,4,1,2,8,25.0,6,8,4,4,7,13,14,0,Primeira_Liga,2023_2024
Franco Israel,URU,GK,Sporting CP,23,2000,10.0,0,0,0,0,0,0,0,,0,0,0,0,0,0,5,1,Primeira_Liga,2023_2024
Abass Issah,GHA,"MF,FW",Chaves,24,1998,3.4,1,0,0,0,1,1,4,25.0,3,2,0,2,0,1,0,0,Primeira_Liga,2023_2024
Léo Jabá,BRA,"FW,MF",Estrela,24,1998,24.7,35,23,12,14,9,11,23,47.8,12,23,2,21,12,47,17,0,Primeira_Liga,2023_2024
Ivan Jaime Pajuelo,ESP,"MF,FW",Porto,22,2000,6.3,11,7,2,5,4,3,8,37.5,5,5,1,4,2,13,2,0,Primeira_Liga,2023_2024
Jajá,BRA,"FW,MF",Casa Pia,22,2001,4.8,19,16,4,7,8,9,16,56.3,7,9,0,9,1,20,2,0,Primeira_Liga,2023_2024
Jardel,GNB,"FW,MF",Vizela,25,1997,2.1,2,1,1,1,0,1,2,50.0,1,0,0,0,2,4,2,0,Primeira_Liga,2023_2024
Jason,ESP,"FW,MF",Arouca,29,1994,28.5,22,17,5,10,7,9,39,23.1,30,29,3,26,12,34,8,0,Primeira_Liga,2023_2024
Sylvester Jasper,BUL,"FW,MF",Portimonense,21,2001,18.6,22,12,9,8,5,10,21,47.6,11,17,0,17,15,37,16,0,Primeira_Liga,2023_2024
Anderson Jesus,BRA,DF,Vizela,28,1995,27.7,33,26,29,4,0,19,35,54.3,16,36,28,8,23,56,124,3,Primeira_Liga,2023_2024
Jhonatan,BRA,GK,Rio Ave,32,1991,26.0,0,0,0,0,0,0,0,,0,0,0,0,1,1,16,3,Primeira_Liga,2023_2024
Jo,BRA,"FW,MF",Chaves,28,1995,11.3,10,6,1,5,4,4,11,36.4,7,6,1,5,1,11,13,0,Primeira_Liga,2023_2024
Joca,POR,"FW,MF",Rio Ave,27,1996,19.0,11,5,4,2,5,8,17,47.1,9,13,1,12,13,24,15,0,Primeira_Liga,2023_2024
Nemanja Jović,SRB,MF,Estoril,20,2002,0.2,0,0,0,0,0,0,1,0.0,1,0,0,0,0,0,0,0,Primeira_Liga,2023_2024
Luiz Lúcio Reis Júnior,BRA,GK,Famalicão,22,2001,33.0,1,0,1,0,0,1,3,33.3,2,1,0,1,1,2,28,2,Primeira_Liga,2023_2024
David Jurásek,CZE,DF,Benfica,22,2000,2.9,9,4,7,2,0,6,8,75.0,2,1,0,1,1,10,9,1,Primeira_Liga,2023_2024
Samuel Justo,POR,MF,Casa Pia,19,2004,6.7,9,6,4,4,1,6,14,42.9,8,7,1,6,4,13,13,0,Primeira_Liga,2023_2024
Kaio,BRA,FW,Vitória,19,2004,4.7,10,8,6,3,1,6,13,46.2,7,8,0,8,0,10,1,0,Primeira_Liga,2023_2024
Kazu,BRA,"DF,FW",Gil Vicente FC,23,2000,0.6,2,0,1,0,1,1,4,25.0,3,0,0,0,2,4,0,0,Primeira_Liga,2023_2024
Keliano,ANG,MF,Estrela,20,2003,1.3,5,3,1,4,0,3,4,75.0,1,6,4,2,4,9,6,1,Primeira_Liga,2023_2024
Kewin,BRA,GK,Moreirense,27,1995,29.8,1,1,1,0,0,0,0,,0,0,0,0,0,1,16,2,Primeira_Liga,2023_2024
Kikas,POR,"FW,MF",Estrela,24,1998,17.3,3,3,0,2,1,1,2,50.0,1,2,0,2,1,4,13,0,Primeira_Liga,2023_2024
Francisco Kiki,POR,MF,Casa Pia,25,1998,0.1,0,0,0,0,0,0,0,,0,0,0,0,0,0,0,0,Primeira_Liga,2023_2024
Kobamelo Kodisang,RSA,FW,Moreirense,23,1999,18.0,10,6,7,3,0,6,17,35.3,11,12,1,11,16,26,10,0,Primeira_Liga,2023_2024
Koba Koindredi,FRA,MF,Estoril,21,2001,6.3,14,5,11,2,1,7,14,50.0,7,5,1,4,11,25,6,0,Primeira_Liga,2023_2024
Koba Koindredi,FRA,MF,Sporting CP,21,2001,0.4,4,3,0,4,0,2,2,100.0,0,0,0,0,2,6,0,0,Primeira_Liga,2023_2024
Orkun Kökçü,TUR,MF,Benfica,22,2000,19.8,32,22,10,18,4,17,35,48.6,18,15,2,13,8,40,7,1,Primeira_Liga,2023_2024
Eboue Kouassi,CIV,MF,Arouca,25,1997,15.0,26,17,12,11,3,14,27,51.9,13,17,7,10,11,37,39,0,Primeira_Liga,2023_2024
Kevin Krygård,NOR,"MF,DF",Casa Pia,23,2000,0.7,4,1,3,1,0,1,6,16.7,5,3,1,2,3,7,0,0,Primeira_Liga,2023_2024
Matías Lacava,VEN,"FW,MF",Vizela,20,2002,14.8,33,19,18,8,7,14,30,46.7,16,15,0,15,6,39,3,0,Primeira_Liga,2023_2024
Tom Lacoux,FRA,MF,Famalicão,21,2002,4.0,12,8,7,4,1,7,11,63.6,4,9,4,5,6,18,2,0,Primeira_Liga,2023_2024
André Lacximicant,POR,"FW,MF",Casa Pia,22,2001,2.4,4,2,0,2,2,0,0,,0,2,0,2,0,4,1,0,Primeira_Liga,2023_2024
Rúben Lameiras,POR,"FW,MF",Casa Pia,28,1994,6.1,7,5,4,1,2,5,9,55.6,4,4,0,4,4,11,4,0,Primeira_Liga,2023_2024
Rúben Lameiras,POR,"FW,MF",Chaves,28,1994,2.3,2,1,0,2,0,0,0,,0,1,0,1,1,3,2,0,Primeira_Liga,2023_2024
Bruno Langa,MOZ,"DF,MF",Chaves,25,1997,11.9,22,14,8,12,2,8,18,44.4,10,9,2,7,18,40,27,1,Primeira_Liga,2023_2024
Larra,ESP,"DF,MF",Casa Pia,25,1997,27.9,46,36,27,14,5,26,45,57.8,19,28,6,22,43,89,69,0,Primeira_Liga,2023_2024
Yusuf Lawal,NGA,"FW,MF",Arouca,25,1998,2.6,4,2,2,2,0,0,2,0.0,2,4,0,4,3,7,2,0,Primeira_Liga,2023_2024
Orest Lebedenko,UKR,DF,Vizela,24,1998,16.1,35,20,18,16,1,18,29,62.1,11,24,7,17,23,58,58,0,Primeira_Liga,2023_2024
Leonardo Lelo,POR,"DF,MF",Casa Pia,23,2000,32.7,53,32,35,13,5,40,74,54.1,34,35,6,29,37,90,70,0,Primeira_Liga,2023_2024
Marcos Leonardo,BRA,FW,Benfica,20,2003,3.7,2,1,0,0,2,0,0,,0,3,0,3,0,2,1,0,Primeira_Liga,2023_2024
Otso Liimatta,FIN,"MF,FW",Famalicão,19,2004,5.2,6,3,3,2,1,3,9,33.3,6,2,0,2,3,9,0,0,Primeira_Liga,2023_2024
Rúben Lima,POR,"DF,MF",Estrela,33,1989,10.3,14,8,7,6,1,4,11,36.4,7,12,1,11,8,22,36,0,Primeira_Liga,2023_2024
Danny Loader,ENG,"FW,MF",Porto,22,2000,2.7,4,2,0,4,0,1,3,33.3,2,5,0,5,0,4,2,0,Primeira_Liga,2023_2024
Jason Lokilo,BEL,"FW,MF",Vizela,24,1998,7.8,4,3,2,2,0,2,6,33.3,4,3,0,3,0,4,7,0,Primeira_Liga,2023_2024
Julien Lomboto,nan,MF,Rio Ave,21,2002,0.1,0,0,0,0,0,0,0,,0,1,1,0,0,0,2,0,Primeira_Liga,2023_2024
Miguel Lopes,POR,DF,Estrela,36,1986,14.7,34,24,18,16,0,22,30,73.3,8,21,13,8,18,52,45,1,Primeira_Liga,2023_2024
Né lopes,POR,DF,Gil Vicente FC,23,2000,2.9,4,3,2,1,1,3,3,100.0,0,3,1,2,4,8,12,0,Primeira_Liga,2023_2024
Rony Lopes,POR,"FW,MF",Braga,27,1995,4.1,6,6,1,2,3,3,4,75.0,1,3,1,2,2,8,4,0,Primeira_Liga,2023_2024
Bruno Lourenço,POR,"FW,MF",Boavista,25,1998,22.4,30,15,5,18,7,12,38,31.6,26,11,0,11,15,45,15,0,Primeira_Liga,2023_2024
Thomas Luciano,BRA,DF,Gil Vicente FC,21,2002,0.3,3,1,0,1,2,1,1,100.0,0,1,0,1,0,3,1,0,Primeira_Liga,2023_2024
André Luis,BRA,FW,Moreirense,29,1994,14.8,8,6,2,4,2,4,10,40.0,6,11,3,8,6,14,24,0,Primeira_Liga,2023_2024
Florentino Luís,POR,MF,Benfica,23,1999,18.7,79,45,26,43,10,39,75,52.0,36,36,5,31,49,128,13,0,Primeira_Liga,2023_2024
José Luis Rodríguez,PAN,FW,Famalicão,25,1998,16.6,20,14,12,5,3,16,30,53.3,14,13,3,10,10,30,16,0,Primeira_Liga,2023_2024
Zé Luís,CPV,"FW,MF",Farense,32,1991,6.6,3,3,0,1,2,1,3,33.3,2,9,3,6,1,4,4,0,Primeira_Liga,2023_2024
Luismi,EQG,FW,Moreirense,22,2001,10.4,20,11,7,10,3,7,19,36.8,12,22,3,19,4,24,10,0,Primeira_Liga,2023_2024
Wallisson Luiz,BRA,"MF,FW",Moreirense,25,1997,2.2,13,7,4,5,4,6,10,60.0,4,3,1,2,6,19,11,0,Primeira_Liga,2023_2024
Rodrigo Macedo,POR,"FW,MF",Moreirense,20,2003,0.7,4,2,1,2,1,2,3,66.7,1,1,0,1,0,4,0,0,Primeira_Liga,2023_2024
Tiago Machado,POR,"MF,FW",Boavista,19,2004,0.2,0,0,0,0,0,0,0,,0,0,0,0,0,0,0,0,Primeira_Liga,2023_2024
Madson,BRA,"FW,MF",Moreirense,23,1999,14.9,6,4,2,3,1,1,9,11.1,8,17,0,17,11,17,18,0,Primeira_Liga,2023_2024
Miguel Maga,POR,"DF,MF",Vitória,20,2002,9.9,30,19,17,11,2,21,31,67.7,10,10,2,8,14,44,25,1,Primeira_Liga,2023_2024
Magrão,BRA,GK,Rio Ave,23,2000,7.0,2,1,2,0,0,2,2,100.0,0,0,0,0,0,2,2,1,Primeira_Liga,2023_2024
Gaius Makouta,CGO,MF,Boavista,26,1997,25.9,29,22,11,17,1,14,23,60.9,9,21,2,19,20,49,34,0,Primeira_Liga,2023_2024
Pedro Malheiro,POR,"DF,MF",Boavista,22,2001,21.9,58,33,34,21,3,36,57,63.2,21,27,8,19,24,82,48,1,Primeira_Liga,2023_2024
Eliaquim Mangala,FRA,DF,Estoril,32,1991,11.6,15,7,9,5,1,8,11,72.7,3,11,9,2,21,36,40,1,Primeira_Liga,2023_2024
Ricardo Mangas,POR,"MF,DF",Vitória,25,1998,21.2,25,17,16,7,2,14,27,51.9,13,15,3,12,14,39,27,0,Primeira_Liga,2023_2024
Mansur,BRA,DF,Estrela,30,1993,15.6,27,19,23,4,0,14,18,77.8,4,17,10,7,13,40,43,1,Primeira_Liga,2023_2024
Manuel Manu,POR,"DF,MF",Vitória,22,2001,19.7,50,33,37,12,1,27,50,54.0,23,23,13,10,22,72,78,3,Primeira_Liga,2023_2024
Zé Manuel,POR,"FW,MF",Rio Ave,32,1990,6.6,12,8,3,8,1,5,17,29.4,12,9,0,9,4,16,7,0,Primeira_Liga,2023_2024
Maracás,BRA,DF,Moreirense,29,1994,28.5,44,35,35,8,1,24,34,70.6,10,34,28,6,22,66,150,0,Primeira_Liga,2023_2024
Iván Marcano,ESP,DF,Porto,36,1987,4.1,9,4,5,4,0,5,7,71.4,2,1,1,0,4,13,9,0,Primeira_Liga,2023_2024
Adrián Marín,ESP,DF,Braga,26,1997,3.6,7,3,2,3,2,3,5,60.0,2,6,3,3,6,13,7,0,Primeira_Liga,2023_2024
João Mário,POR,"FW,MF",Benfica,30,1993,26.9,39,27,8,21,10,15,34,44.1,19,24,0,24,16,55,8,0,Primeira_Liga,2023_2024
João Mário Lopes,POR,DF,Porto,23,2000,22.9,33,20,13,16,4,22,44,50.0,22,19,4,15,13,46,18,1,Primeira_Liga,2023_2024
Marlon,BRA,"FW,MF",Gil Vicente FC,25,1997,4.8,4,3,1,2,1,3,12,25.0,9,8,0,8,3,7,5,0,Primeira_Liga,2023_2024
Uladzislaŭ Marozaŭ,BLR,"FW,MF",Arouca,22,2000,1.6,0,0,0,0,0,0,2,0.0,2,1,0,1,0,0,1,0,Primeira_Liga,2023_2024
Alejandro Marqués,VEN,FW,Estoril,22,2000,15.1,10,7,1,8,1,2,9,22.2,7,14,4,10,3,13,15,0,Primeira_Liga,2023_2024
Gustavo Marques,BRA,DF,Benfica,21,2001,0.0,0,0,0,0,0,0,0,,0,0,0,0,1,1,0,0,Primeira_Liga,2023_2024
Igor Marques,BRA,"DF,MF",Portimonense,24,1999,16.5,55,34,25,24,6,23,50,46.0,27,35,5,30,41,96,45,1,Primeira_Liga,2023_2024
João Marques,POR,"MF,FW",Estoril,21,2002,21.9,39,25,5,26,8,11,29,37.9,18,20,2,18,11,50,13,0,Primeira_Liga,2023_2024
Toni Martínez,ESP,FW,Porto,26,1997,5.8,2,1,1,0,1,1,6,16.7,5,2,0,2,0,2,0,0,Primeira_Liga,2023_2024
Rafael Martins,BRA,MF,Casa Pia,34,1989,0.3,0,0,0,0,0,0,0,,0,0,0,0,0,0,0,0,Primeira_Liga,2023_2024
Rodrigo Martins,POR,"DF,FW",Estoril,24,1998,0.1,0,0,0,0,0,0,0,,0,0,0,0,1,1,0,0,Primeira_Liga,2023_2024
Rodrigo Martins,POR,FW,Portimonense,24,1998,2.6,4,3,2,1,1,2,6,33.3,4,1,0,1,0,4,6,0,Primeira_Liga,2023_2024
Matheus,BRA,GK,Braga,31,1992,34.0,1,1,1,0,0,0,2,0.0,2,1,0,1,0,1,20,2,Primeira_Liga,2023_2024
Marco Matias,POR,"FW,MF",Farense,34,1989,25.5,40,26,20,12,8,13,32,40.6,19,19,0,19,22,62,20,0,Primeira_Liga,2023_2024
Nuno Matos,POR,DF,Braga,18,2004,0.1,0,0,0,0,0,0,2,0.0,2,0,0,0,0,0,0,0,Primeira_Liga,2023_2024
Maurício,BRA,MF,Portimonense,34,1988,5.0,11,8,3,8,0,8,14,57.1,6,7,3,4,9,20,11,1,Primeira_Liga,2023_2024
Rodrigo Melro,POR,DF,Chaves,19,2004,0.0,0,0,0,0,0,0,1,0.0,1,0,0,0,0,0,0,0,Primeira_Liga,2023_2024
João Mendes,POR,"FW,MF",Vitória,28,1994,16.0,21,9,5,10,6,10,29,34.5,19,19,1,18,9,30,7,1,Primeira_Liga,2023_2024
Joe Mendes,SWE,DF,Braga,20,2002,9.9,18,8,10,6,2,8,17,47.1,9,7,3,4,6,24,20,0,Primeira_Liga,2023_2024
Pedro Mendes,POR,DF,Estrela,32,1990,9.0,13,9,10,2,1,7,12,58.3,5,14,10,4,15,28,42,1,Primeira_Liga,2023_2024
Alex Mendez,USA,"MF,FW",Vizela,22,2000,4.1,6,5,1,4,1,3,4,75.0,1,2,0,2,2,8,1,0,Primeira_Liga,2023_2024
Miguel Menino,POR,MF,Sporting CP,20,2003,0.0,0,0,0,0,0,0,0,,0,1,0,1,0,0,0,0,Primeira_Liga,2023_2024
Benji Michel,USA,"FW,MF",Arouca,25,1997,0.5,0,0,0,0,0,0,0,,0,0,0,0,0,0,1,0,Primeira_Liga,2023_2024
João Miguel,POR,DF,Porto,23,2000,3.2,3,2,2,1,0,3,5,60.0,2,5,3,2,2,5,2,0,Primeira_Liga,2023_2024
Enea Mihaj,ALB,DF,Famalicão,25,1998,17.3,20,15,14,6,0,14,22,63.6,8,25,19,6,23,43,75,0,Primeira_Liga,2023_2024
Mika,POR,GK,Moreirense,32,1991,0.2,0,0,0,0,0,0,0,,0,0,0,0,0,0,0,0,Primeira_Liga,2023_2024
Bogdan Milovanov,UKR,DF,Arouca,25,1998,13.4,49,30,24,21,4,29,51,56.9,22,12,4,8,13,62,33,0,Primeira_Liga,2023_2024
Vinicius Mingotti,BRA,FW,Moreirense,23,2000,5.4,6,3,1,4,1,0,1,0.0,1,4,0,4,0,6,3,0,Primeira_Liga,2023_2024
Miro,ANG,"FW,MF",Gil Vicente FC,20,2003,1.8,2,2,0,1,1,0,2,0.0,2,1,0,1,1,3,1,0,Primeira_Liga,2023_2024
Cezary Miszta,POL,GK,Rio Ave,21,2001,1.0,0,0,0,0,0,0,0,,0,0,0,0,0,0,2,0,Primeira_Liga,2023_2024
Miguel Monteiro,POR,FW,Gil Vicente FC,20,2003,2.5,0,0,0,0,0,0,1,0.0,1,0,0,0,1,1,2,0,Primeira_Liga,2023_2024
Francisco Montero,ESP,DF,Arouca,24,1999,28.7,28,20,24,4,0,14,35,40.0,21,35,19,16,31,59,137,1,Primeira_Liga,2023_2024
Morato,BRA,DF,Benfica,22,2001,16.9,53,33,33,11,9,37,67,55.2,30,20,5,15,17,70,40,0,Primeira_Liga,2023_2024
Hélder Morim,POR,"MF,DF",Chaves,22,2001,7.3,19,8,8,8,3,7,24,29.2,17,18,7,11,8,27,5,0,Primeira_Liga,2023_2024
Hidemasa Morita,JPN,MF,Sporting CP,28,1995,23.8,55,35,16,32,7,28,58,48.3,30,17,1,16,17,72,25,0,Primeira_Liga,2023_2024
Mosquito,BRA,GK,Arouca,27,1996,2.0,0,0,0,0,0,0,0,,0,0,0,0,0,0,0,0,Primeira_Liga,2023_2024
Moura,POR,DF,Famalicão,23,1999,33.0,55,35,29,13,13,29,41,70.7,12,43,7,36,33,88,79,1,Primeira_Liga,2023_2024
Rodrigo Moura,BRA,GK,Chaves,27,1996,7.0,3,0,3,0,0,3,3,100.0,0,0,0,0,0,3,3,0,Primeira_Liga,2023_2024
João Moutinho,POR,MF,Braga,36,1986,23.5,68,42,24,42,2,31,69,44.9,38,27,8,19,30,98,28,1,Primeira_Liga,2023_2024
Rafa Mújica,ESP,FW,Arouca,24,1998,28.1,22,14,5,8,9,2,13,15.4,11,23,3,20,5,27,16,0,Primeira_Liga,2023_2024
Petar Musa,CRO,FW,Benfica,25,1998,5.8,12,8,4,4,4,3,5,60.0,2,8,2,6,0,12,6,0,Primeira_Liga,2023_2024
Zach Muscat,MLT,DF,Farense,29,1993,18.7,11,4,5,6,0,6,14,42.9,8,42,33,9,15,26,103,0,Primeira_Liga,2023_2024
Almoatasem Al Musrati,LBY,MF,Braga,27,1996,8.9,20,14,9,10,1,9,14,64.3,5,4,2,2,14,34,8,1,Primeira_Liga,2023_2024
Steve Mvoué,CMR,MF,Portimonense,21,2002,0.8,4,1,0,4,0,1,2,50.0,1,1,0,1,0,4,0,0,Primeira_Liga,2023_2024
Kosuke Nakamura,JPN,GK,Portimonense,28,1995,20.0,0,0,0,0,0,0,1,0.0,1,0,0,0,0,0,17,1,Primeira_Liga,2023_2024
Nuno Namora,POR,"DF,MF",Rio Ave,25,1998,0.3,1,0,0,0,1,1,3,33.3,2,0,0,0,0,1,3,0,Primeira_Liga,2023_2024
Davis Nascimento,BRA,MF,Portimonense,20,2002,0.0,0,0,0,0,0,0,1,0.0,1,0,0,0,0,0,0,0,Primeira_Liga,2023_2024
Diogo Nascimento,POR,MF,Vizela,20,2002,24.0,29,19,9,17,3,14,32,43.8,18,17,2,15,10,39,24,0,Primeira_Liga,2023_2024
Nathan,BRA,DF,Famalicão,21,2001,20.5,61,42,39,20,2,27,59,45.8,32,18,1,17,19,80,38,0,Primeira_Liga,2023_2024
Fran Navarro,ESP,"FW,MF",Porto,25,1998,1.9,1,0,1,0,0,0,3,0.0,3,1,0,1,3,4,3,0,Primeira_Liga,2023_2024
Mor Ndiaye,SEN,MF,Estoril,22,2000,2.8,5,3,3,1,1,5,7,71.4,2,2,0,2,1,6,6,0,Primeira_Liga,2023_2024
Alioune Ndour,SEN,"FW,MF",Estrela,22,2001,1.9,4,3,0,2,2,0,1,0.0,1,0,0,0,0,4,2,0,Primeira_Liga,2023_2024
Cher Ndour,ITA,MF,Braga,19,2004,2.3,7,4,4,3,0,1,4,25.0,3,3,1,2,5,12,5,0,Primeira_Liga,2023_2024
Nelson,ANG,"DF,FW",Vitória,25,1998,4.5,10,8,3,4,3,5,11,45.5,6,11,0,11,6,16,4,0,Primeira_Liga,2023_2024
David Neres,BRA,FW,Benfica,26,1997,12.6,12,3,2,8,2,4,11,36.4,7,15,2,13,5,17,2,0,Primeira_Liga,2023_2024
Neto,BRA,MF,Casa Pia,31,1991,25.0,50,32,26,18,6,31,62,50.0,31,37,9,28,22,72,44,0,Primeira_Liga,2023_2024
Luís Neto,POR,DF,Sporting CP,35,1988,1.5,1,0,0,1,0,0,1,0.0,1,2,2,0,1,2,4,0,Primeira_Liga,2023_2024
Martim Neto,POR,MF,Gil Vicente FC,20,2003,20.7,45,23,17,26,2,22,57,38.6,35,25,0,25,18,63,16,1,Primeira_Liga,2023_2024
João Neves,POR,MF,Benfica,18,2004,25.7,65,53,21,26,18,29,63,46.0,34,49,12,37,35,100,38,0,Primeira_Liga,2023_2024
Sikou Niakaté,MLI,DF,Braga,24,1999,16.5,13,9,8,5,0,8,12,66.7,4,13,7,6,16,29,72,2,Primeira_Liga,2023_2024
Miguel Nóbrega,POR,DF,Rio Ave,23,2000,18.0,32,20,17,14,1,20,32,62.5,12,22,12,10,22,54,79,1,Primeira_Liga,2023_2024
Gonçalo Nogueira,POR,MF,Vitória,19,2003,0.1,0,0,0,0,0,0,0,,0,1,0,1,0,0,0,0,Primeira_Liga,2023_2024
Ygor Nogueira,BRA,DF,Chaves,28,1995,18.4,37,25,32,5,0,24,33,72.7,9,22,15,7,27,64,101,0,Primeira_Liga,2023_2024
Nonoca,BRA,MF,Portimonense,25,1998,21.3,82,54,34,41,7,35,49,71.4,14,30,11,19,20,102,30,1,Primeira_Liga,2023_2024
João Nunes,POR,DF,Casa Pia,27,1995,14.7,12,7,8,4,0,8,20,40.0,12,19,11,8,14,26,55,1,Primeira_Liga,2023_2024
Kelechi Nwakali,NGA,MF,Chaves,25,1998,23.0,38,29,7,27,4,20,38,52.6,18,20,2,18,19,57,12,0,Primeira_Liga,2023_2024
Régis N’Do,BFA,"FW,MF",Estrela,22,2001,11.0,16,9,5,8,3,10,25,40.0,15,15,2,13,3,19,4,0,Primeira_Liga,2023_2024
Tashan Oakley-Boothe,ENG,"MF,DF",Estrela,23,2000,0.6,0,0,0,0,0,0,0,,0,0,0,0,1,1,2,0,Primeira_Liga,2023_2024
Lawrence Ofori,GHA,MF,Moreirense,25,1998,27.3,27,13,10,15,2,8,38,21.1,30,22,5,17,17,44,19,1,Primeira_Liga,2023_2024
Hugo Oliveira,POR,"DF,MF",Vizela,21,2002,5.5,8,6,5,2,1,5,8,62.5,3,5,3,2,8,16,15,0,Primeira_Liga,2023_2024
Mattheus Oliveira,BRA,MF,Farense,29,1994,24.8,44,34,24,17,3,19,43,44.2,24,40,8,32,27,71,42,0,Primeira_Liga,2023_2024
Nélson Oliveira,POR,FW,Vitória,31,1991,6.7,4,4,1,3,0,0,1,0.0,1,4,1,3,2,6,3,0,Primeira_Liga,2023_2024
Paulo Oliveira,POR,DF,Braga,31,1992,18.6,34,18,20,13,1,21,31,67.7,10,18,9,9,35,69,79,1,Primeira_Liga,2023_2024
Talys Oliveira,BRA,DF,Farense,24,1999,10.9,18,13,12,5,1,12,23,52.2,11,13,3,10,18,36,43,0,Primeira_Liga,2023_2024
Joneston Omurwa,KEN,DF,Estrela,24,1998,12.7,20,12,13,6,1,12,20,60.0,8,20,12,8,21,41,47,1,Primeira_Liga,2023_2024
Bruno Onyemaechi,NGA,"DF,MF",Boavista,24,1999,21.9,50,37,26,20,4,21,36,58.3,15,28,6,22,24,74,57,0,Primeira_Liga,2023_2024
Jerome Opoku,GHA,DF,Arouca,24,1998,1.5,1,0,0,0,1,0,0,,0,2,0,2,0,1,9,0,Primeira_Liga,2023_2024
Pedro Ortiz,ESP,MF,Vizela,22,2000,10.2,27,15,10,14,3,15,26,57.7,11,9,4,5,7,34,21,0,Primeira_Liga,2023_2024
Nicolás Otamendi,ARG,DF,Benfica,35,1988,30.6,50,36,33,16,1,30,58,51.7,28,30,14,16,53,103,109,3,Primeira_Liga,2023_2024
Otávio,POR,"MF,FW",Porto,28,1995,1.0,0,0,0,0,0,0,3,0.0,3,0,0,0,0,0,0,0,Primeira_Liga,2023_2024
João Othavio Basso,BRA,DF,Estoril,26,1997,13.4,26,18,17,7,2,14,25,56.0,11,16,9,7,16,42,53,0,Primeira_Liga,2023_2024
Amine Oudrhiri,MAR,MF,Rio Ave,30,1992,24.7,34,22,8,21,5,19,34,55.9,15,22,4,18,30,64,20,3,Primeira_Liga,2023_2024
Pablo,BRA,"FW,MF",Famalicão,19,2004,2.2,3,3,3,0,0,2,4,50.0,2,4,1,3,1,4,3,0,Primeira_Liga,2023_2024
Lucas Paes,BRA,GK,Casa Pia,25,1997,3.0,0,0,0,0,0,0,1,0.0,1,0,0,0,0,0,0,0,Primeira_Liga,2023_2024
Renato Pantalon,CRO,DF,Rio Ave,25,1997,14.9,22,10,11,10,1,11,16,68.8,5,15,8,7,9,31,54,0,Primeira_Liga,2023_2024
Raúl Parra,ESP,DF,Estoril,23,1999,6.3,8,5,6,2,0,4,9,44.4,5,3,2,1,2,10,9,0,Primeira_Liga,2023_2024
David Pastor,BRA,DF,Farense,23,2000,27.5,55,34,34,19,2,31,60,51.7,29,32,7,25,50,105,83,0,Primeira_Liga,2023_2024
Patrick,BRA,DF,Rio Ave,26,1997,12.4,18,8,14,4,0,12,21,57.1,9,9,2,7,26,44,44,0,Primeira_Liga,2023_2024
Paulinho,POR,"FW,MF",Portimonense,23,1999,1.9,0,0,0,0,0,0,0,,0,0,0,0,0,0,3,0,Primeira_Liga,2023_2024
Paulinho,POR,"FW,MF",Sporting CP,30,1992,14.5,18,14,1,9,8,5,16,31.3,11,15,1,14,2,20,6,0,Primeira_Liga,2023_2024
Ivan Pavlic,BEL,MF,Estoril,21,2001,2.0,4,2,3,1,0,4,6,66.7,2,1,0,1,1,5,2,0,Primeira_Liga,2023_2024
Pedrão,BRA,DF,Portimonense,26,1997,29.3,48,29,34,12,2,22,38,57.9,16,32,17,15,50,98,136,0,Primeira_Liga,2023_2024
Zé Pedro Figueiredo,POR,DF,Porto,26,1997,10.3,15,7,8,6,1,10,17,58.8,7,5,2,3,9,24,31,0,Primeira_Liga,2023_2024
João Pedro,POR,MF,Chaves,30,1993,4.5,7,4,3,3,1,7,15,46.7,8,3,2,1,3,10,5,0,Primeira_Liga,2023_2024
Pepe,POR,DF,Porto,40,1983,20.9,28,16,16,12,0,16,30,53.3,14,13,8,5,19,47,50,1,Primeira_Liga,2023_2024
Pepê,BRA,"MF,DF",Porto,26,1997,31.7,26,18,8,12,6,9,33,27.3,24,30,2,28,22,48,16,0,Primeira_Liga,2023_2024
André Pereira,POR,FW,Rio Ave,28,1995,6.5,10,7,1,8,1,4,10,40.0,6,9,0,9,2,12,5,0,Primeira_Liga,2023_2024
Gabriel Pereira,BRA,DF,Gil Vicente FC,23,2000,30.9,34,24,25,6,3,26,38,68.4,12,42,30,12,26,60,130,0,Primeira_Liga,2023_2024
Hildeberto Pereira,POR,FW,Portimonense,27,1996,9.4,2,2,2,0,0,0,12,0.0,12,10,1,9,2,4,3,0,Primeira_Liga,2023_2024
Matheus Pereira,BRA,"DF,FW",Vizela,22,2000,23.3,26,16,12,11,3,11,23,47.8,12,29,6,23,20,46,38,0,Primeira_Liga,2023_2024
Sebastián Pérez Cardona,COL,MF,Boavista,30,1993,24.3,74,39,41,30,3,39,68,57.4,29,30,8,22,22,96,26,1,Primeira_Liga,2023_2024
Sava Petrov,SRB,"FW,MF",Vizela,25,1998,5.7,0,0,0,0,0,0,3,0.0,3,5,2,3,0,0,8,0,Primeira_Liga,2023_2024
Thibang Phete,RSA,"DF,MF",Chaves,29,1994,4.9,5,3,2,2,1,3,5,60.0,2,5,3,2,8,13,18,0,Primeira_Liga,2023_2024
Wagner Pina,CPV,"MF,DF",Estoril,20,2002,12.2,34,24,22,10,2,23,29,79.3,6,24,5,19,8,42,29,0,Primeira_Liga,2023_2024
Pedro Pinho,POR,MF,Chaves,23,2000,2.8,9,2,4,3,2,3,7,42.9,4,6,4,2,9,18,7,0,Primeira_Liga,2023_2024
Rodrigo Pinho,BRA,FW,Estrela,32,1991,3.5,2,2,1,1,0,0,1,0.0,1,2,0,2,1,3,1,0,Primeira_Liga,2023_2024
Alexandre Pinto,POR,DF,Gil Vicente FC,25,1998,11.8,25,17,13,10,2,14,24,58.3,10,6,1,5,15,40,57,1,Primeira_Liga,2023_2024
Dinis Pinto,POR,DF,Moreirense,22,2000,10.4,20,12,10,6,4,10,14,71.4,4,10,3,7,8,28,24,0,Primeira_Liga,2023_2024
Diogo Pinto,POR,MF,Casa Pia,24,1999,0.1,0,0,0,0,0,0,0,,0,0,0,0,0,0,0,0,Primeira_Liga,2023_2024
Diogo Pinto,POR,GK,Sporting CP,19,2004,1.9,0,0,0,0,0,0,0,,0,0,0,0,0,0,0,0,Primeira_Liga,2023_2024
Gonçalo Pinto,POR,GK,Chaves,23,2000,1.0,0,0,0,0,0,0,0,,0,0,0,0,0,0,0,0,Primeira_Liga,2023_2024
Junior Pius,NGA,DF,Chaves,27,1995,12.8,45,33,31,12,2,28,42,66.7,14,23,7,16,18,63,53,0,Primeira_Liga,2023_2024
Pizzi,POR,"MF,FW",Braga,33,1989,10.7,6,4,4,1,1,2,8,25.0,6,8,0,8,3,9,6,1,Primeira_Liga,2023_2024
Carlos Ponck,CPV,DF,Moreirense,28,1995,11.5,20,17,12,8,0,14,17,82.4,3,16,10,6,12,32,61,2,Primeira_Liga,2023_2024
Cristian Ponde,POR,"MF,FW",Farense,28,1995,2.5,5,3,2,3,0,1,5,20.0,4,6,1,5,3,8,2,0,Primeira_Liga,2023_2024
Rafael Pontelo,BRA,DF,Sporting CP,20,2003,0.0,0,0,0,0,0,0,0,,0,0,0,0,0,0,0,0,Primeira_Liga,2023_2024
Gianluca Prestianni,ARG,MF,Benfica,17,2006,0.0,0,0,0,0,0,0,1,0.0,1,0,0,0,0,0,0,0,Primeira_Liga,2023_2024
Miguel Puche García,ESP,"FW,MF",Arouca,22,2001,3.4,6,2,5,1,0,4,5,80.0,1,1,0,1,1,7,1,0,Primeira_Liga,2023_2024
Quaresma,BRA,DF,Arouca,26,1996,3.3,8,6,4,3,1,6,13,46.2,7,5,1,4,5,13,6,1,Primeira_Liga,2023_2024
Eduardo Quaresma,POR,DF,Sporting CP,21,2002,10.7,28,18,15,12,1,13,20,65.0,7,11,7,4,9,37,23,0,Primeira_Liga,2023_2024
João Queirós,POR,DF,Chaves,25,1998,2.6,4,2,3,1,0,3,4,75.0,1,2,1,1,4,8,6,1,Primeira_Liga,2023_2024
Domingos Quina,POR,"FW,MF",Vizela,23,1999,8.1,18,9,1,14,3,4,12,33.3,8,11,0,11,4,22,5,0,Primeira_Liga,2023_2024
Cláudio Ramos,POR,GK,Porto,31,1991,1.3,0,0,0,0,0,0,0,,0,0,0,0,1,1,0,0,Primeira_Liga,2023_2024
Osama Rashid,IRQ,"MF,FW",Vizela,31,1992,0.3,0,0,0,0,0,0,1,0.0,1,0,0,0,1,1,2,0,Primeira_Liga,2023_2024
Miguel Rebelo,POR,MF,Moreirense,19,2003,0.0,0,0,0,0,0,0,0,,0,0,0,0,0,0,0,0,Primeira_Liga,2023_2024
João Rêgo,POR,MF,Benfica,18,2005,0.1,0,0,0,0,0,0,0,,0,0,0,0,0,0,0,0,Primeira_Liga,2023_2024
João Reis,POR,"DF,MF",Estrela,31,1992,16.1,40,24,24,13,3,25,51,49.0,26,27,2,25,24,64,45,0,Primeira_Liga,2023_2024
Matheus Reis,BRA,"DF,MF",Sporting CP,28,1995,15.8,20,13,7,11,2,15,24,62.5,9,16,3,13,9,29,27,0,Primeira_Liga,2023_2024
Miguel Reisinho,POR,MF,Boavista,24,1999,23.3,48,30,14,29,5,22,48,45.8,26,22,8,14,21,69,37,2,Primeira_Liga,2023_2024
Filipe Relvas,POR,DF,Portimonense,23,1999,31.1,56,32,43,13,0,28,46,60.9,18,48,25,23,58,114,140,1,Primeira_Liga,2023_2024
Rúben Tiago Rodrigues Ribeiro,POR,"FW,MF",Chaves,35,1987,18.7,23,14,14,7,2,12,20,60.0,8,12,0,12,12,35,11,0,Primeira_Liga,2023_2024
Tomás Ribeiro,POR,DF,Vitória,24,1999,27.0,33,17,16,14,3,19,34,55.9,15,36,17,19,21,54,88,0,Primeira_Liga,2023_2024
Riccieli,BRA,DF,Famalicão,24,1998,19.7,23,14,17,6,0,15,29,51.7,14,26,13,13,13,36,84,0,Primeira_Liga,2023_2024
Rildo,BRA,"FW,MF",Portimonense,23,2000,5.7,5,3,0,5,0,1,3,33.3,2,9,0,9,1,6,3,0,Primeira_Liga,2023_2024
Mihailo Ristić,SRB,DF,Benfica,27,1995,0.0,1,0,1,0,0,0,0,,0,0,0,0,0,1,0,0,Primeira_Liga,2023_2024
Pablo Roberto,BRA,"MF,FW",Casa Pia,23,1999,18.5,25,13,4,19,2,13,33,39.4,20,18,1,17,17,42,9,1,Primeira_Liga,2023_2024
Matí­as Rocha,URU,DF,Arouca,22,2001,6.2,6,4,3,3,0,5,8,62.5,3,2,2,0,6,12,26,0,Primeira_Liga,2023_2024
Afonso Rodrigues,POR,"FW,MF",Famalicão,20,2002,2.6,4,0,0,2,2,2,5,40.0,3,4,0,4,2,6,4,0,Primeira_Liga,2023_2024
Bruno Rodrigues,POR,DF,Chaves,22,2001,15.0,14,8,11,1,2,9,13,69.2,4,15,3,12,18,32,47,0,Primeira_Liga,2023_2024
Gonçalo Rodrigues,POR,MF,Rio Ave,26,1997,13.7,22,12,3,15,4,10,27,37.0,17,8,0,8,4,26,8,0,Primeira_Liga,2023_2024
Benjamín Rollheiser,ARG,FW,Benfica,23,2000,1.7,0,0,0,0,0,0,1,0.0,1,3,1,2,0,0,1,0,Primeira_Liga,2023_2024
Ronald,BRA,"MF,FW",Estrela,22,2001,14.7,14,8,3,7,4,7,18,38.9,11,13,0,13,4,18,6,0,Primeira_Liga,2023_2024
Igor Rossi Branco,BRA,DF,Farense,34,1989,11.3,8,6,7,0,1,6,7,85.7,1,4,4,0,12,20,64,1,Primeira_Liga,2023_2024
Francesco Ruberto,SUI,GK,Vizela,30,1993,6.3,0,0,0,0,0,0,2,0.0,2,0,0,0,0,0,3,1,Primeira_Liga,2023_2024
Abel Ruiz,ESP,"FW,MF",Braga,23,2000,21.1,8,6,1,4,3,4,8,50.0,4,6,1,5,6,14,12,0,Primeira_Liga,2023_2024
Leonardo Ruíz,COL,FW,Rio Ave,27,1996,8.3,6,6,2,3,1,5,12,41.7,7,3,1,2,4,10,13,0,Primeira_Liga,2023_2024
Gustavo sá,POR,MF,Famalicão,18,2004,20.4,37,22,6,22,9,12,40,30.0,28,16,5,11,12,49,31,0,Primeira_Liga,2023_2024
Helder Sá,POR,"DF,MF",Rio Ave,20,2002,0.5,0,0,0,0,0,0,1,0.0,1,2,2,0,0,0,4,0,Primeira_Liga,2023_2024
Josué Sá,POR,DF,Rio Ave,31,1992,21.8,30,20,18,11,1,16,26,61.5,10,24,11,13,23,53,78,0,Primeira_Liga,2023_2024
Pedro Sá,POR,MF,Estrela,29,1993,7.2,9,4,4,5,0,3,10,30.0,7,4,2,2,6,15,7,0,Primeira_Liga,2023_2024
Serdar Saatçı,TUR,DF,Braga,20,2003,16.6,27,17,18,9,0,17,24,70.8,7,17,10,7,38,65,46,3,Primeira_Liga,2023_2024
Safira,BRA,FW,Vitória,28,1995,1.6,4,2,2,2,0,1,1,100.0,0,2,0,2,0,4,3,0,Primeira_Liga,2023_2024
Dylan Saint-Louis,CGO,"FW,MF",Vizela,28,1995,2.9,5,2,3,1,1,3,6,50.0,3,3,1,2,1,6,2,0,Primeira_Liga,2023_2024
Samu,POR,MF,Vizela,27,1996,30.7,70,37,32,27,11,34,78,43.6,44,54,12,42,20,90,48,0,Primeira_Liga,2023_2024
Leandro Sanca,GNB,"FW,MF",Chaves,23,2000,16.3,17,5,5,9,3,6,29,20.7,23,25,1,24,9,26,8,0,Primeira_Liga,2023_2024
Aderlan Santos,BRA,DF,Rio Ave,34,1989,31.6,68,44,50,18,0,34,47,72.3,13,58,40,18,45,113,167,1,Primeira_Liga,2023_2024
Hevertton Santos,BRA,"DF,MF",Estrela,22,2001,21.9,25,18,12,10,3,18,29,62.1,11,27,7,20,20,45,53,0,Primeira_Liga,2023_2024
Luís Santos,POR,"DF,FW",Boavista,23,2000,7.6,17,9,13,3,1,10,16,62.5,6,8,3,5,11,28,23,0,Primeira_Liga,2023_2024
Nuno Santos,POR,"FW,MF",Vitória,24,1999,10.7,10,6,3,7,0,5,26,19.2,21,12,0,12,5,15,5,0,Primeira_Liga,2023_2024
Nuno Santos,POR,"MF,DF",Sporting CP,28,1995,22.9,26,18,8,12,6,9,22,40.9,13,8,1,7,25,51,13,1,Primeira_Liga,2023_2024
Pedro Santos,POR,MF,Arouca,22,2000,16.1,29,20,8,18,3,18,45,40.0,27,19,1,18,11,40,8,0,Primeira_Liga,2023_2024
Zaidu Sanusi,NGA,DF,Porto,26,1997,3.2,3,2,1,2,0,2,3,66.7,1,4,2,2,4,7,4,0,Primeira_Liga,2023_2024
Vincent Sasso,FRA,DF,Boavista,32,1991,14.2,23,10,13,9,1,13,23,56.5,10,20,13,7,14,37,69,3,Primeira_Liga,2023_2024
Savio,BRA,"DF,MF",Rio Ave,28,1995,2.8,4,2,2,2,0,3,8,37.5,5,3,1,2,2,6,6,2,Primeira_Liga,2023_2024
Caio Secco,BRA,GK,Moreirense,32,1990,4.0,0,0,0,0,0,0,0,,0,0,0,0,0,0,1,0,Primeira_Liga,2023_2024
Moustapha Seck,SEN,"DF,MF",Portimonense,27,1996,9.8,29,19,17,9,3,15,19,78.9,4,17,6,11,11,40,28,0,Primeira_Liga,2023_2024
Telasco Segovia,VEN,MF,Casa Pia,20,2003,8.3,29,19,12,16,1,15,31,48.4,16,7,1,6,15,44,6,0,Primeira_Liga,2023_2024
Artur Serobyan,ARM,MF,Casa Pia,20,2003,0.7,1,1,0,1,0,1,2,50.0,1,0,0,0,1,2,1,0,Primeira_Liga,2023_2024
André Seruca,POR,MF,Farense,22,2000,0.4,3,2,3,0,0,2,2,100.0,0,2,0,2,0,3,0,0,Primeira_Liga,2023_2024
Nkanyiso Shinga,RSA,"DF,MF",Estrela,23,2000,5.7,12,11,4,5,3,10,12,83.3,2,12,7,5,7,19,20,1,Primeira_Liga,2023_2024
Adrien Silva,POR,MF,Rio Ave,34,1989,3.8,13,4,4,7,2,4,10,40.0,6,6,0,6,5,18,7,1,Primeira_Liga,2023_2024
André Silva,BRA,FW,Vitória,26,1997,19.7,19,10,3,12,4,8,13,61.5,5,20,1,19,5,24,17,0,Primeira_Liga,2023_2024
António Silva,POR,DF,Benfica,19,2003,29.1,64,43,34,24,6,33,42,78.6,9,47,24,23,23,87,91,0,Primeira_Liga,2023_2024
Francisco Silva,POR,GK,Sporting CP,17,2005,0.1,0,0,0,0,0,0,0,,0,0,0,0,0,0,0,0,Primeira_Liga,2023_2024
Gonçalo Silva,POR,DF,Farense,32,1991,32.0,36,21,29,7,0,22,35,62.9,13,45,32,13,39,75,231,1,Primeira_Liga,2023_2024
Joel silva,POR,MF,Boavista,20,2003,4.1,11,7,3,7,1,5,12,41.7,7,6,1,5,3,14,5,0,Primeira_Liga,2023_2024
Jota Silva,POR,"FW,MF",Vitória,23,1999,30.9,35,18,12,14,9,11,43,25.6,32,34,2,32,17,52,28,0,Primeira_Liga,2023_2024
Felipe Silva Lipe,BRA,DF,Gil Vicente FC,21,2002,3.0,7,2,4,3,0,5,7,71.4,2,3,2,1,2,9,8,0,Primeira_Liga,2023_2024
Pedro Manuel da Silva Moreira,POR,MF,Arouca,34,1989,0.5,1,0,0,0,1,0,0,,0,0,0,0,0,1,0,0,Primeira_Liga,2023_2024
Rafa Silva,POR,"MF,FW",Benfica,30,1993,27.5,23,12,10,7,6,10,32,31.3,22,11,0,11,7,30,4,0,Primeira_Liga,2023_2024
Tiago Silva,POR,MF,Vitória,30,1993,25.9,45,30,14,24,7,22,46,47.8,24,17,1,16,27,72,13,0,Primeira_Liga,2023_2024
Vinicius Silvestre,BRA,GK,Portimonense,29,1994,14.0,0,0,0,0,0,0,3,0.0,3,0,0,0,0,0,10,1,Primeira_Liga,2023_2024
David Simão,POR,MF,Arouca,33,1990,28.4,47,28,22,21,4,28,63,44.4,35,40,9,31,34,81,22,3,Primeira_Liga,2023_2024
André Simões,POR,FW,Gil Vicente FC,19,2003,0.2,0,0,0,0,0,0,1,0.0,1,0,0,0,0,0,0,0,Primeira_Liga,2023_2024
Alexandre Miguel Barros Soares,POR,MF,Estoril,32,1991,2.8,9,4,2,6,1,4,6,66.7,2,2,1,1,3,12,3,0,Primeira_Liga,2023_2024
Filipe Soares,POR,MF,Famalicão,24,1999,1.9,4,2,1,1,2,1,3,33.3,2,0,0,0,0,4,1,0,Primeira_Liga,2023_2024
Samuel Soares,POR,GK,Benfica,21,2002,5.0,0,0,0,0,0,0,0,,0,0,0,0,0,0,2,0,Primeira_Liga,2023_2024
Yuki Soma,JPN,"FW,MF",Casa Pia,26,1997,21.0,21,15,6,11,4,7,21,33.3,14,12,1,11,4,25,11,0,Primeira_Liga,2023_2024
Alberto Soro,ESP,"FW,MF",Vizela,24,1999,10.0,21,13,9,8,4,6,16,37.5,10,10,0,10,1,22,8,0,Primeira_Liga,2023_2024
Gonçalo Sousa,POR,FW,Porto,17,2006,0.1,0,0,0,0,0,0,0,,0,0,0,0,0,0,1,0,Primeira_Liga,2023_2024
Aloísio Souza Genézio,BRA,MF,Estrela,27,1996,16.6,44,30,13,27,4,19,46,41.3,27,16,4,12,24,68,20,0,Primeira_Liga,2023_2024
Hugo Souza,BRA,GK,Chaves,24,1999,26.0,0,0,0,0,0,0,1,0.0,1,0,0,0,0,0,16,2,Primeira_Liga,2023_2024
Jose Souza,POR,MF,Portimonense,22,2001,0.1,0,0,0,0,0,0,1,0.0,1,1,0,1,0,0,0,0,Primeira_Liga,2023_2024
Diogo Spencer,POR,DF,Benfica,19,2004,0.0,0,0,0,0,0,0,0,,0,0,0,0,0,0,0,0,Primeira_Liga,2023_2024
Jerry St. Juste,NED,DF,Sporting CP,26,1996,6.0,13,5,7,5,1,5,9,55.6,4,5,0,5,6,19,8,0,Primeira_Liga,2023_2024
Harouna Sy,FRA,FW,Estoril,27,1996,0.1,0,0,0,0,0,0,0,,0,0,0,0,0,0,1,0,Primeira_Liga,2023_2024
Habib sylla,CIV,DF,Chaves,24,1999,4.5,6,2,3,2,1,2,3,66.7,1,9,2,7,1,7,16,0,Primeira_Liga,2023_2024
Morlaye Sylla,GUI,"MF,FW",Arouca,25,1998,28.7,69,41,24,31,14,38,73,52.1,35,42,3,39,27,96,17,0,Primeira_Liga,2023_2024
Talocha,POR,DF,Farense,33,1989,22.9,36,26,21,13,2,18,25,72.0,7,31,13,18,26,62,87,0,Primeira_Liga,2023_2024
Tamble,POR,FW,Portimonense,22,2000,4.0,0,0,0,0,0,0,2,0.0,2,3,3,0,1,1,3,0,Primeira_Liga,2023_2024
Mateo Tanlongo,ARG,MF,Rio Ave,19,2003,6.8,18,8,6,9,3,5,15,33.3,10,4,1,3,8,26,1,0,Primeira_Liga,2023_2024
Mehdi Taremi,IRN,"FW,MF",Porto,31,1992,16.4,24,15,8,9,7,8,24,33.3,16,14,3,11,7,31,21,0,Primeira_Liga,2023_2024
Heriberto Tavares,POR,"FW,MF",Estoril,26,1997,13.9,14,9,7,5,2,4,18,22.2,14,6,0,6,4,18,5,2,Primeira_Liga,2023_2024
Martim Tavares,POR,"FW,MF",Boavista,19,2003,6.0,4,3,1,3,0,1,4,25.0,3,6,3,3,2,6,4,0,Primeira_Liga,2023_2024
Ronaldo Tavares,POR,FW,Estrela,26,1997,12.8,9,4,2,4,3,2,4,50.0,2,10,1,9,2,11,15,0,Primeira_Liga,2023_2024
Duplexe Tchamba,CMR,DF,Casa Pia,25,1998,13.9,23,14,17,5,1,16,26,61.5,10,14,6,8,18,41,79,1,Primeira_Liga,2023_2024
João Teixeira,POR,"MF,FW",Rio Ave,29,1994,8.0,17,10,9,7,1,9,21,42.9,12,14,2,12,4,21,5,0,Primeira_Liga,2023_2024
Casper Tengstedt,DEN,FW,Benfica,23,2000,7.4,11,5,2,5,4,7,12,58.3,5,6,0,6,0,11,2,0,Primeira_Liga,2023_2024
Pedro Tiba,POR,MF,Gil Vicente FC,34,1988,16.6,46,35,23,15,8,22,44,50.0,22,15,4,11,15,61,17,0,Primeira_Liga,2023_2024
Mirko Topić,SRB,MF,Famalicão,22,2001,26.1,51,39,24,24,3,22,32,68.8,10,27,4,23,47,98,47,1,Primeira_Liga,2023_2024
Alfonso Trezza,URU,"FW,MF",Arouca,24,1999,9.3,17,14,11,6,0,7,24,29.2,17,15,0,15,6,23,8,0,Primeira_Liga,2023_2024
Francisco Trincão,POR,"FW,MF",Sporting CP,23,1999,18.9,28,19,8,16,4,9,24,37.5,15,13,2,11,4,32,8,0,Primeira_Liga,2023_2024
Anatolii Trubin,UKR,GK,Benfica,21,2001,28.0,1,1,1,0,0,1,2,50.0,1,0,0,0,1,2,10,3,Primeira_Liga,2023_2024
Ukra,POR,"FW,MF",Rio Ave,35,1988,0.9,0,0,0,0,0,0,1,0.0,1,0,0,0,0,0,0,0,Primeira_Liga,2023_2024
Iker Unzueta,ESP,FW,Vizela,24,1998,0.3,0,0,0,0,0,0,0,,0,0,0,0,0,0,0,0,Primeira_Liga,2023_2024
João Valido,POR,GK,Arouca,23,2000,1.0,1,1,1,0,0,1,2,50.0,1,0,0,0,0,1,2,0,Primeira_Liga,2023_2024
Alan Varela,ARG,MF,Porto,22,2001,24.7,36,20,11,21,4,15,35,42.9,20,32,8,24,23,59,28,0,Primeira_Liga,2023_2024
Bruno Varela,CPV,GK,Vitória,28,1994,26.5,0,0,0,0,0,0,1,0.0,1,0,0,0,0,0,9,1,Primeira_Liga,2023_2024
Fernando Varela,CPV,DF,Casa Pia,35,1987,23.0,28,20,20,7,1,15,23,65.2,8,33,19,14,17,45,113,0,Primeira_Liga,2023_2024
Gustavo Varela,POR,FW,Benfica,18,2005,0.2,0,0,0,0,0,0,0,,0,0,0,0,0,0,0,0,Primeira_Liga,2023_2024
Hélio Varela,CPV,"FW,MF",Portimonense,21,2002,30.5,35,22,19,10,6,14,39,35.9,25,29,4,25,15,50,31,0,Primeira_Liga,2023_2024
Nilton Varela,POR,"DF,MF",Estrela,22,2001,6.2,20,15,15,5,0,16,22,72.7,6,5,1,4,4,24,9,0,Primeira_Liga,2023_2024
Jhon Velásquez,COL,"FW,MF",Farense,28,1995,0.3,0,0,0,0,0,0,1,0.0,1,0,0,0,0,0,1,0,Primeira_Liga,2023_2024
Ricardo Velho,POR,GK,Farense,24,1998,32.0,0,0,0,0,0,0,1,0.0,1,0,0,0,0,0,21,2,Primeira_Liga,2023_2024
Bruno Ventura,POR,"FW,MF",Rio Ave,22,2001,5.8,3,1,2,0,1,2,7,28.6,5,3,0,3,2,5,7,0,Primeira_Liga,2023_2024
João Victor,BRA,DF,Benfica,25,1998,0.3,0,0,0,0,0,0,0,,0,2,1,1,1,1,0,0,Primeira_Liga,2023_2024
Paulo Victor,BRA,"FW,MF",Chaves,22,2001,9.1,14,8,4,10,0,5,9,55.6,4,15,2,13,6,20,5,0,Primeira_Liga,2023_2024
Kiko Vilas Boas,POR,DF,Gil Vicente FC,23,1999,6.3,18,11,11,7,0,8,11,72.7,3,3,0,3,7,25,26,0,Primeira_Liga,2023_2024
Mikel Villanueva,VEN,DF,Vitória,30,1993,5.1,4,3,1,1,2,3,4,75.0,1,8,5,3,8,12,16,0,Primeira_Liga,2023_2024
Marcos Vinicios Sorriso,BRA,"FW,MF",Famalicão,22,2001,9.5,14,9,4,8,2,8,17,47.1,9,11,0,11,7,21,11,0,Primeira_Liga,2023_2024
Bernardo Vital,POR,DF,Estoril,22,2000,28.3,39,21,24,14,1,23,40,57.5,17,38,24,14,23,62,107,2,Primeira_Liga,2023_2024
Vitinho,BRA,"FW,MF",Arouca,23,2000,1.1,4,4,3,0,1,1,3,33.3,2,2,0,2,2,6,1,0,Primeira_Liga,2023_2024
Steven Vitória,CAN,DF,Chaves,36,1987,15.0,11,8,8,3,0,8,9,88.9,1,17,14,3,4,15,75,3,Primeira_Liga,2023_2024
Odisseas Vlachodimos,GRE,GK,Benfica,29,1994,1.0,0,0,0,0,0,0,0,,0,0,0,0,0,0,0,0,Primeira_Liga,2023_2024
Marious Vrousai,GRE,"MF,DF",Rio Ave,25,1998,7.4,20,13,9,9,2,10,18,55.6,8,15,3,12,6,26,18,0,Primeira_Liga,2023_2024
Ilija Vukotić,MNE,MF,Boavista,24,1999,11.1,22,16,8,10,4,13,25,52.0,12,7,4,3,3,25,27,0,Primeira_Liga,2023_2024
Masaki Watai,JPN,"FW,MF",Boavista,24,1999,4.8,8,4,4,2,2,2,10,20.0,8,4,0,4,5,13,2,0,Primeira_Liga,2023_2024
Wendell,BRA,DF,Porto,30,1993,23.3,40,23,16,23,1,21,37,56.8,16,21,3,18,14,54,42,0,Primeira_Liga,2023_2024
Weverson,BRA,DF,Arouca,23,2000,22.2,53,29,25,24,4,34,48,70.8,14,28,6,22,17,70,46,0,Primeira_Liga,2023_2024
Bruno Wilson,POR,DF,Vizela,26,1996,15.6,15,8,9,5,1,11,14,78.6,3,20,14,6,19,34,62,0,Primeira_Liga,2023_2024
Roan Wilson,CRC,"MF,DF",Gil Vicente FC,21,2002,1.4,8,4,2,6,0,4,6,66.7,2,3,0,3,2,10,3,0,Primeira_Liga,2023_2024
Frederik Winther,DEN,DF,Estoril,22,2001,1.3,0,0,0,0,0,0,1,0.0,1,0,0,0,0,0,9,1,Primeira_Liga,2023_2024
Abdul-Aziz Yakubu,GHA,FW,Rio Ave,24,1998,12.4,2,2,0,2,0,1,8,12.5,7,3,2,1,0,2,17,0,Primeira_Liga,2023_2024
Moses Yaw,GHA,"DF,MF",Arouca,24,1999,0.8,1,1,1,0,0,1,1,100.0,0,1,0,1,0,1,1,0,Primeira_Liga,2023_2024
Zaydou Youssouf,FRA,MF,Famalicão,24,1999,30.7,76,48,34,32,10,28,60,46.7,32,32,2,30,27,103,25,0,Primeira_Liga,2023_2024
Rodrigo Zalazar,URU,MF,Braga,23,1999,20.2,40,27,11,24,5,18,42,42.9,24,33,3,30,9,49,16,3,Primeira_Liga,2023_2024
Vinícius Zanocelo,BRA,MF,Estoril,22,2001,12.4,18,9,9,8,1,8,21,38.1,13,7,2,5,10,28,25,0,Primeira_Liga,2023_2024
Zinho,BRA,"FW,MF",Portimonense,20,2003,1.6,4,3,1,1,2,3,4,75.0,1,2,0,2,1,5,1,0,Primeira_Liga,2023_2024
Ivan Zlobin,RUS,GK,Famalicão,26,1997,1.0,0,0,0,0,0,0,0,,0,0,0,0,0,0,0,0,Primeira_Liga,2023_2024
Nermin Zolotić,BIH,DF,Casa Pia,30,1993,29.7,41,29,26,14,1,32,49,65.3,17,40,22,18,28,69,127,2,Primeira_Liga,2023_2024
