squad,#_of_players,90s_played,tackles,tackles_won,tackles_(def_3rd),tackles_(mid_3rd),tackles_(att_3rd),dribblers_tackled,dribbles_challenged,%_of_dribblers_tackled,challenges_lost,blocks,shots_blocked,passes_blocked,interceptions,tkl+int,clearances,errors,league,season
Atalanta,29,38,613,369,273,249,91,291,597,48,306,483,119,364,340,953,614,7,Serie_A,2023_2024
Bologna,28,38,633,385,299,267,67,303,579,52,276,426,113,313,258,891,677,17,Serie_A,2023_2024
Cagliari,29,38,540,315,272,203,65,264,525,50,261,373,113,260,265,805,816,12,Serie_A,2023_2024
Empoli,34,38,618,378,311,227,80,300,564,53,264,462,154,308,263,881,840,9,Serie_A,2023_2024
Fiorentina,30,38,564,320,242,231,91,275,512,53,237,388,81,307,236,800,509,8,Serie_A,2023_2024
Frosinone,34,38,545,322,244,225,76,253,525,48,272,439,143,296,241,786,789,14,Serie_A,2023_2024
Genoa,34,38,625,352,315,247,63,283,571,49,288,462,162,300,332,957,796,11,Serie_A,2023_2024
Hellas Verona,36,38,621,387,302,245,74,293,578,50,285,414,133,281,302,923,784,15,Serie_A,2023_2024
Inter,27,38,540,321,252,219,69,234,474,49,240,365,116,249,280,820,576,7,Serie_A,2023_2024
Juventus,31,38,577,369,270,233,74,264,445,59,181,375,124,251,253,830,725,4,Serie_A,2023_2024
Lazio,22,38,581,348,259,254,68,283,618,45,335,430,122,308,295,876,640,7,Serie_A,2023_2024
Lecce,26,38,605,374,285,252,68,289,566,51,277,429,117,312,308,913,751,8,Serie_A,2023_2024
Milan,35,38,576,333,274,232,70,273,521,52,248,367,146,221,252,828,548,16,Serie_A,2023_2024
Monza,31,38,565,334,307,195,63,266,484,55,218,378,151,227,279,844,642,8,Serie_A,2023_2024
Napoli,29,38,571,326,235,237,99,263,554,47,291,351,92,259,241,812,521,5,Serie_A,2023_2024
Roma,30,38,569,336,261,229,79,249,535,46,286,370,132,238,242,811,623,16,Serie_A,2023_2024
Salernitana,39,38,536,327,289,198,49,257,519,49,262,409,161,248,279,815,816,12,Serie_A,2023_2024
Sassuolo,30,38,507,310,241,198,68,245,531,46,286,402,143,259,267,774,767,14,Serie_A,2023_2024
Torino,30,38,471,275,207,213,51,191,386,49,195,303,100,203,329,800,594,15,Serie_A,2023_2024
Udinese,32,38,606,381,345,213,48,299,571,52,272,437,129,308,327,933,988,10,Serie_A,2023_2024
Arouca,35,34,496,308,231,211,54,269,557,48,288,316,71,245,355,851,616,8,Primeira_Liga,2021_2022
B-SAD,37,34,455,269,238,163,54,235,528,44,293,374,138,236,334,789,679,5,Primeira_Liga,2021_2022
Benfica,35,34,551,339,234,236,81,284,541,52,257,347,92,255,319,870,449,7,Primeira_Liga,2021_2022
Boavista,28,34,567,337,310,210,47,286,609,47,323,336,100,236,379,946,646,6,Primeira_Liga,2021_2022
Braga,40,34,470,284,185,209,76,211,523,40,312,344,92,252,336,806,550,8,Primeira_Liga,2021_2022
Estoril,31,34,447,252,213,172,62,221,474,46,253,348,152,196,298,745,636,14,Primeira_Liga,2021_2022
Famalicão,37,34,550,334,265,215,70,296,611,48,315,344,107,237,404,954,704,10,Primeira_Liga,2021_2022
Gil Vicente FC,29,34,430,248,170,203,57,170,447,38,277,323,111,212,282,712,633,10,Primeira_Liga,2021_2022
Marítimo,30,34,585,362,287,245,53,249,525,47,276,382,122,260,343,928,642,8,Primeira_Liga,2021_2022
Moreirense,29,34,502,294,247,201,54,225,537,41,312,317,93,224,311,813,674,10,Primeira_Liga,2021_2022
Paços,30,34,492,285,239,191,62,270,642,42,372,328,109,219,376,868,637,9,Primeira_Liga,2021_2022
Portimonense,35,34,473,280,250,172,51,228,497,45,269,344,131,213,355,828,669,6,Primeira_Liga,2021_2022
Porto,33,34,553,340,178,258,117,273,573,47,300,299,52,247,323,876,407,6,Primeira_Liga,2021_2022
Santa Clara,32,34,524,323,279,198,47,262,539,48,277,322,97,225,378,902,657,11,Primeira_Liga,2021_2022
Sporting CP,31,34,567,333,237,261,69,262,577,45,315,331,67,264,341,908,427,7,Primeira_Liga,2021_2022
Tondela,27,34,586,376,330,207,49,305,599,50,294,318,95,223,348,934,669,6,Primeira_Liga,2021_2022
Vitória,31,34,470,290,215,188,67,238,516,46,278,279,77,202,322,792,554,10,Primeira_Liga,2021_2022
Vizela,31,34,534,322,271,192,71,266,585,45,319,314,99,215,384,918,695,9,Primeira_Liga,2021_2022
Brest,25,34,679,427,295,299,85,306,715,42,409,386,100,286,321,1000,644,13,Ligue_1,2023_2024
Clermont Foot,31,34,581,358,279,242,60,312,633,49,321,382,130,252,347,928,667,19,Ligue_1,2023_2024
Le Havre,27,34,560,332,293,207,60,283,572,49,289,362,124,238,363,923,664,10,Ligue_1,2023_2024
Lens,27,34,554,339,213,266,75,291,569,51,278,392,112,280,298,852,549,16,Ligue_1,2023_2024
Lille,28,34,594,370,267,242,85,278,580,47,302,319,80,239,292,886,574,10,Ligue_1,2023_2024
Lorient,38,34,538,326,284,195,59,252,531,47,279,391,129,262,337,875,805,14,Ligue_1,2023_2024
Lyon,35,34,538,331,241,203,94,250,578,43,328,343,118,225,304,842,563,12,Ligue_1,2023_2024
Marseille,33,34,604,371,270,264,70,292,587,49,295,365,99,266,332,936,633,8,Ligue_1,2023_2024
Metz,30,34,562,334,310,183,69,238,514,46,276,416,127,289,348,910,834,9,Ligue_1,2023_2024
Monaco,30,34,664,412,259,314,91,322,686,46,364,418,85,333,394,1058,582,14,Ligue_1,2023_2024
Montpellier,31,34,619,379,352,187,80,310,691,44,381,427,161,266,308,927,766,5,Ligue_1,2023_2024
Nantes,35,34,582,352,307,220,55,298,616,48,318,339,102,237,332,914,697,4,Ligue_1,2023_2024
Nice,27,34,538,308,247,212,79,285,505,56,220,389,111,278,292,830,505,10,Ligue_1,2023_2024
Paris S-G,29,34,585,360,254,221,110,283,602,47,319,346,108,238,268,853,509,22,Ligue_1,2023_2024
Reims,29,34,640,392,303,246,91,320,639,50,319,398,133,265,342,982,671,10,Ligue_1,2023_2024
Rennes,29,34,526,311,261,190,75,280,525,53,245,371,106,265,328,854,618,10,Ligue_1,2023_2024
Strasbourg,30,34,620,383,317,240,63,308,572,53,264,406,115,291,347,967,682,13,Ligue_1,2023_2024
Toulouse,26,34,612,358,295,241,76,294,626,47,332,431,148,283,294,906,715,6,Ligue_1,2023_2024
Angers,30,38,619,370,301,253,65,284,659,43,375,384,99,285,423,1042,631,9,Ligue_1,2021_2022
Bordeaux,39,38,642,377,321,243,78,323,741,43,418,357,104,253,454,1096,688,19,Ligue_1,2021_2022
Brest,25,38,682,400,342,249,91,310,655,47,345,369,108,261,469,1151,707,4,Ligue_1,2021_2022
Clermont Foot,28,38,622,361,285,262,75,291,665,43,374,372,99,273,386,1008,527,9,Ligue_1,2021_2022
Lens,28,38,591,359,273,243,75,266,602,44,336,360,99,261,455,1046,616,7,Ligue_1,2021_2022
Lille,26,38,653,359,310,274,69,305,619,49,314,351,111,240,377,1030,672,6,Ligue_1,2021_2022
Lorient,29,38,696,412,337,292,67,383,811,47,428,405,115,290,412,1108,776,9,Ligue_1,2021_2022
Lyon,30,38,632,367,264,270,98,279,614,45,335,385,91,294,396,1028,621,17,Ligue_1,2021_2022
Marseille,27,38,556,319,252,238,66,232,501,46,269,263,65,198,327,883,437,10,Ligue_1,2021_2022
Metz,36,38,711,442,395,275,41,300,649,46,349,452,139,313,507,1218,782,11,Ligue_1,2021_2022
Monaco,27,38,745,435,292,368,85,324,701,46,377,378,103,275,424,1169,487,10,Ligue_1,2021_2022
Montpellier,27,38,625,380,340,210,75,309,723,42,414,363,134,229,356,981,675,13,Ligue_1,2021_2022
Nantes,26,38,685,405,331,262,92,353,774,45,421,419,136,283,415,1100,680,9,Ligue_1,2021_2022
Nice,27,38,610,369,291,253,66,314,590,53,276,392,119,273,441,1051,595,7,Ligue_1,2021_2022
Paris S-G,36,38,607,360,229,276,102,290,599,48,309,330,106,224,303,910,437,14,Ligue_1,2021_2022
Reims,35,38,615,365,328,221,66,286,629,45,343,460,154,306,493,1108,753,7,Ligue_1,2021_2022
Rennes,28,38,546,318,234,215,97,261,550,47,289,347,92,255,315,861,646,12,Ligue_1,2021_2022
Saint-Étienne,39,38,695,397,341,265,89,295,638,46,343,398,93,305,452,1147,563,10,Ligue_1,2021_2022
Strasbourg,26,38,660,392,302,257,101,293,626,46,333,380,93,287,433,1093,563,6,Ligue_1,2021_2022
Troyes,35,38,636,351,351,221,64,285,625,45,340,375,107,268,430,1066,656,8,Ligue_1,2021_2022
Augsburg,29,34,528,319,234,222,72,237,492,48,255,439,133,306,295,823,727,9,Bundesliga,2023_2024
Bayern Munich,30,34,520,323,227,191,102,245,510,48,265,378,81,297,288,808,473,18,Bundesliga,2023_2024
Bochum,25,34,603,366,272,253,78,294,574,51,280,460,142,318,308,911,768,9,Bundesliga,2023_2024
Darmstadt 98,32,34,560,323,303,197,60,285,583,48,298,400,137,263,317,877,707,19,Bundesliga,2023_2024
Dortmund,32,34,548,356,297,201,50,292,557,52,265,431,121,310,251,799,628,12,Bundesliga,2023_2024
Eint Frankfurt,34,34,602,359,282,240,80,293,548,53,255,424,99,325,302,904,704,12,Bundesliga,2023_2024
Freiburg,25,34,546,319,303,175,68,227,463,49,236,436,149,287,272,818,725,7,Bundesliga,2023_2024
Gladbach,27,34,582,337,291,247,44,287,534,53,247,465,168,297,333,915,860,15,Bundesliga,2023_2024
Heidenheim,22,34,601,352,311,225,65,275,591,46,316,463,129,334,302,903,783,5,Bundesliga,2023_2024
Hoffenheim,30,34,517,304,286,185,46,259,541,47,282,413,143,270,357,874,790,12,Bundesliga,2023_2024
Köln,26,34,617,375,330,234,53,342,659,51,317,506,154,352,305,922,766,9,Bundesliga,2023_2024
Leverkusen,24,34,458,277,183,187,88,197,403,48,206,330,72,258,224,682,460,9,Bundesliga,2023_2024
Mainz 05,30,34,572,328,256,253,63,276,526,52,250,442,117,325,346,918,704,3,Bundesliga,2023_2024
RB Leipzig,26,34,538,317,236,240,62,244,487,50,243,444,97,347,240,778,630,12,Bundesliga,2023_2024
Stuttgart,27,34,537,316,222,239,76,253,513,49,260,378,109,269,269,806,619,12,Bundesliga,2023_2024
Union Berlin,30,34,549,352,242,240,67,254,504,50,250,480,137,343,305,854,861,9,Bundesliga,2023_2024
Werder Bremen,30,34,604,351,303,239,62,312,609,51,297,434,153,281,284,888,785,9,Bundesliga,2023_2024
Wolfsburg,28,34,550,303,272,201,77,262,527,49,265,414,99,315,268,818,801,8,Bundesliga,2023_2024
Augsburg,34,34,522,299,251,202,69,232,479,48,247,428,125,303,286,808,755,14,Bundesliga,2022_2023
Bayern Munich,28,34,623,387,263,258,102,287,538,53,251,381,77,304,287,910,477,19,Bundesliga,2022_2023
Bochum,26,34,626,386,301,247,78,310,635,48,325,402,118,284,337,963,776,13,Bundesliga,2022_2023
Dortmund,30,34,580,334,246,241,93,287,551,52,264,382,95,287,298,878,491,9,Bundesliga,2022_2023
Eint Frankfurt,28,34,562,357,244,248,70,265,585,45,320,415,88,327,284,846,687,5,Bundesliga,2022_2023
Freiburg,27,34,498,289,223,211,64,207,451,45,244,375,106,269,325,823,612,10,Bundesliga,2022_2023
Gladbach,27,34,497,275,274,171,52,267,536,49,269,405,104,301,267,764,728,7,Bundesliga,2022_2023
Hertha BSC,32,34,576,344,307,215,54,251,521,48,270,416,132,284,366,942,797,8,Bundesliga,2022_2023
Hoffenheim,31,34,543,323,254,231,58,236,474,49,238,428,119,309,285,828,665,8,Bundesliga,2022_2023
Köln,27,34,615,370,287,263,65,310,666,46,356,423,99,324,372,987,716,5,Bundesliga,2022_2023
Leverkusen,27,34,494,280,242,206,46,236,421,56,185,358,99,259,294,788,599,12,Bundesliga,2022_2023
Mainz 05,27,34,547,341,268,206,73,270,559,48,289,419,98,321,433,980,673,9,Bundesliga,2022_2023
RB Leipzig,25,34,534,312,237,231,66,253,512,49,259,428,94,334,310,844,552,3,Bundesliga,2022_2023
Schalke 04,35,34,542,329,240,246,56,253,551,45,298,397,110,287,306,848,723,12,Bundesliga,2022_2023
Stuttgart,30,34,528,316,255,207,66,268,524,51,256,421,113,308,308,836,666,10,Bundesliga,2022_2023
Union Berlin,28,34,494,278,217,216,61,239,525,45,286,356,101,255,262,756,704,6,Bundesliga,2022_2023
Werder Bremen,25,34,595,349,269,273,53,300,617,48,317,371,103,268,321,916,789,7,Bundesliga,2022_2023
Wolfsburg,28,34,543,324,255,206,82,265,521,50,256,443,116,327,292,835,701,9,Bundesliga,2022_2023
Atalanta,32,38,630,341,252,271,107,299,635,47,336,436,96,340,441,1071,483,6,Serie_A,2021_2022
Bologna,36,38,530,298,261,202,67,216,528,40,312,384,127,257,370,900,678,5,Serie_A,2021_2022
Cagliari,33,38,557,303,263,229,65,230,544,42,314,406,128,278,397,954,747,5,Serie_A,2021_2022
Empoli,28,38,568,327,268,208,92,273,606,45,333,451,177,274,352,920,772,10,Serie_A,2021_2022
Fiorentina,28,38,508,301,232,203,73,268,540,49,272,357,91,266,244,752,407,15,Serie_A,2021_2022
Genoa,40,38,739,416,324,302,113,349,727,48,378,487,134,353,449,1188,751,15,Serie_A,2021_2022
Hellas Verona,31,38,534,308,248,214,72,238,557,42,319,414,107,307,392,926,779,9,Serie_A,2021_2022
Inter,27,38,588,332,265,240,83,247,545,45,298,360,110,250,332,920,485,11,Serie_A,2021_2022
Juventus,32,38,555,316,260,217,78,236,529,44,293,392,134,258,332,887,677,9,Serie_A,2021_2022
Lazio,27,38,578,339,246,255,77,238,621,38,383,416,144,272,315,893,565,10,Serie_A,2021_2022
Milan,28,38,697,421,304,288,105,281,583,48,302,371,110,261,355,1052,477,12,Serie_A,2021_2022
Napoli,27,38,550,327,246,227,77,268,617,43,349,371,108,263,296,846,510,8,Serie_A,2021_2022
Roma,29,38,613,362,282,253,78,283,622,45,339,383,82,301,385,998,552,9,Serie_A,2021_2022
Salernitana,42,38,541,321,274,208,59,277,579,47,302,394,146,248,353,894,777,3,Serie_A,2021_2022
Sampdoria,34,38,562,327,277,217,68,288,629,45,341,383,134,249,443,1005,723,11,Serie_A,2021_2022
Sassuolo,29,38,482,271,252,163,67,236,574,41,338,422,127,295,314,796,664,19,Serie_A,2021_2022
Spezia,30,38,580,343,301,205,74,266,585,45,319,465,176,289,372,952,736,8,Serie_A,2021_2022
Torino,31,38,531,314,223,234,74,228,440,51,212,375,108,267,423,954,651,4,Serie_A,2021_2022
Udinese,29,38,622,350,282,271,69,284,643,44,359,432,122,310,351,973,671,12,Serie_A,2021_2022
Venezia,39,38,613,352,325,217,71,273,626,43,353,495,202,293,388,1001,865,13,Serie_A,2021_2022
Arsenal,26,38,568,343,238,212,118,249,509,48,260,362,86,276,237,805,599,23,Premier_League,2022_2023
Aston Villa,26,38,632,338,305,251,76,312,648,48,336,438,118,320,324,956,714,14,Premier_League,2022_2023
Bournemouth,31,38,618,371,316,249,53,256,614,41,358,499,170,329,353,971,1027,11,Premier_League,2022_2023
Brentford,25,38,588,338,271,228,89,253,599,42,346,456,168,288,341,929,822,14,Premier_League,2022_2023
Brighton,29,38,616,340,270,242,104,266,561,47,295,392,104,288,303,919,432,15,Premier_League,2022_2023
Chelsea,32,38,740,445,363,267,110,333,656,50,323,466,108,358,341,1081,661,21,Premier_League,2022_2023
Crystal Palace,26,38,690,421,354,246,90,281,532,52,251,463,119,344,359,1049,807,7,Premier_League,2022_2023
Everton,28,38,708,424,362,257,89,309,619,49,310,510,180,330,390,1098,874,17,Premier_League,2022_2023
Fulham,29,38,625,350,295,229,101,299,588,50,289,455,125,330,340,965,749,15,Premier_League,2022_2023
Leeds United,29,38,840,480,376,343,121,412,863,47,451,536,131,405,392,1232,734,18,Premier_League,2022_2023
Leicester City,28,38,699,412,345,291,63,308,677,45,369,517,170,347,367,1066,777,12,Premier_League,2022_2023
Liverpool,28,38,590,370,228,250,112,281,651,43,370,350,74,276,333,923,568,20,Premier_League,2022_2023
Manchester City,24,38,471,272,185,198,88,212,462,45,250,339,95,244,223,694,402,9,Premier_League,2022_2023
Manchester Utd,26,38,657,400,343,231,83,300,600,50,300,496,146,350,352,1009,771,11,Premier_League,2022_2023
Newcastle Utd,27,38,607,360,268,254,85,307,642,47,335,448,116,332,333,940,680,10,Premier_League,2022_2023
Nott'ham Forest,33,38,659,387,380,201,78,296,589,50,293,500,156,344,349,1008,944,7,Premier_League,2022_2023
Southampton,36,38,714,426,378,279,57,297,612,48,315,542,165,377,427,1141,852,11,Premier_League,2022_2023
Tottenham,29,38,619,353,325,215,79,275,574,47,299,428,148,280,340,959,762,20,Premier_League,2022_2023
West Ham,25,38,608,336,290,226,92,270,563,48,293,415,139,276,408,1016,810,10,Premier_League,2022_2023
Wolves,32,38,660,370,363,222,75,285,616,46,331,497,175,322,279,939,817,19,Premier_League,2022_2023
Arouca,29,34,568,342,305,211,52,282,594,47,312,369,114,255,355,923,777,7,Primeira_Liga,2022_2023
Benfica,32,34,660,395,243,305,112,365,654,55,289,327,52,275,364,1024,390,7,Primeira_Liga,2022_2023
Boavista,30,34,562,333,293,222,47,271,550,49,279,282,69,213,362,924,636,4,Primeira_Liga,2022_2023
Braga,31,34,530,314,222,222,86,265,582,45,317,373,95,278,374,904,587,3,Primeira_Liga,2022_2023
Casa Pia,31,34,551,318,269,248,34,297,641,46,344,414,128,286,350,901,709,9,Primeira_Liga,2022_2023
Chaves,31,34,477,303,240,182,55,247,561,44,314,428,158,270,336,813,739,10,Primeira_Liga,2022_2023
Estoril,33,34,513,316,251,209,53,270,512,52,242,333,120,213,250,763,647,12,Primeira_Liga,2022_2023
Famalicão,33,34,587,360,300,227,60,280,596,47,316,396,127,269,330,917,717,5,Primeira_Liga,2022_2023
Gil Vicente FC,32,34,539,316,253,209,77,285,572,49,287,369,114,255,306,845,593,6,Primeira_Liga,2022_2023
Marítimo,39,34,594,362,282,234,78,313,582,53,269,344,93,251,334,928,554,11,Primeira_Liga,2022_2023
Paços,36,34,487,292,254,170,63,248,530,46,282,347,115,232,330,817,656,16,Primeira_Liga,2022_2023
Portimonense,35,34,532,331,241,225,66,241,515,46,274,399,126,273,339,871,722,12,Primeira_Liga,2022_2023
Porto,28,34,593,358,251,234,108,305,617,49,312,324,67,257,333,926,487,7,Primeira_Liga,2022_2023
Rio Ave,30,34,542,334,264,231,47,271,548,49,277,390,129,261,298,840,700,12,Primeira_Liga,2022_2023
Santa Clara,34,34,546,342,262,228,56,274,578,47,304,366,112,254,314,860,735,7,Primeira_Liga,2022_2023
Sporting CP,32,34,595,352,203,298,94,312,597,52,285,295,70,225,293,888,363,7,Primeira_Liga,2022_2023
Vitória,34,34,579,353,325,187,67,287,541,53,254,359,97,262,350,929,703,5,Primeira_Liga,2022_2023
Vizela,30,34,558,319,262,227,69,296,546,54,250,370,132,238,381,939,817,5,Primeira_Liga,2022_2023
Arsenal,27,38,540,311,261,195,84,244,500,48,256,386,123,263,296,836,658,20,Premier_League,2021_2022
Aston Villa,31,38,634,382,300,259,75,300,649,46,349,453,140,313,339,973,693,13,Premier_League,2021_2022
Brentford,29,38,607,342,299,228,80,291,616,47,325,383,113,270,393,1000,863,7,Premier_League,2021_2022
Brighton,26,38,668,403,306,257,105,243,563,43,320,480,150,330,358,1026,723,12,Premier_League,2021_2022
Burnley,23,38,590,324,273,235,82,250,534,46,284,509,211,298,410,1000,887,18,Premier_League,2021_2022
Chelsea,26,38,621,348,267,269,85,257,567,45,310,408,96,312,347,968,641,15,Premier_League,2021_2022
Crystal Palace,24,38,637,374,323,236,78,273,575,47,302,452,135,317,333,970,761,5,Premier_League,2021_2022
Everton,33,38,705,402,369,252,84,336,735,45,399,496,140,356,365,1070,815,15,Premier_League,2021_2022
Leeds United,29,38,787,437,396,298,93,408,886,46,478,473,143,330,395,1182,621,15,Premier_League,2021_2022
Leicester City,28,38,690,384,336,270,84,306,720,42,414,469,146,323,367,1057,777,15,Premier_League,2021_2022
Liverpool,27,38,554,320,207,240,107,233,576,40,343,359,74,285,340,894,523,8,Premier_League,2021_2022
Manchester City,26,38,498,284,183,214,101,227,509,44,282,267,55,212,279,777,403,7,Premier_League,2021_2022
Manchester Utd,29,38,585,358,320,197,68,265,608,43,343,404,133,271,340,925,704,20,Premier_League,2021_2022
Newcastle Utd,29,38,659,383,334,266,59,304,641,47,337,420,162,258,360,1019,776,14,Premier_League,2021_2022
Norwich City,28,38,614,368,322,242,50,297,714,41,417,450,180,270,381,995,860,14,Premier_League,2021_2022
Southampton,25,38,602,340,285,243,74,248,581,42,333,430,132,298,446,1048,795,13,Premier_League,2021_2022
Tottenham,25,38,598,349,286,244,68,262,584,44,322,470,161,309,355,953,793,15,Premier_League,2021_2022
Watford,30,38,614,356,341,213,60,278,626,44,348,440,148,292,444,1058,899,19,Premier_League,2021_2022
West Ham,25,38,534,301,273,199,62,240,557,43,317,420,175,245,374,908,781,5,Premier_League,2021_2022
Wolves,26,38,673,377,377,242,54,273,671,40,398,437,135,302,389,1062,820,20,Premier_League,2021_2022
Arminia,26,34,549,311,270,235,44,238,543,43,305,395,110,285,421,970,770,7,Bundesliga,2021_2022
Augsburg,26,34,561,335,254,236,71,250,584,42,334,397,116,281,363,924,769,12,Bundesliga,2021_2022
Bayern Munich,30,34,563,338,231,237,95,259,559,46,300,338,68,270,349,912,404,18,Bundesliga,2021_2022
Bochum,28,34,566,353,298,199,69,277,574,48,297,420,119,301,429,995,616,13,Bundesliga,2021_2022
Dortmund,33,34,541,322,232,236,73,255,550,46,295,351,82,269,347,888,519,11,Bundesliga,2021_2022
Eint Frankfurt,27,34,595,330,260,252,83,283,673,42,390,435,95,340,377,972,592,12,Bundesliga,2021_2022
Freiburg,26,34,518,299,246,207,65,215,477,45,262,352,130,222,355,873,751,13,Bundesliga,2021_2022
Gladbach,26,34,572,345,260,252,60,285,615,46,330,402,91,311,326,898,553,13,Bundesliga,2021_2022
Greuther Fürth,29,34,568,336,258,252,58,270,567,47,297,416,124,292,374,942,712,8,Bundesliga,2021_2022
Hertha BSC,36,34,546,321,294,197,55,252,544,46,292,377,105,272,406,952,816,15,Bundesliga,2021_2022
Hoffenheim,32,34,483,291,191,216,76,223,484,46,261,390,88,302,285,768,520,17,Bundesliga,2021_2022
Köln,26,34,598,361,264,246,88,288,665,43,377,442,99,343,426,1024,628,10,Bundesliga,2021_2022
Leverkusen,29,34,484,281,235,199,50,225,493,45,268,350,101,249,360,844,620,12,Bundesliga,2021_2022
Mainz 05,28,34,579,305,291,220,68,282,595,47,313,404,94,310,439,1018,584,9,Bundesliga,2021_2022
RB Leipzig,29,34,499,289,218,222,59,219,512,42,293,399,81,318,349,848,523,12,Bundesliga,2021_2022
Stuttgart,34,34,532,307,231,236,65,241,530,45,289,386,124,262,342,874,708,8,Bundesliga,2021_2022
Union Berlin,28,34,538,296,266,223,49,268,568,47,300,322,90,232,376,914,657,7,Bundesliga,2021_2022
Wolfsburg,30,34,539,298,278,201,60,257,540,47,283,388,103,285,388,927,740,9,Bundesliga,2021_2022
Almería,29,38,557,322,292,202,63,280,623,44,343,435,122,313,322,879,855,13,La_Liga,2022_2023
Athletic Club,26,38,608,369,267,254,87,322,642,50,320,415,95,320,310,918,598,14,La_Liga,2022_2023
Atlético Madrid,27,38,667,408,332,245,90,334,685,48,351,396,103,293,304,971,704,9,La_Liga,2022_2023
Barcelona,29,38,522,324,211,216,95,227,498,45,271,353,82,271,253,775,439,17,La_Liga,2022_2023
Betis,30,38,665,421,373,238,54,338,701,48,363,411,112,299,364,1029,857,7,La_Liga,2022_2023
Cádiz,38,38,623,410,358,205,60,320,671,47,351,425,128,297,270,893,853,13,La_Liga,2022_2023
Celta Vigo,26,38,664,413,319,269,76,295,676,43,381,393,84,309,368,1032,666,5,La_Liga,2022_2023
Elche,32,38,633,363,367,212,54,280,603,46,323,413,131,282,323,956,766,13,La_Liga,2022_2023
Espanyol,33,38,652,379,330,239,83,301,600,50,299,416,134,282,338,990,788,9,La_Liga,2022_2023
Getafe,25,38,541,339,282,199,60,285,619,46,334,404,113,291,320,861,794,10,La_Liga,2022_2023
Girona,29,38,551,321,271,213,67,244,532,45,288,379,111,268,266,817,662,20,La_Liga,2022_2023
Mallorca,31,38,583,344,318,213,52,283,581,48,298,402,146,256,318,901,859,7,La_Liga,2022_2023
Osasuna,26,38,534,328,256,196,82,266,588,45,322,392,97,295,315,849,749,10,La_Liga,2022_2023
Rayo Vallecano,28,38,636,393,262,276,98,281,664,42,383,428,92,336,309,945,680,11,La_Liga,2022_2023
Real Madrid,26,38,542,353,242,212,88,259,565,45,306,365,105,260,296,838,469,5,La_Liga,2022_2023
Real Sociedad,30,38,660,395,304,254,102,285,613,46,328,399,103,296,271,931,624,13,La_Liga,2022_2023
Sevilla,35,38,587,367,261,230,96,281,591,47,310,361,127,234,339,926,633,9,La_Liga,2022_2023
Valencia,28,38,678,428,340,254,84,311,645,48,334,370,75,295,288,966,643,21,La_Liga,2022_2023
Valladolid,36,38,671,396,334,251,86,296,628,47,332,432,149,283,345,1016,767,8,La_Liga,2022_2023
Villarreal,32,38,578,370,276,201,101,270,534,50,264,372,125,247,262,840,691,16,La_Liga,2022_2023
Alavés,30,38,578,347,284,227,67,290,629,46,339,363,117,246,279,857,810,5,La_Liga,2023_2024
Almería,35,38,633,372,354,222,57,280,582,48,302,430,134,296,313,946,856,19,La_Liga,2023_2024
Athletic Club,27,38,581,362,217,264,100,305,635,48,330,419,106,313,278,859,631,4,La_Liga,2023_2024
Atlético Madrid,27,38,654,399,308,263,83,327,671,48,344,460,114,346,256,910,793,8,La_Liga,2023_2024
Barcelona,29,38,571,363,271,223,77,243,523,46,280,363,97,266,257,828,573,17,La_Liga,2023_2024
Betis,35,38,692,440,305,300,87,358,683,52,325,422,101,321,345,1037,801,9,La_Liga,2023_2024
Cádiz,34,38,671,398,338,264,69,341,728,46,387,443,123,320,298,969,786,13,La_Liga,2023_2024
Celta Vigo,31,38,627,382,302,243,82,308,662,46,354,434,116,318,297,924,832,9,La_Liga,2023_2024
Getafe,33,38,608,364,269,251,88,291,577,50,286,342,103,239,307,915,730,6,La_Liga,2023_2024
Girona,25,38,544,340,264,222,58,274,521,52,247,378,124,254,257,801,661,21,La_Liga,2023_2024
Granada,40,38,637,374,336,237,64,289,623,46,334,404,110,294,280,917,779,26,La_Liga,2023_2024
Las Palmas,29,38,662,397,328,263,71,305,633,48,328,416,98,318,281,943,761,14,La_Liga,2023_2024
Mallorca,25,38,686,388,347,281,58,340,657,51,317,369,131,238,365,1051,785,10,La_Liga,2023_2024
Osasuna,29,38,525,311,247,201,77,243,517,47,274,400,108,292,263,788,756,16,La_Liga,2023_2024
Rayo Vallecano,26,38,630,372,279,282,69,270,608,44,338,410,105,305,308,938,796,12,La_Liga,2023_2024
Real Madrid,27,38,557,368,252,214,91,225,461,48,236,401,104,297,296,853,552,14,La_Liga,2023_2024
Real Sociedad,31,38,650,405,271,285,94,283,552,51,269,405,118,287,253,903,693,15,La_Liga,2023_2024
Sevilla,35,38,697,463,380,237,80,335,626,53,291,395,123,272,313,1010,772,9,La_Liga,2023_2024
Valencia,29,38,657,379,335,250,72,309,618,50,309,392,105,287,324,981,842,9,La_Liga,2023_2024
Villarreal,32,38,576,348,288,212,76,260,532,48,272,386,130,256,304,880,789,12,La_Liga,2023_2024
Arouca,31,34,530,339,255,204,71,291,604,48,313,361,92,269,262,792,637,8,Primeira_Liga,2023_2024
Benfica,34,34,657,420,273,270,114,343,657,52,314,397,87,310,298,955,457,10,Primeira_Liga,2023_2024
Boavista,23,34,554,343,279,229,46,281,554,50,273,348,119,229,273,827,705,15,Primeira_Liga,2023_2024
Braga,25,34,518,313,225,237,56,251,536,46,285,328,83,245,310,828,593,16,Primeira_Liga,2023_2024
Casa Pia,32,34,499,331,248,189,62,270,560,48,290,366,99,267,286,785,712,7,Primeira_Liga,2023_2024
Chaves,31,34,473,282,250,176,47,254,505,50,251,364,108,256,294,767,730,12,Primeira_Liga,2023_2024
Estoril,31,34,538,335,249,228,61,261,539,48,278,359,113,246,269,807,687,18,Primeira_Liga,2023_2024
Estrela,34,34,574,381,265,242,67,314,582,54,268,390,115,275,281,855,709,9,Primeira_Liga,2023_2024
Famalicão,27,34,548,360,286,197,65,270,534,50,264,372,107,265,299,847,687,7,Primeira_Liga,2023_2024
Farense,25,34,515,318,274,199,42,244,519,47,275,472,175,297,332,847,1004,5,Primeira_Liga,2023_2024
Gil Vicente FC,31,34,540,341,261,206,73,289,539,53,250,373,102,271,303,843,677,15,Primeira_Liga,2023_2024
Moreirense,29,34,532,345,269,195,68,242,500,48,258,382,114,268,318,850,797,7,Primeira_Liga,2023_2024
Portimonense,31,34,661,413,343,255,63,312,594,52,282,402,129,273,356,1017,811,10,Primeira_Liga,2023_2024
Porto,32,34,484,308,188,218,78,245,492,49,247,308,71,237,215,699,440,6,Primeira_Liga,2023_2024
Rio Ave,33,34,541,329,253,233,55,283,577,49,294,403,119,284,289,830,755,15,Primeira_Liga,2023_2024
Sporting CP,29,34,562,354,211,259,92,257,496,51,239,281,70,211,216,778,420,8,Primeira_Liga,2023_2024
Vitória,27,34,505,320,241,205,59,283,555,51,272,366,78,288,277,782,643,7,Primeira_Liga,2023_2024
Vizela,31,34,521,312,262,198,61,257,536,47,279,384,127,257,266,787,766,8,Primeira_Liga,2023_2024
Ajaccio,36,38,637,382,321,236,80,313,694,45,381,359,85,274,420,1057,670,10,Ligue_1,2022_2023
Angers,33,38,652,386,311,268,73,310,610,50,300,402,99,303,375,1027,605,13,Ligue_1,2022_2023
Auxerre,33,38,674,378,337,263,74,313,678,46,365,441,118,323,454,1128,782,11,Ligue_1,2022_2023
Brest,29,38,705,417,348,289,68,356,740,48,384,435,115,320,475,1180,686,13,Ligue_1,2022_2023
Clermont Foot,28,38,685,398,350,250,85,351,779,45,428,424,126,298,440,1125,571,17,Ligue_1,2022_2023
Lens,29,38,540,323,225,238,77,262,570,46,308,401,112,289,339,879,559,7,Ligue_1,2022_2023
Lille,26,38,635,370,266,265,104,314,658,47,344,390,74,316,301,936,543,13,Ligue_1,2022_2023
Lorient,30,38,736,420,409,244,83,315,690,45,375,484,141,343,369,1105,849,17,Ligue_1,2022_2023
Lyon,29,38,723,423,306,282,135,367,771,47,404,433,107,326,481,1204,542,12,Ligue_1,2022_2023
Marseille,30,38,685,404,271,304,110,301,593,50,292,366,101,265,420,1105,570,11,Ligue_1,2022_2023
Monaco,27,38,696,400,284,310,102,323,701,46,378,459,120,339,426,1122,549,14,Ligue_1,2022_2023
Montpellier,31,38,684,413,362,249,73,361,745,48,384,448,121,327,404,1088,686,9,Ligue_1,2022_2023
Nantes,29,38,709,431,367,249,93,367,730,50,363,427,107,320,431,1140,731,8,Ligue_1,2022_2023
Nice,34,38,818,467,415,295,108,382,680,56,298,419,115,304,413,1231,588,9,Ligue_1,2022_2023
Paris S-G,26,38,612,362,253,255,104,339,693,48,354,378,109,269,296,908,432,20,Ligue_1,2022_2023
Reims,34,38,703,407,338,259,106,339,747,45,408,468,127,341,397,1100,633,15,Ligue_1,2022_2023
Rennes,32,38,600,335,255,251,94,289,616,46,327,392,91,301,341,941,587,10,Ligue_1,2022_2023
Strasbourg,29,38,690,409,316,284,90,344,666,51,322,423,98,325,437,1127,688,5,Ligue_1,2022_2023
Toulouse,29,38,716,406,349,264,103,368,842,43,474,476,138,338,409,1125,656,15,Ligue_1,2022_2023
Troyes,32,38,608,361,333,207,68,272,606,44,334,416,144,272,398,1006,779,5,Ligue_1,2022_2023
Arsenal,25,38,610,348,257,246,107,271,543,49,272,412,106,306,292,902,515,18,Premier_League,2023_2024
Aston Villa,31,38,547,311,269,210,68,260,550,47,290,389,113,276,236,783,597,13,Premier_League,2023_2024
Bournemouth,30,38,693,410,301,281,111,325,688,47,363,504,153,351,357,1050,817,16,Premier_League,2023_2024
Brentford,28,38,677,399,349,250,78,317,697,45,380,474,142,332,378,1055,903,18,Premier_League,2023_2024
Brighton,30,38,644,366,292,252,100,307,658,46,351,437,140,297,288,932,603,21,Premier_League,2023_2024
Burnley,31,38,607,342,282,247,78,284,584,48,300,477,169,308,280,887,837,22,Premier_League,2023_2024
Chelsea,32,38,663,376,325,235,103,323,630,51,307,448,166,282,298,961,785,24,Premier_League,2023_2024
Crystal Palace,26,38,788,464,373,301,114,337,609,55,272,456,122,334,323,1111,927,6,Premier_League,2023_2024
Everton,26,38,743,442,371,261,111,347,701,49,354,479,177,302,358,1101,882,12,Premier_League,2023_2024
Fulham,25,38,679,384,339,260,80,346,678,51,332,437,117,320,371,1050,744,14,Premier_League,2023_2024
Liverpool,30,38,677,418,274,290,113,341,768,44,427,475,108,367,292,969,583,19,Premier_League,2023_2024
Luton Town,28,38,654,368,330,236,88,299,616,48,317,493,183,310,325,979,916,21,Premier_League,2023_2024
Manchester City,25,38,517,305,183,221,113,222,458,48,236,353,75,278,233,750,457,17,Premier_League,2023_2024
Manchester Utd,31,38,676,409,334,240,102,349,715,48,366,534,207,327,313,989,884,12,Premier_League,2023_2024
Newcastle Utd,32,38,661,391,316,254,91,302,681,44,379,497,151,346,285,946,682,16,Premier_League,2023_2024
Nott'ham Forest,33,38,728,429,437,219,72,325,607,53,282,488,168,320,331,1059,968,13,Premier_League,2023_2024
Sheffield Utd,35,38,709,405,375,248,86,299,635,47,336,514,180,334,348,1057,1042,18,Premier_League,2023_2024
Tottenham,29,38,724,451,335,264,125,360,691,52,331,445,132,313,355,1079,707,24,Premier_League,2023_2024
West Ham,26,38,684,426,350,254,80,307,607,50,300,487,180,307,361,1045,906,9,Premier_League,2023_2024
Wolves,27,38,739,430,415,247,77,312,607,51,295,506,173,333,284,1023,828,16,Premier_League,2023_2024
Atalanta,27,38,636,364,291,272,73,312,634,49,322,455,93,362,421,1057,613,12,Serie_A,2022_2023
Bologna,27,38,648,373,310,255,83,297,618,48,321,414,131,283,302,950,652,7,Serie_A,2022_2023
Cremonese,33,38,704,400,403,228,73,364,729,49,365,432,136,296,393,1097,771,13,Serie_A,2022_2023
Empoli,32,38,606,364,316,218,72,254,538,47,284,449,183,266,280,886,910,4,Serie_A,2022_2023
Fiorentina,30,38,581,337,232,260,89,282,531,53,249,356,84,272,260,841,473,11,Serie_A,2022_2023
Hellas Verona,36,38,605,357,319,228,58,296,562,52,266,445,143,302,337,942,745,12,Serie_A,2022_2023
Inter,25,38,572,325,247,241,84,258,523,49,265,385,110,275,315,887,541,7,Serie_A,2022_2023
Juventus,29,38,594,352,296,219,79,288,558,51,270,421,131,290,307,901,704,10,Serie_A,2022_2023
Lazio,24,38,582,349,261,234,87,277,625,44,348,437,126,311,310,892,606,8,Serie_A,2022_2023
Lecce,29,38,705,427,347,259,99,319,619,51,300,486,112,374,368,1073,826,4,Serie_A,2022_2023
Milan,30,38,690,422,327,295,68,300,563,53,263,387,126,261,289,979,542,9,Serie_A,2022_2023
Monza,31,38,595,355,323,214,58,260,551,47,291,380,120,260,334,929,661,13,Serie_A,2022_2023
Napoli,27,38,569,313,236,227,106,255,521,48,266,374,96,278,287,856,490,7,Serie_A,2022_2023
Roma,30,38,624,340,301,257,66,289,617,46,328,392,113,279,368,992,590,9,Serie_A,2022_2023
Salernitana,30,38,587,337,309,220,58,259,569,45,310,409,157,252,329,916,740,13,Serie_A,2022_2023
Sampdoria,40,38,589,351,290,240,59,261,558,46,297,428,152,276,317,906,688,7,Serie_A,2022_2023
Sassuolo,31,38,502,281,237,186,79,216,461,46,245,371,122,249,278,780,658,16,Serie_A,2022_2023
Spezia,34,38,622,359,290,236,96,254,569,44,315,457,161,296,301,923,830,7,Serie_A,2022_2023
Torino,28,38,473,265,231,187,55,199,367,54,168,337,110,227,292,765,627,9,Serie_A,2022_2023
Udinese,30,38,651,365,363,228,60,326,632,51,306,437,128,309,314,965,712,8,Serie_A,2022_2023
Alavés,33,38,550,324,271,221,58,262,637,41,375,373,106,267,376,926,890,7,La_Liga,2021_2022
Athletic Club,26,38,508,292,217,216,75,224,582,38,358,411,128,283,339,847,788,8,La_Liga,2021_2022
Atlético Madrid,26,38,636,346,290,279,67,293,619,47,326,372,98,274,365,1001,649,14,La_Liga,2021_2022
Barcelona,38,38,587,331,236,270,81,244,493,49,249,346,85,261,325,912,467,17,La_Liga,2021_2022
Betis,31,38,662,392,322,261,79,324,695,46,371,386,112,274,361,1023,777,11,La_Liga,2021_2022
Cádiz,33,38,647,380,346,238,63,301,711,42,410,390,106,284,413,1060,768,5,La_Liga,2021_2022
Celta Vigo,25,38,696,409,324,279,93,286,762,37,476,423,91,332,376,1072,634,11,La_Liga,2021_2022
Elche,28,38,589,325,335,191,63,268,622,43,354,367,126,241,305,894,769,14,La_Liga,2021_2022
Espanyol,34,38,557,338,308,196,53,275,646,42,371,360,114,246,326,883,892,20,La_Liga,2021_2022
Getafe,31,38,587,360,266,243,78,248,594,41,346,400,96,304,401,988,719,8,La_Liga,2021_2022
Granada,32,38,611,343,310,240,61,274,632,43,358,437,130,307,326,937,841,8,La_Liga,2021_2022
Levante,31,38,558,305,268,212,78,237,611,38,374,326,110,216,377,935,735,12,La_Liga,2021_2022
Mallorca,33,38,607,332,301,235,71,248,551,45,303,374,119,255,344,951,826,9,La_Liga,2021_2022
Osasuna,29,38,577,331,270,236,71,251,598,42,347,340,115,225,368,945,758,5,La_Liga,2021_2022
Rayo Vallecano,28,38,621,359,320,237,64,280,688,40,408,410,95,315,365,986,686,9,La_Liga,2021_2022
Real Madrid,31,38,560,345,281,195,84,211,502,42,291,379,114,265,334,894,526,17,La_Liga,2021_2022
Real Sociedad,32,38,586,339,271,234,81,260,546,47,286,382,105,277,348,934,703,6,La_Liga,2021_2022
Sevilla,33,38,534,302,252,211,71,236,542,43,306,367,124,243,270,804,603,18,La_Liga,2021_2022
Valencia,34,38,591,364,289,217,85,266,623,42,357,373,93,280,339,930,746,8,La_Liga,2021_2022
Villarreal,29,38,538,312,250,197,91,229,476,48,247,330,109,221,329,867,644,16,La_Liga,2021_2022
